S.N.,Candidate,Party,EVM Votes,Postal Votes,Total Votes,% of Votes,Constituency,State Code,Constituency Number
1.0,GUMMA THANUJA RANI,Yuvajana Sramika Rythu Congress Party,471470,5535,477005,40.96,1 - Araku (ST) (Andhra Pradesh),1,1
2.0,KOTHAPALLI GEETHA,Bharatiya Janata Party,417113,9312,426425,36.62,1 - Araku (ST) (Andhra Pradesh),1,1
3.0,APPALANARASA PACHIPENTA,Communist Party of India (Marxist),119016,4113,123129,10.57,1 - Araku (ST) (Andhra Pradesh),1,1
4.0,AVASHYA LAHARI . VARAM,Bahujan Samaj Party,24858,892,25750,2.21,1 - Araku (ST) (Andhra Pradesh),1,1
5.0,SAMAREDDY BALAKRISHNA,Independent,9493,42,9535,0.82,1 - Araku (ST) (Andhra Pradesh),1,1
6.0,NIMMAKA JAYARAJU,Independent,8798,664,9462,0.81,1 - Araku (ST) (Andhra Pradesh),1,1
7.0,ATHIDHI,Independent,8121,15,8136,0.7,1 - Araku (ST) (Andhra Pradesh),1,1
8.0,CHANTI BADNAINA,Jai Bharat National Party,7205,47,7252,0.62,1 - Araku (ST) (Andhra Pradesh),1,1
9.0,MOTTADAM . RAJABABU,Bharat Adivasi Party,6370,396,6766,0.58,1 - Araku (ST) (Andhra Pradesh),1,1
10.0,RANJITH KUMAR PALAKA,Independent,6000,47,6047,0.52,1 - Araku (ST) (Andhra Pradesh),1,1
11.0,RAMBABU JALLI,Telugu Rajadhikara Samiti Party,4933,26,4959,0.43,1 - Araku (ST) (Andhra Pradesh),1,1
12.0,MANDALA GIRIDHARA RAO,Independent,4931,36,4967,0.43,1 - Araku (ST) (Andhra Pradesh),1,1
13.0,VUYAKA NIREEKSHAN (V. CHENCHU),India Praja Bandhu Party,4500,42,4542,0.39,1 - Araku (ST) (Andhra Pradesh),1,1
14.0,NOTA,None of the Above,50205,265,50470,4.33,1 - Araku (ST) (Andhra Pradesh),1,1
,Total,,1143013,21432,1164445,,1 - Araku (ST) (Andhra Pradesh),1,1
1.0,KINJARAPU RAMMOHAN NAIDU,Telugu Desam,734501,19827,754328,61.05,2 - Srikakulam (Andhra Pradesh),1,2
2.0,TILAK PERADA,Yuvajana Sramika Rythu Congress Party,420394,6033,426427,34.51,2 - Srikakulam (Andhra Pradesh),1,2
3.0,PEDADA PARAMESWARA RAO,Indian National Congress,6724,448,7172,0.58,2 - Srikakulam (Andhra Pradesh),1,2
4.0,SANAPALA SRAVAN KUMAR,Independent,5950,8,5958,0.48,2 - Srikakulam (Andhra Pradesh),1,2
5.0,NAIDUGARI RAJASEKHAR,Bahujan Samaj Party,4661,81,4742,0.38,2 - Srikakulam (Andhra Pradesh),1,2
6.0,VABA YOGESWARA RAO,Independent,3472,126,3598,0.29,2 - Srikakulam (Andhra Pradesh),1,2
7.0,BETHA VIVEKANANDA MAHARAJ,Independent,2523,13,2536,0.21,2 - Srikakulam (Andhra Pradesh),1,2
8.0,YEDDU LAKSHMINARAYANA,Independent,1598,7,1605,0.13,2 - Srikakulam (Andhra Pradesh),1,2
9.0,BORUBADRA CHANDRAKALA,Bharatha Chaitanya Yuvajana Party,1315,42,1357,0.11,2 - Srikakulam (Andhra Pradesh),1,2
10.0,IPPILI SEETHARAJU,Jai Bharat National Party,1080,50,1130,0.09,2 - Srikakulam (Andhra Pradesh),1,2
11.0,KAYA DURGARAO,Navarang Congress Party,811,7,818,0.07,2 - Srikakulam (Andhra Pradesh),1,2
12.0,CHELLURI DANIYAL,Independent,796,20,816,0.07,2 - Srikakulam (Andhra Pradesh),1,2
13.0,BOMMALI TIRUPATI RAO,Pyramid Party of India,589,5,594,0.05,2 - Srikakulam (Andhra Pradesh),1,2
14.0,NOTA,None of the Above,24498,107,24605,1.99,2 - Srikakulam (Andhra Pradesh),1,2
,Total,,1208912,26774,1235686,,2 - Srikakulam (Andhra Pradesh),1,2
1.0,APPALANAIDU KALISETTI,Telugu Desam,729284,13829,743113,57.2,3 - Vizianagaram (Andhra Pradesh),1,3
2.0,BELLANA CHANDRASEKHAR,Yuvajana Sramika Rythu Congress Party,487691,6071,493762,38.0,3 - Vizianagaram (Andhra Pradesh),1,3
3.0,BOBBILI SRINU,Indian National Congress,10270,353,10623,0.82,3 - Vizianagaram (Andhra Pradesh),1,3
4.0,PEERUBANDI PRAKASH RAO,Bahujan Samaj Party,7985,53,8038,0.62,3 - Vizianagaram (Andhra Pradesh),1,3
5.0,VELURI VENKATA TRINADHARAO,Independent,4146,6,4152,0.32,3 - Vizianagaram (Andhra Pradesh),1,3
6.0,ALLU SRIRAMULU,Independent,3396,5,3401,0.26,3 - Vizianagaram (Andhra Pradesh),1,3
7.0,SIYYADULA YELLA RAO,Independent,3105,2,3107,0.24,3 - Vizianagaram (Andhra Pradesh),1,3
8.0,SRINIVASA RAO SAMBHANA,Yuga Thulasi Party,1758,3,1761,0.14,3 - Vizianagaram (Andhra Pradesh),1,3
9.0,MARISERLA KRISHNAMURTHY NAIDU,Independent,1617,12,1629,0.13,3 - Vizianagaram (Andhra Pradesh),1,3
10.0,VANGAPANDU MAHESWARA RAO,Naba Bharata Nirmana Seva Party,1544,9,1553,0.12,3 - Vizianagaram (Andhra Pradesh),1,3
11.0,CHINNAM ARUNA KUMAR,Jaibhim Rao Bharat Party,1401,10,1411,0.11,3 - Vizianagaram (Andhra Pradesh),1,3
12.0,ATCHIYYA NAIDU SAMIREDDY,Samajwadi Party,1059,11,1070,0.08,3 - Vizianagaram (Andhra Pradesh),1,3
13.0,ADINARAYANA TADDI,Independent,855,1,856,0.07,3 - Vizianagaram (Andhra Pradesh),1,3
14.0,P V A ANANDA SAGAR,Independent,787,4,791,0.06,3 - Vizianagaram (Andhra Pradesh),1,3
15.0,SAKHINETI ANANTHA RAJU,Pyramid Party of India,715,10,725,0.06,3 - Vizianagaram (Andhra Pradesh),1,3
16.0,NOTA,None of the Above,23097,153,23250,1.79,3 - Vizianagaram (Andhra Pradesh),1,3
,Total,,1278710,20532,1299242,,3 - Vizianagaram (Andhra Pradesh),1,3
1.0,SRIBHARAT MATHUKUMILI,Telugu Desam,893884,13583,907467,65.42,4 - Visakhapatnam (Andhra Pradesh),1,4
2.0,JHANSI LAKSHMI. BOTCHA.,Yuvajana Sramika Rythu Congress Party,397821,5399,403220,29.07,4 - Visakhapatnam (Andhra Pradesh),1,4
3.0,P. SATYA REDDY,Indian National Congress,29430,837,30267,2.18,4 - Visakhapatnam (Andhra Pradesh),1,4
4.0,K.A. PAUL,Praja Shanthi Party,7529,167,7696,0.55,4 - Visakhapatnam (Andhra Pradesh),1,4
5.0,PEDAPENKI SIVA PRASADA RAO,Bahujan Samaj Party,6006,85,6091,0.44,4 - Visakhapatnam (Andhra Pradesh),1,4
6.0,BIKKAVOLU. CHALAMAJI,Navarang Congress Party,4883,1,4884,0.35,4 - Visakhapatnam (Andhra Pradesh),1,4
7.0,V.N. SATYA NARAYANA,Rashtriya Praja Congress (Secular),2534,3,2537,0.18,4 - Visakhapatnam (Andhra Pradesh),1,4
8.0,ARUNA SRI MURALA,Independent,1991,2,1993,0.14,4 - Visakhapatnam (Andhra Pradesh),1,4
9.0,VASUPILLI SURESH,Independent,1931,2,1933,0.14,4 - Visakhapatnam (Andhra Pradesh),1,4
10.0,SONDI KRISHNA.,Independent,1811,7,1818,0.13,4 - Visakhapatnam (Andhra Pradesh),1,4
11.0,ANDUKURI VIJAYA BHASKAR,India Praja Bandhu Party,1098,11,1109,0.08,4 - Visakhapatnam (Andhra Pradesh),1,4
12.0,DR. GANAPATHI KONGARAPU.,Republican Party of India (A),944,6,950,0.07,4 - Visakhapatnam (Andhra Pradesh),1,4
13.0,BANNA. RAMESH,Dalita Bahujana Party,941,7,948,0.07,4 - Visakhapatnam (Andhra Pradesh),1,4
14.0,P. SATYA VANI,Pyramid Party of India,875,7,882,0.06,4 - Visakhapatnam (Andhra Pradesh),1,4
15.0,DURGA PRASAD. GUNTU,Bhartiya Rashtriya Dal,760,7,767,0.06,4 - Visakhapatnam (Andhra Pradesh),1,4
16.0,CHAPPIDI RAMU,Independent,756,1,757,0.05,4 - Visakhapatnam (Andhra Pradesh),1,4
17.0,M.G.M. KHAN,Independent,738,4,742,0.05,4 - Visakhapatnam (Andhra Pradesh),1,4
18.0,SHANKAR DEVARA YADAV,Independent,656,5,661,0.05,4 - Visakhapatnam (Andhra Pradesh),1,4
19.0,VENU MADHAV KARRI,Independent,646,1,647,0.05,4 - Visakhapatnam (Andhra Pradesh),1,4
20.0,DR. ACHUTHA BALAJI YADAV (MURAPALA),Bharatha Chaitanya Yuvajana Party,628,10,638,0.05,4 - Visakhapatnam (Andhra Pradesh),1,4
21.0,THOTA VENKATA SAI MUKUND,Praja Prasthanam Party,628,5,633,0.05,4 - Visakhapatnam (Andhra Pradesh),1,4
22.0,PIDIDHI APPARAO,Independent,576,4,580,0.04,4 - Visakhapatnam (Andhra Pradesh),1,4
23.0,G.A.N. ANAND,Independent,543,-,543,0.04,4 - Visakhapatnam (Andhra Pradesh),1,4
24.0,VADDI. HARI GANESH,Independent,518,2,520,0.04,4 - Visakhapatnam (Andhra Pradesh),1,4
25.0,JANARDHAN PONNADA.,Independent,499,1,500,0.04,4 - Visakhapatnam (Andhra Pradesh),1,4
26.0,GANAPATHI. JAGADEESWARA RAO (JAGADEESH),Jai Maha Bharath Party,494,6,500,0.04,4 - Visakhapatnam (Andhra Pradesh),1,4
27.0,JALADI VIJAYA KUMARI,Samajwadi Party,463,3,466,0.03,4 - Visakhapatnam (Andhra Pradesh),1,4
28.0,CHINTADA SURYAM,Naba Bharata Nirmana Seva Party,443,5,448,0.03,4 - Visakhapatnam (Andhra Pradesh),1,4
29.0,GANDIKOTA RAJESH,Navataram Party,392,1,393,0.03,4 - Visakhapatnam (Andhra Pradesh),1,4
30.0,KOLLI NAGA RAJU,Independent,322,7,329,0.02,4 - Visakhapatnam (Andhra Pradesh),1,4
31.0,METTA RAMA RAO,Independent,320,6,326,0.02,4 - Visakhapatnam (Andhra Pradesh),1,4
32.0,LAGUDU. GOVINDA RAO,Independent,293,1,294,0.02,4 - Visakhapatnam (Andhra Pradesh),1,4
33.0,MALLA SRAVANI,Independent,271,2,273,0.02,4 - Visakhapatnam (Andhra Pradesh),1,4
34.0,NOTA,None of the Above,5171,142,5313,0.38,4 - Visakhapatnam (Andhra Pradesh),1,4
,Total,,1366795,20330,1387125,,4 - Visakhapatnam (Andhra Pradesh),1,4
1.0,C.M.RAMESH,Bharatiya Janata Party,750027,12042,762069,57.5,5 - Anakapalle (Andhra Pradesh),1,5
2.0,BUDI MUTYALA NAIDU,Yuvajana Sramika Rythu Congress Party,459762,5777,465539,35.13,5 - Anakapalle (Andhra Pradesh),1,5
3.0,VEGI VENKATESH,Indian National Congress,24833,818,25651,1.94,5 - Anakapalle (Andhra Pradesh),1,5
4.0,PALAKA SREERAMA MURTHY,Bahujan Samaj Party,19082,75,19157,1.45,5 - Anakapalle (Andhra Pradesh),1,5
5.0,VANKAYALA RAMACHANDRA RAO,Independent,4001,1,4002,0.3,5 - Anakapalle (Andhra Pradesh),1,5
6.0,LOVARAJU SIDDHA,Independent,3845,7,3852,0.29,5 - Anakapalle (Andhra Pradesh),1,5
7.0,KRISHNA SWAROOP VADLAMURI,Dalita Bahujana Party,3549,8,3557,0.27,5 - Anakapalle (Andhra Pradesh),1,5
8.0,GARA SURYA RAO,Independent,3116,8,3124,0.24,5 - Anakapalle (Andhra Pradesh),1,5
9.0,APPALA RAJU NAMMI,Bharatha Chaitanya Yuvajana Party,2589,30,2619,0.2,5 - Anakapalle (Andhra Pradesh),1,5
10.0,NAGESWARA RAO PETLA,Independent,2179,5,2184,0.16,5 - Anakapalle (Andhra Pradesh),1,5
11.0,ADARI SARAT CHANDRA,Jai Bharat National Party,1886,27,1913,0.14,5 - Anakapalle (Andhra Pradesh),1,5
12.0,VIJAYA LAKSHMI KARRI,Pyramid Party of India,1578,13,1591,0.12,5 - Anakapalle (Andhra Pradesh),1,5
13.0,DR. THUMMAPALA HARI SHANKAR,Independent,1567,9,1576,0.12,5 - Anakapalle (Andhra Pradesh),1,5
14.0,JUNNURI J SRINIVAS,Independent,1195,6,1201,0.09,5 - Anakapalle (Andhra Pradesh),1,5
15.0,APPALANAIDU TUMMAGUNTA,Independent,1055,7,1062,0.08,5 - Anakapalle (Andhra Pradesh),1,5
16.0,NOTA,None of the Above,26084,151,26235,1.98,5 - Anakapalle (Andhra Pradesh),1,5
,Total,,1306348,18984,1325332,,5 - Anakapalle (Andhra Pradesh),1,5
1.0,TANGELLA UDAY SRINIVAS (TEA TIME UDAY),Janasena Party,718971,10728,729699,54.87,6 - Kakinada (Andhra Pradesh),1,6
2.0,CHALAMALASETTY SUNIL,Yuvajana Sramika Rythu Congress Party,495188,5020,500208,37.62,6 - Kakinada (Andhra Pradesh),1,6
3.0,MALLIPUDI MANGAPATI PALLAM RAJU,Indian National Congress,20258,851,21109,1.59,6 - Kakinada (Andhra Pradesh),1,6
4.0,UDAY,Navarang Congress Party,15578,125,15703,1.18,6 - Kakinada (Andhra Pradesh),1,6
5.0,KANDREGULA NARASIMHAM,Bahujan Samaj Party,11916,63,11979,0.9,6 - Kakinada (Andhra Pradesh),1,6
6.0,DR ANUSHA YADAV,Bharatha Chaitanya Yuvajana Party,9818,36,9854,0.74,6 - Kakinada (Andhra Pradesh),1,6
7.0,TANGELLA SRINIVASU,Jatiya Jana Sena Party,6516,43,6559,0.49,6 - Kakinada (Andhra Pradesh),1,6
8.0,YEDIDA VARA PRASAD KUMAR,Republican Party of India (A),3924,3,3927,0.3,6 - Kakinada (Andhra Pradesh),1,6
9.0,BUGATHA BANGARRAO,Communist Party of India (Marxist-Leninist) (Liberation),2816,7,2823,0.21,6 - Kakinada (Andhra Pradesh),1,6
10.0,SUDHA VEERA GANESH,Independent,2645,2,2647,0.2,6 - Kakinada (Andhra Pradesh),1,6
11.0,BHAVANI SANKAR PRASAD MERLA,Independent,1963,6,1969,0.15,6 - Kakinada (Andhra Pradesh),1,6
12.0,YENUGUPALLI KRISHNA,Jaibhim Rao Bharat Party,1762,18,1780,0.13,6 - Kakinada (Andhra Pradesh),1,6
13.0,BODDETI APPARAO,Independent,1687,-,1687,0.13,6 - Kakinada (Andhra Pradesh),1,6
14.0,NEELAKANTAM DONAM,Independent,1401,11,1412,0.11,6 - Kakinada (Andhra Pradesh),1,6
15.0,PASUPULETI S.V.S.BHUSHANAM,Independent,1222,5,1227,0.09,6 - Kakinada (Andhra Pradesh),1,6
16.0,NOTA,None of the Above,17105,115,17220,1.29,6 - Kakinada (Andhra Pradesh),1,6
,Total,,1312770,17033,1329803,,6 - Kakinada (Andhra Pradesh),1,6
1.0,G M HARISH (BALAYOGI),Telugu Desam,786149,10832,796981,61.25,7 - Amalapuram (SC) (Andhra Pradesh),1,7
2.0,RAPAKA VARAPRASADA RAO,Yuvajana Sramika Rythu Congress Party,450362,4423,454785,34.95,7 - Amalapuram (SC) (Andhra Pradesh),1,7
3.0,GOUTHAM JANGA,Indian National Congress,14523,559,15082,1.16,7 - Amalapuram (SC) (Andhra Pradesh),1,7
4.0,DORABABU YALLA,Bahujan Samaj Party,5202,186,5388,0.41,7 - Amalapuram (SC) (Andhra Pradesh),1,7
5.0,KATRU NAGA BABU,Telugu Nava Garjana Party,3736,5,3741,0.29,7 - Amalapuram (SC) (Andhra Pradesh),1,7
6.0,VADDI LALITH KUMAR,Independent,2974,3,2977,0.23,7 - Amalapuram (SC) (Andhra Pradesh),1,7
7.0,MAKEY DAVY PRASAD,Independent,2104,7,2111,0.16,7 - Amalapuram (SC) (Andhra Pradesh),1,7
8.0,GUDE VENKATESWARULU,Independent,1741,4,1745,0.13,7 - Amalapuram (SC) (Andhra Pradesh),1,7
9.0,RAMESH JILLELLA,Jatiya Jana Sena Party,866,6,872,0.07,7 - Amalapuram (SC) (Andhra Pradesh),1,7
10.0,YALANGI RAMESH,Jaibhim Rao Bharat Party,738,2,740,0.06,7 - Amalapuram (SC) (Andhra Pradesh),1,7
11.0,MATHA KRISHNA,Pyramid Party of India,718,1,719,0.06,7 - Amalapuram (SC) (Andhra Pradesh),1,7
12.0,GIDDI JNANA PRAKASA RAO,Republican Party of India,717,9,726,0.06,7 - Amalapuram (SC) (Andhra Pradesh),1,7
13.0,YADLA RAJESH,Liberation Congress Party,628,7,635,0.05,7 - Amalapuram (SC) (Andhra Pradesh),1,7
14.0,KAPA KALYAN,Republican Party of India (A),579,2,581,0.04,7 - Amalapuram (SC) (Andhra Pradesh),1,7
15.0,PATHURI RAMESH,Peoples Party of India (Democratic),502,3,505,0.04,7 - Amalapuram (SC) (Andhra Pradesh),1,7
16.0,NOTA,None of the Above,13418,100,13518,1.04,7 - Amalapuram (SC) (Andhra Pradesh),1,7
,Total,,1284957,16149,1301106,,7 - Amalapuram (SC) (Andhra Pradesh),1,7
1.0,DAGGUBATI PURANDHESHWARI,Bharatiya Janata Party,718641,7874,726515,54.82,8 - Rajahmundry (Andhra Pradesh),1,8
2.0,DR. GUDURI SRINIVAS,Yuvajana Sramika Rythu Congress Party,483172,4204,487376,36.77,8 - Rajahmundry (Andhra Pradesh),1,8
3.0,GIDUGU RUDRARAJU,Indian National Congress,31441,1067,32508,2.45,8 - Rajahmundry (Andhra Pradesh),1,8
4.0,GANESWARA RAO PARAMATA,Bahujan Samaj Party,20277,132,20409,1.54,8 - Rajahmundry (Andhra Pradesh),1,8
5.0,BATTULA BALARAMAKRISHNA,Navarang Congress Party,16930,78,17008,1.28,8 - Rajahmundry (Andhra Pradesh),1,8
6.0,SALOPANTULA RAGHAVENDRA RAO,Independent,3261,17,3278,0.25,8 - Rajahmundry (Andhra Pradesh),1,8
7.0,DR. MEDISI RATNARAO ALIAS VINAY,Independent,3109,6,3115,0.24,8 - Rajahmundry (Andhra Pradesh),1,8
8.0,MOHANARAO SINGULURI,Jai Bharat National Party,2818,15,2833,0.21,8 - Rajahmundry (Andhra Pradesh),1,8
9.0,MEDA SRINIVASA RAO,Rashtriya Praja Congress (Secular),2422,7,2429,0.18,8 - Rajahmundry (Andhra Pradesh),1,8
10.0,BOMMANABOINA VSR MURTHY,Independent,2173,6,2179,0.16,8 - Rajahmundry (Andhra Pradesh),1,8
11.0,BHANU CHANDAR KURUVELLA,Independent,1955,3,1958,0.15,8 - Rajahmundry (Andhra Pradesh),1,8
12.0,JALLI BALA NAVEENA,Independent,1250,4,1254,0.09,8 - Rajahmundry (Andhra Pradesh),1,8
13.0,NOTA,None of the Above,24302,133,24435,1.84,8 - Rajahmundry (Andhra Pradesh),1,8
,Total,,1311751,13546,1325297,,8 - Rajahmundry (Andhra Pradesh),1,8
1.0,BHUPATHI RAJU SRINIVASA VARMA (B.J.P.VARMA),Bharatiya Janata Party,699382,7961,707343,57.46,9 - Narsapuram (Andhra Pradesh),1,9
2.0,UMABALA GUDURI,Yuvajana Sramika Rythu Congress Party,426037,4504,430541,34.98,9 - Narsapuram (Andhra Pradesh),1,9
3.0,K.B.R.NAIDU,Indian National Congress,34298,915,35213,2.86,9 - Narsapuram (Andhra Pradesh),1,9
4.0,PRASANNA KUMAR UNDURTHI,Independent,6350,14,6364,0.52,9 - Narsapuram (Andhra Pradesh),1,9
5.0,MEDAPATI VENKATA VARAHALA REDDY,Independent,5966,3,5969,0.48,9 - Narsapuram (Andhra Pradesh),1,9
6.0,SIRRA RAJU,Bahujan Samaj Party,5945,69,6014,0.49,9 - Narsapuram (Andhra Pradesh),1,9
7.0,BALAGAM NAYAKAR,Independent,5232,8,5240,0.43,9 - Narsapuram (Andhra Pradesh),1,9
8.0,NALLI RAJESH,Independent,4684,-,4684,0.38,9 - Narsapuram (Andhra Pradesh),1,9
9.0,KETHA SREENU,Independent,3140,5,3145,0.26,9 - Narsapuram (Andhra Pradesh),1,9
10.0,OLETY NAGENDRA KRISHNA,Jaibhim Rao Bharat Party,3112,4,3116,0.25,9 - Narsapuram (Andhra Pradesh),1,9
11.0,ADDEPALLI VEERA VENKAT SUBBA RAO,Independent,2781,2,2783,0.23,9 - Narsapuram (Andhra Pradesh),1,9
12.0,ANAND CHANDULAL JASTI,Independent,2726,-,2726,0.22,9 - Narsapuram (Andhra Pradesh),1,9
13.0,GANJI PURNIMA,Republican Party of India (A),1645,4,1649,0.13,9 - Narsapuram (Andhra Pradesh),1,9
14.0,GEDALA LAXMANA RAO,Independent,1525,2,1527,0.12,9 - Narsapuram (Andhra Pradesh),1,9
15.0,ADDANKI DORABABU,Independent,1388,5,1393,0.11,9 - Narsapuram (Andhra Pradesh),1,9
16.0,GOTTUMUKKALA SHIVAJI,Independent,1378,6,1384,0.11,9 - Narsapuram (Andhra Pradesh),1,9
17.0,ADINARAYANA DUPPANAPUDI,Independent,1002,5,1007,0.08,9 - Narsapuram (Andhra Pradesh),1,9
18.0,MANNE LEELA RAMA NARENDRA,Pyramid Party of India,922,8,930,0.08,9 - Narsapuram (Andhra Pradesh),1,9
19.0,RAMA DURGA PRASAD THOLETI,Independent,919,1,920,0.07,9 - Narsapuram (Andhra Pradesh),1,9
20.0,RUKHMINI,Independent,683,3,686,0.06,9 - Narsapuram (Andhra Pradesh),1,9
21.0,ADABALA SIVA,Independent,682,1,683,0.06,9 - Narsapuram (Andhra Pradesh),1,9
22.0,NOTA,None of the Above,7554,123,7677,0.62,9 - Narsapuram (Andhra Pradesh),1,9
,Total,,1217351,13643,1230994,,9 - Narsapuram (Andhra Pradesh),1,9
1.0,PUTTA MAHESH KUMAR,Telugu Desam,737644,8707,746351,54.0,10 - Eluru (Andhra Pradesh),1,10
2.0,KARUMURI SUNIL KUMAR,Yuvajana Sramika Rythu Congress Party,559318,5176,564494,40.84,10 - Eluru (Andhra Pradesh),1,10
3.0,KAVURI LAVANYA,Indian National Congress,19820,1006,20826,1.51,10 - Eluru (Andhra Pradesh),1,10
4.0,AJAY BABU BODA,Navarang Congress Party,12197,13,12210,0.88,10 - Eluru (Andhra Pradesh),1,10
5.0,NITTA AKHILA DHARANI PAL,Bahujan Samaj Party,6664,68,6732,0.49,10 - Eluru (Andhra Pradesh),1,10
6.0,BOKINALA KOTESWARA RAO,Independent,2253,10,2263,0.16,10 - Eluru (Andhra Pradesh),1,10
7.0,RUDRAPAKA RATNA RAO (R.R.R),Andhra Rastra Praja Samithi,1523,3,1526,0.11,10 - Eluru (Andhra Pradesh),1,10
8.0,KANDAVALLI JEEVA DEVA DAYAKAR,Independent,1172,8,1180,0.09,10 - Eluru (Andhra Pradesh),1,10
9.0,AGASTEEN KOMMINA,Independent,1001,3,1004,0.07,10 - Eluru (Andhra Pradesh),1,10
10.0,DR. MENDEM SANTHOSH KUMAR (PEDDA BABULU),Liberation Congress Party,777,9,786,0.06,10 - Eluru (Andhra Pradesh),1,10
11.0,RAJESWARA RAO KONDRU,Bharatheeya Jawan Kisan Party,729,3,732,0.05,10 - Eluru (Andhra Pradesh),1,10
12.0,GODUGUPATI VEERA RAGHAVULU,Pyramid Party of India,710,5,715,0.05,10 - Eluru (Andhra Pradesh),1,10
13.0,BYRABOYINA MALYADRI,Bharatha Chaitanya Yuvajana Party,705,10,715,0.05,10 - Eluru (Andhra Pradesh),1,10
14.0,NOTA,None of the Above,22371,144,22515,1.63,10 - Eluru (Andhra Pradesh),1,10
,Total,,1366884,15165,1382049,,10 - Eluru (Andhra Pradesh),1,10
1.0,BALASHOWRY VALLABHANENI,Janasena Party,712149,12290,724439,55.22,11 - Machilipatnam (Andhra Pradesh),1,11
2.0,SIMHADRI CHANDRA SEKHAR RAO,Yuvajana Sramika Rythu Congress Party,495211,6049,501260,38.21,11 - Machilipatnam (Andhra Pradesh),1,11
3.0,GOLLU KRISHNA,Indian National Congress,31130,695,31825,2.43,11 - Machilipatnam (Andhra Pradesh),1,11
4.0,BAAL SHOURI CHODABATHINA,Jatiya Jana Sena Party,10518,623,11141,0.85,11 - Machilipatnam (Andhra Pradesh),1,11
5.0,DEVAMANI DEVARAPALLI,Bahujan Samaj Party,9911,117,10028,0.76,11 - Machilipatnam (Andhra Pradesh),1,11
6.0,KOMMARAJU SIVA NARASIMHA RAO,All India Forward Bloc,5245,9,5254,0.4,11 - Machilipatnam (Andhra Pradesh),1,11
7.0,VALLABHANENI NAGA PAVAN KUMAR,Independent,5206,14,5220,0.4,11 - Machilipatnam (Andhra Pradesh),1,11
8.0,MARADANI K R SWAMY,Jai Maha Bharath Party,2206,8,2214,0.17,11 - Machilipatnam (Andhra Pradesh),1,11
9.0,GANDHI DHANEKULA,Independent,1989,2,1991,0.15,11 - Machilipatnam (Andhra Pradesh),1,11
10.0,PAMULA BALA SOWRYAMMA,Independent,1576,6,1582,0.12,11 - Machilipatnam (Andhra Pradesh),1,11
11.0,ANUSHA YERUVA,Independent,1233,2,1235,0.09,11 - Machilipatnam (Andhra Pradesh),1,11
12.0,GUDAVALLI VENKATA KEDARESWARA RAO,Independent,1102,9,1111,0.08,11 - Machilipatnam (Andhra Pradesh),1,11
13.0,JOGI VEERANJANEYULU,Independent,1020,2,1022,0.08,11 - Machilipatnam (Andhra Pradesh),1,11
14.0,DAMODARA RAO GUDAVALLI,Independent,928,2,930,0.07,11 - Machilipatnam (Andhra Pradesh),1,11
15.0,APPARAO ENNETI,Independent,625,1,626,0.05,11 - Machilipatnam (Andhra Pradesh),1,11
16.0,NOTA,None of the Above,12008,118,12126,0.92,11 - Machilipatnam (Andhra Pradesh),1,11
,Total,,1292057,19947,1312004,,11 - Machilipatnam (Andhra Pradesh),1,11
1.0,KESINENI SIVANATH (CHINNI),Telugu Desam,784722,9432,794154,58.21,12 - Vijayawada (Andhra Pradesh),1,12
2.0,KESINENI SRINIVAS (NANI),Yuvajana Sramika Rythu Congress Party,505637,6432,512069,37.53,12 - Vijayawada (Andhra Pradesh),1,12
3.0,BHARGAV VALLURU,Indian National Congress,23498,608,24106,1.77,12 - Vijayawada (Andhra Pradesh),1,12
4.0,KRISHNA KISHORE YANAMANDRA,Navataram Party,7710,168,7878,0.58,12 - Vijayawada (Andhra Pradesh),1,12
5.0,VENKATA ASHOK PAPPURI,Independent,6672,-,6672,0.49,12 - Vijayawada (Andhra Pradesh),1,12
6.0,DEVARAPALLI MALLIKARJUNA RAO (MAHESH),Independent,3199,-,3199,0.23,12 - Vijayawada (Andhra Pradesh),1,12
7.0,MEKA VENKATESWARA RAO,Bahujan Samaj Party,2184,49,2233,0.16,12 - Vijayawada (Andhra Pradesh),1,12
8.0,ANIL KUMAR MADDINENI,Independent,1240,-,1240,0.09,12 - Vijayawada (Andhra Pradesh),1,12
9.0,BARRE SREENIVASARAO (JAI BHEEM SRINIVAS),Telugu Rajadhikara Samiti Party,609,6,615,0.05,12 - Vijayawada (Andhra Pradesh),1,12
10.0,SYED KHAMURUNNISA,Navarang Congress Party,600,1,601,0.04,12 - Vijayawada (Andhra Pradesh),1,12
11.0,CHAGANTIPATI GANGADHAR GANDHI,Pyramid Party of India,486,3,489,0.04,12 - Vijayawada (Andhra Pradesh),1,12
12.0,DATLA LURTHU MERI,Jaibhim Rao Bharat Party,409,8,417,0.03,12 - Vijayawada (Andhra Pradesh),1,12
13.0,PERAM SIVA NAGESWARA RAO,Republican Party of India (Athawale),365,3,368,0.03,12 - Vijayawada (Andhra Pradesh),1,12
14.0,DEVARASETTY RAVEENDRA BABU,Andhra Rastra Praja Samithi,328,3,331,0.02,12 - Vijayawada (Andhra Pradesh),1,12
15.0,GUJJULA LALITHA,Socialist Unity Centre Of India (COMMUNIST),323,4,327,0.02,12 - Vijayawada (Andhra Pradesh),1,12
16.0,N DASARADHA RAMI REDDY,All India Jaihind Party,268,1,269,0.02,12 - Vijayawada (Andhra Pradesh),1,12
17.0,CHINTHALACHERUVU HEMALATHA,Jai Maha Bharath Party,239,5,244,0.02,12 - Vijayawada (Andhra Pradesh),1,12
18.0,NOTA,None of the Above,9038,155,9193,0.67,12 - Vijayawada (Andhra Pradesh),1,12
,Total,,1347527,16878,1364405,,12 - Vijayawada (Andhra Pradesh),1,12
1.0,DR CHANDRA SEKHAR PEMMASANI,Telugu Desam,851020,13928,864948,60.68,13 - Guntur (Andhra Pradesh),1,13
2.0,KILARI VENKATA ROSAIAH,Yuvajana Sramika Rythu Congress Party,513563,6690,520253,36.5,13 - Guntur (Andhra Pradesh),1,13
3.0,JANGALA AJAY KUMAR,Communist Party of India,8317,320,8637,0.61,13 - Guntur (Andhra Pradesh),1,13
4.0,SIVAREDDY. ENDREDDY,Navataram Party,5628,1,5629,0.39,13 - Guntur (Andhra Pradesh),1,13
5.0,TENALI PRAKASH,Bahujan Samaj Party,4172,100,4272,0.3,13 - Guntur (Andhra Pradesh),1,13
6.0,SIKHAKOLLI HEMA GOWRI SHANKAR,Jatiya Jana Sena Party,1959,5,1964,0.14,13 - Guntur (Andhra Pradesh),1,13
7.0,SAMUDRALA CHINNA KOTAIAH,Jaibhim Rao Bharat Party,1748,5,1753,0.12,13 - Guntur (Andhra Pradesh),1,13
8.0,UMAR BHASHA SHAIK,Jana Sahayaka Sakthi,1273,2,1275,0.09,13 - Guntur (Andhra Pradesh),1,13
9.0,SYED. SAIDA,Navarang Congress Party,1216,6,1222,0.09,13 - Guntur (Andhra Pradesh),1,13
10.0,AMBATI CHALAMAIAH,Pyramid Party of India,1029,2,1031,0.07,13 - Guntur (Andhra Pradesh),1,13
11.0,PILLI BABU RAO,Independent,688,4,692,0.05,13 - Guntur (Andhra Pradesh),1,13
12.0,HARI VENKATA SATISH KURNALA,Jai Bharat National Party,540,2,542,0.04,13 - Guntur (Andhra Pradesh),1,13
13.0,VISHNU REDDY LANKIREDDY,Bengaluru Nava Nirmana Party,461,-,461,0.03,13 - Guntur (Andhra Pradesh),1,13
14.0,EMANI. CHANDRASEKHAR RAO,Navodayam Party,409,5,414,0.03,13 - Guntur (Andhra Pradesh),1,13
15.0,SHAIK. KHAJAVALI,Independent,387,4,391,0.03,13 - Guntur (Andhra Pradesh),1,13
16.0,CHALLAPALLI RATAN RAJU,Viduthalai Chiruthaigal Katchi,374,4,378,0.03,13 - Guntur (Andhra Pradesh),1,13
17.0,KANNEBOYINA VAMSI KRISHNA YADAV,Independent,368,7,375,0.03,13 - Guntur (Andhra Pradesh),1,13
18.0,MOHAMMAD KHAJA MOINUDDIN CHISTI PASHA,Andhra Pradesh Rashtra Samithi,353,5,358,0.03,13 - Guntur (Andhra Pradesh),1,13
19.0,GAYATRI AUDHIPUDI,Independent,350,7,357,0.03,13 - Guntur (Andhra Pradesh),1,13
20.0,ASHOK ANAND GALI,Independent,335,-,335,0.02,13 - Guntur (Andhra Pradesh),1,13
21.0,SHAIK ASLAM AKTHER,Independent,334,1,335,0.02,13 - Guntur (Andhra Pradesh),1,13
22.0,PATHAN KHAJA (BASHA),Telugu Rajadhikara Samiti Party,328,4,332,0.02,13 - Guntur (Andhra Pradesh),1,13
23.0,AMARTHALURI VENKATESWARA RAO.,Marxist Communist Party of India (United),308,4,312,0.02,13 - Guntur (Andhra Pradesh),1,13
24.0,DR. RAYAPUDI RAJESH VIJAY KUMAR,Indian Labour Party (Ambedkar Phule),306,4,310,0.02,13 - Guntur (Andhra Pradesh),1,13
25.0,BURAGA RATNAM,Loktantrik Janta Dal,304,12,316,0.02,13 - Guntur (Andhra Pradesh),1,13
26.0,VANKAYALAPATI VENKATA SIVA RAMANJANEYULU,Independent,268,-,268,0.02,13 - Guntur (Andhra Pradesh),1,13
27.0,SIVA PARVATHI,Independent,262,4,266,0.02,13 - Guntur (Andhra Pradesh),1,13
28.0,BOMMASANI MUTYALA RAO,All Peoples Party,200,7,207,0.01,13 - Guntur (Andhra Pradesh),1,13
29.0,SRIKRISHNA AKKISETTI,Independent,179,-,179,0.01,13 - Guntur (Andhra Pradesh),1,13
30.0,MADAVARAPU NAGA RAJU,Independent,172,-,172,0.01,13 - Guntur (Andhra Pradesh),1,13
31.0,NOTA,None of the Above,7210,177,7387,0.52,13 - Guntur (Andhra Pradesh),1,13
,Total,,1404061,21310,1425371,,13 - Guntur (Andhra Pradesh),1,13
1.0,LAVU SRIKRISHNA DEVARAYALU,Telugu Desam,798097,9899,807996,53.88,14 - Narsaraopet (Andhra Pradesh),1,14
2.0,ANIL KUMAR POLUBOINA,Yuvajana Sramika Rythu Congress Party,642186,6081,648267,43.23,14 - Narsaraopet (Andhra Pradesh),1,14
3.0,GARNEPUDI ALEXANDER SUDHAKAR,Indian National Congress,17520,526,18046,1.2,14 - Narsaraopet (Andhra Pradesh),1,14
4.0,ORSU PREMARAJU,Bahujan Samaj Party,5276,33,5309,0.35,14 - Narsaraopet (Andhra Pradesh),1,14
5.0,KUCHIPUDI JOHN BABU,Jaibhim Rao Bharat Party,2328,8,2336,0.16,14 - Narsaraopet (Andhra Pradesh),1,14
6.0,GARLAPATI SUBHASH PREM,Revolutionary Socialist Party,1243,2,1245,0.08,14 - Narsaraopet (Andhra Pradesh),1,14
7.0,YAMPATI VEERANJANEYA REDDY,Independent,1056,1,1057,0.07,14 - Narsaraopet (Andhra Pradesh),1,14
8.0,SUBBARAO CHALLA,Independent,1051,-,1051,0.07,14 - Narsaraopet (Andhra Pradesh),1,14
9.0,ABDUL RAJAK SHAIK,Independent,718,5,723,0.05,14 - Narsaraopet (Andhra Pradesh),1,14
10.0,KOTA POTHURAJU,Pyramid Party of India,667,3,670,0.04,14 - Narsaraopet (Andhra Pradesh),1,14
11.0,P VENKATESH,Jaathia Chethi Vruthula Ikya Vedika Party,385,3,388,0.03,14 - Narsaraopet (Andhra Pradesh),1,14
12.0,PASUPULETI PICHAIAH,National Nava Kranthi Party,353,3,356,0.02,14 - Narsaraopet (Andhra Pradesh),1,14
13.0,PAPPULA SAMBASIVA RAO,Navarang Congress Party,331,1,332,0.02,14 - Narsaraopet (Andhra Pradesh),1,14
14.0,DOCTOR GODA RAMESH KUMAR,Jatiya Jana Sena Party,305,4,309,0.02,14 - Narsaraopet (Andhra Pradesh),1,14
15.0,THOKALA NAGA RAJU,All India Forward Bloc,277,8,285,0.02,14 - Narsaraopet (Andhra Pradesh),1,14
16.0,NOTA,None of the Above,11120,79,11199,0.75,14 - Narsaraopet (Andhra Pradesh),1,14
,Total,,1482913,16656,1499569,,14 - Narsaraopet (Andhra Pradesh),1,14
1.0,KRISHNA PRASAD TENNETI,Telugu Desam,706757,10736,717493,55.16,15 - Bapatla (SC) (Andhra Pradesh),1,15
2.0,NANDIGAM SURESH BABU,Yuvajana Sramika Rythu Congress Party,503816,5646,509462,39.17,15 - Bapatla (SC) (Andhra Pradesh),1,15
3.0,J.D. SEELAM,Indian National Congress,41673,1586,43259,3.33,15 - Bapatla (SC) (Andhra Pradesh),1,15
4.0,DOKKA JAGAN MOHANA RAO,Bahujan Samaj Party,6774,83,6857,0.53,15 - Bapatla (SC) (Andhra Pradesh),1,15
5.0,NALAMALA TIRUPATI RAO,Navataram Party,2888,76,2964,0.23,15 - Bapatla (SC) (Andhra Pradesh),1,15
6.0,BUSSA. NAGARAJU,Independent,1311,7,1318,0.1,15 - Bapatla (SC) (Andhra Pradesh),1,15
7.0,GADDE. VIJAYA LAKSHMI,Independent,1046,5,1051,0.08,15 - Bapatla (SC) (Andhra Pradesh),1,15
8.0,KATTAPOGU. VIJAY KUMAR,Pyramid Party of India,893,4,897,0.07,15 - Bapatla (SC) (Andhra Pradesh),1,15
9.0,KONDRU KIRAN KUMAR,Independent,791,6,797,0.06,15 - Bapatla (SC) (Andhra Pradesh),1,15
10.0,KATTA ANAND BABU,Independent,704,25,729,0.06,15 - Bapatla (SC) (Andhra Pradesh),1,15
11.0,MERUGUPALA SADASIVA RAO,India Praja Bandhu Party,669,4,673,0.05,15 - Bapatla (SC) (Andhra Pradesh),1,15
12.0,KATTA HEMANAND,Independent,547,2,549,0.04,15 - Bapatla (SC) (Andhra Pradesh),1,15
13.0,PARRE. KOTAIAH,Jaibhim Rao Bharat Party,408,4,412,0.03,15 - Bapatla (SC) (Andhra Pradesh),1,15
14.0,PALADUG VIJENDRA RAO (BAHUJAN),Liberation Congress Party,294,12,306,0.02,15 - Bapatla (SC) (Andhra Pradesh),1,15
15.0,CHINNAM MURALIDHAR,All Peoples Party,252,3,255,0.02,15 - Bapatla (SC) (Andhra Pradesh),1,15
16.0,NOTA,None of the Above,13599,124,13723,1.06,15 - Bapatla (SC) (Andhra Pradesh),1,15
,Total,,1282422,18323,1300745,,15 - Bapatla (SC) (Andhra Pradesh),1,15
1.0,MAGUNTA SREENIVASULU REDDY,Telugu Desam,689829,12065,701894,49.35,16 - Ongole (Andhra Pradesh),1,16
2.0,DR CHEVIREDDY BHASKAR REDD,Yuvajana Sramika Rythu Congress Party,644052,7643,651695,45.82,16 - Ongole (Andhra Pradesh),1,16
3.0,EDA SUDHAKARA REDDY,Indian National Congress,25803,919,26722,1.88,16 - Ongole (Andhra Pradesh),1,16
4.0,DHARANIKOTA LAKSHMI NARAYANA,Bahujan Samaj Party,6238,76,6314,0.44,16 - Ongole (Andhra Pradesh),1,16
5.0,BUCHI EDUKONDALU,Independent,3046,2,3048,0.21,16 - Ongole (Andhra Pradesh),1,16
6.0,PODILI RAMBABU,Independent,3035,38,3073,0.22,16 - Ongole (Andhra Pradesh),1,16
7.0,ORSU VEENA,Jai Bharat National Party,2242,25,2267,0.16,16 - Ongole (Andhra Pradesh),1,16
8.0,BONTHA RANGA REDDY,Independent,1923,-,1923,0.14,16 - Ongole (Andhra Pradesh),1,16
9.0,BODDU KRANTHI KUMAR,Independent,1797,1,1798,0.13,16 - Ongole (Andhra Pradesh),1,16
10.0,MOHAN GOUD J V,Independent,1442,5,1447,0.1,16 - Ongole (Andhra Pradesh),1,16
11.0,U MADHU BABU,Independent,1006,2,1008,0.07,16 - Ongole (Andhra Pradesh),1,16
12.0,KARATAPU RAJU,Independent,730,5,735,0.05,16 - Ongole (Andhra Pradesh),1,16
13.0,JAGADEESH RAYAPATI,Independent,713,12,725,0.05,16 - Ongole (Andhra Pradesh),1,16
14.0,DEVIREDDY BALANJANEYULU,Independent,710,6,716,0.05,16 - Ongole (Andhra Pradesh),1,16
15.0,HARI PRASAD TUPAKULA,Independent,706,5,711,0.05,16 - Ongole (Andhra Pradesh),1,16
16.0,PASAM VENKATESWARLU YADAV,Samajwadi Party,699,44,743,0.05,16 - Ongole (Andhra Pradesh),1,16
17.0,SURYA TEJA KOTA,Pyramid Party of India,674,9,683,0.05,16 - Ongole (Andhra Pradesh),1,16
18.0,AKUMALLA MALLIKARJUNA REDDY,Independent,575,-,575,0.04,16 - Ongole (Andhra Pradesh),1,16
19.0,VESHAPOGU GURAVABABU,Independent,457,4,461,0.03,16 - Ongole (Andhra Pradesh),1,16
20.0,KOMMU YOHANU,Liberation Congress Party,454,7,461,0.03,16 - Ongole (Andhra Pradesh),1,16
21.0,SESHUBABU GUDDANTI,Independent,449,-,449,0.03,16 - Ongole (Andhra Pradesh),1,16
22.0,SINGAMNENI SREEKANTH,Independent,407,3,410,0.03,16 - Ongole (Andhra Pradesh),1,16
23.0,YARRA DASARADHARAMAIAH,Independent,394,-,394,0.03,16 - Ongole (Andhra Pradesh),1,16
24.0,KOTA VAMSI KRISHNA,Independent,365,-,365,0.03,16 - Ongole (Andhra Pradesh),1,16
25.0,K PAVAN KALYAN,Jatiya Jana Sena Party,362,30,392,0.03,16 - Ongole (Andhra Pradesh),1,16
26.0,NOTA,None of the Above,13066,139,13205,0.93,16 - Ongole (Andhra Pradesh),1,16
,Total,,1401174,21040,1422214,,16 - Ongole (Andhra Pradesh),1,16
1.0,DR BYREDDY SHABARI,Telugu Desam,689417,11714,701131,49.92,17 - Nandyal (Andhra Pradesh),1,17
2.0,POCHA BRAHMANANDA REDDY,Yuvajana Sramika Rythu Congress Party,583155,6001,589156,41.95,17 - Nandyal (Andhra Pradesh),1,17
3.0,J LAKSHMI NARASIMHA YADAV,Indian National Congress,54920,1284,56204,4.0,17 - Nandyal (Andhra Pradesh),1,17
4.0,P GURUVAIAH,Independent,8190,1,8191,0.58,17 - Nandyal (Andhra Pradesh),1,17
5.0,A CHINNA MOULALI,Bahujan Samaj Party,7768,63,7831,0.56,17 - Nandyal (Andhra Pradesh),1,17
6.0,HAFIZ ATAULLAH KHAN,Social Democratic Party Of India,6858,74,6932,0.49,17 - Nandyal (Andhra Pradesh),1,17
7.0,KOMMUSANI PEDDA KAMBAGIRI SWAMY,Independent,4633,-,4633,0.33,17 - Nandyal (Andhra Pradesh),1,17
8.0,GAGGERA VENKATA RAMANAIAH,Independent,3027,4,3031,0.22,17 - Nandyal (Andhra Pradesh),1,17
9.0,DUMAVATH SWAMY NAIK,Independent,2348,10,2358,0.17,17 - Nandyal (Andhra Pradesh),1,17
10.0,KUNUKUNTLA RAMUDU,Independent,1408,5,1413,0.1,17 - Nandyal (Andhra Pradesh),1,17
11.0,E ANIL KUMAR,Independent,1332,2,1334,0.09,17 - Nandyal (Andhra Pradesh),1,17
12.0,C SURENDRA NATHA REDDY,Independent,1267,1,1268,0.09,17 - Nandyal (Andhra Pradesh),1,17
13.0,BRAHMANANDA REDDY K,Independent,1261,11,1272,0.09,17 - Nandyal (Andhra Pradesh),1,17
14.0,UPPU SUBBARAYUDU,Jaathia Chethi Vruthula Ikya Vedika Party,785,6,791,0.06,17 - Nandyal (Andhra Pradesh),1,17
15.0,NAGESWARA RAO,Independent,678,2,680,0.05,17 - Nandyal (Andhra Pradesh),1,17
16.0,VIJAYA BHASKAR REDDYPOGU,Independent,641,-,641,0.05,17 - Nandyal (Andhra Pradesh),1,17
17.0,YELAMPALLE GOVARDHAN REDDY,All India Forward Bloc,638,4,642,0.05,17 - Nandyal (Andhra Pradesh),1,17
18.0,BHUMA VEERA BHADRA REDDY,Navarang Congress Party,630,16,646,0.05,17 - Nandyal (Andhra Pradesh),1,17
19.0,PANDU RANGA YADAV SIDDAPU,Samajwadi Party,594,11,605,0.04,17 - Nandyal (Andhra Pradesh),1,17
20.0,CHANDINI REDDY VAKATI,Liberation Congress Party,546,10,556,0.04,17 - Nandyal (Andhra Pradesh),1,17
21.0,B C RAMANADHA AREDDY,Independent,472,-,472,0.03,17 - Nandyal (Andhra Pradesh),1,17
22.0,GAJULA SHALIMIYA,Anna YSR Congress Party,468,18,486,0.03,17 - Nandyal (Andhra Pradesh),1,17
23.0,KULURU RAMA KRISHNA REDDY,Neethi Nijayithi Party,428,2,430,0.03,17 - Nandyal (Andhra Pradesh),1,17
24.0,CH P MALLESWARUDU,Independent,417,4,421,0.03,17 - Nandyal (Andhra Pradesh),1,17
25.0,I V PAKKIR REDDY,Independent,408,2,410,0.03,17 - Nandyal (Andhra Pradesh),1,17
26.0,V MADHUSUDHANA REDDY,Independent,399,2,401,0.03,17 - Nandyal (Andhra Pradesh),1,17
27.0,BUSHAKU MAHESWARA REDDY,Independent,390,-,390,0.03,17 - Nandyal (Andhra Pradesh),1,17
28.0,U P MUNI REDDY,Independent,376,-,376,0.03,17 - Nandyal (Andhra Pradesh),1,17
29.0,GOGULA SUGUNAMMA,Jai Maha Bharath Party,375,4,379,0.03,17 - Nandyal (Andhra Pradesh),1,17
30.0,BELLAMKONDA SREENIVASULU,Independent,352,1,353,0.03,17 - Nandyal (Andhra Pradesh),1,17
31.0,BALIJA SHIVA KUMAR,Independent,288,-,288,0.02,17 - Nandyal (Andhra Pradesh),1,17
32.0,NOTA,None of the Above,10538,159,10697,0.76,17 - Nandyal (Andhra Pradesh),1,17
,Total,,1385007,19411,1404418,,17 - Nandyal (Andhra Pradesh),1,17
1.0,BASTIPATI NAGARAJU PANCHALINGALA,Telugu Desam,650335,8579,658914,49.51,18 - Kurnoolu (Andhra Pradesh),1,18
2.0,B Y RAMAIAH,Yuvajana Sramika Rythu Congress Party,543801,3815,547616,41.15,18 - Kurnoolu (Andhra Pradesh),1,18
3.0,P.G.RAMPULLAIAH YADAV LUCKY-2,Indian National Congress,68972,1401,70373,5.29,18 - Kurnoolu (Andhra Pradesh),1,18
4.0,MANCHALA LAKSHMI NARAYANA,Bahujan Samaj Party,8533,56,8589,0.65,18 - Kurnoolu (Andhra Pradesh),1,18
5.0,BOYA SURESH,Independent,5891,9,5900,0.44,18 - Kurnoolu (Andhra Pradesh),1,18
6.0,T. BEECHUPALLI,Independent,5125,2,5127,0.39,18 - Kurnoolu (Andhra Pradesh),1,18
7.0,VIJAYA BHASKAR .REDDYPOGU,Independent,3504,4,3508,0.26,18 - Kurnoolu (Andhra Pradesh),1,18
8.0,PAGADALA KODANDA,Independent,3070,6,3076,0.23,18 - Kurnoolu (Andhra Pradesh),1,18
9.0,DEVARAPOGU MADDILETY,Independent,2576,6,2582,0.19,18 - Kurnoolu (Andhra Pradesh),1,18
10.0,PRAKASH REDDY RALAMPADU,Independent,2222,3,2225,0.17,18 - Kurnoolu (Andhra Pradesh),1,18
11.0,JAHANGIR AHMED,Social Democratic Party Of India,2058,16,2074,0.16,18 - Kurnoolu (Andhra Pradesh),1,18
12.0,DR. REDDYPOGU PRAVEEN KUMAR,Independent,1847,9,1856,0.14,18 - Kurnoolu (Andhra Pradesh),1,18
13.0,ABDUL SATTAR A.S.R,Anna YSR Congress Party,1565,36,1601,0.12,18 - Kurnoolu (Andhra Pradesh),1,18
14.0,VALMIKI ARJUNA,Bharatha Chaitanya Yuvajana Party,1385,5,1390,0.1,18 - Kurnoolu (Andhra Pradesh),1,18
15.0,URUKUNDU VADDE,Independent,1284,11,1295,0.1,18 - Kurnoolu (Andhra Pradesh),1,18
16.0,MALLEPOGU NAGANNA,Socialist Unity Centre Of India (COMMUNIST),1162,2,1164,0.09,18 - Kurnoolu (Andhra Pradesh),1,18
17.0,SUNKARA SREEDHAR,Jai Bharat National Party,1149,14,1163,0.09,18 - Kurnoolu (Andhra Pradesh),1,18
18.0,TARIGOPULA RAJABABU,All Peoples Party,1032,1,1033,0.08,18 - Kurnoolu (Andhra Pradesh),1,18
19.0,AMRUTH KUMAR SALKAPURAM,Liberation Congress Party,777,6,783,0.06,18 - Kurnoolu (Andhra Pradesh),1,18
20.0,NOTA,None of the Above,10394,117,10511,0.79,18 - Kurnoolu (Andhra Pradesh),1,18
,Total,,1316682,14098,1330780,,18 - Kurnoolu (Andhra Pradesh),1,18
1.0,AMBICA G LAKSHMINARAYANA VALMIKI,Telugu Desam,755862,12383,768245,53.33,19 - Ananthapur (Andhra Pradesh),1,19
2.0,MALAGUNDLA SANKAR NARAYANA,Yuvajana Sramika Rythu Congress Party,573769,5921,579690,40.24,19 - Ananthapur (Andhra Pradesh),1,19
3.0,MALLIKARJUNA VAJJALA,Indian National Congress,41954,1263,43217,3.0,19 - Ananthapur (Andhra Pradesh),1,19
4.0,G.V.RAMANA REDDY,Independent,6436,3,6439,0.45,19 - Ananthapur (Andhra Pradesh),1,19
5.0,BANASI NARAYANAPPA,Bahujan Samaj Party,6280,116,6396,0.44,19 - Ananthapur (Andhra Pradesh),1,19
6.0,V.MURALI PRASAD REDDY,Independent,5775,3,5778,0.4,19 - Ananthapur (Andhra Pradesh),1,19
7.0,DR.NALLANI RAMESH NAIDU,Andhra Rastra Praja Samithi,4862,127,4989,0.35,19 - Ananthapur (Andhra Pradesh),1,19
8.0,M.SURENDRA,Pyramid Party of India,2927,8,2935,0.2,19 - Ananthapur (Andhra Pradesh),1,19
9.0,U.C.VENKATASUBBAIAH,Jaathia Chethi Vruthula Ikya Vedika Party,2533,7,2540,0.18,19 - Ananthapur (Andhra Pradesh),1,19
10.0,P.CHOWDESWARI,Independent,1514,4,1518,0.11,19 - Ananthapur (Andhra Pradesh),1,19
11.0,VADLA KESAVAIAH,Independent,1488,6,1494,0.1,19 - Ananthapur (Andhra Pradesh),1,19
12.0,B.RAGHAVENDRA PRASAD,Independent,1317,1,1318,0.09,19 - Ananthapur (Andhra Pradesh),1,19
13.0,KETHIREDDY RAGHUNATHAREDDY,Independent,1086,5,1091,0.08,19 - Ananthapur (Andhra Pradesh),1,19
14.0,LOKANATH GOWD SURAGOWINI,Independent,1085,6,1091,0.08,19 - Ananthapur (Andhra Pradesh),1,19
15.0,SREERANGARAJULA GOPINATH ROYAL,Independent,903,1,904,0.06,19 - Ananthapur (Andhra Pradesh),1,19
16.0,SHAIK.NIZAM,Samajwadi Party,749,4,753,0.05,19 - Ananthapur (Andhra Pradesh),1,19
17.0,RAMAVTH CHINNA RAMAPPA NAIK,Jaibhim Rao Bharat Party,735,10,745,0.05,19 - Ananthapur (Andhra Pradesh),1,19
18.0,KURUBA MALLIKARJUNA.S.,All India Kisan Janatha party,574,4,578,0.04,19 - Ananthapur (Andhra Pradesh),1,19
19.0,B.NAGAMUTHYALU,Socialist Unity Centre Of India (COMMUNIST),566,4,570,0.04,19 - Ananthapur (Andhra Pradesh),1,19
20.0,SRINIVASA RAJU.O,Bhartiya Panchyat Party,489,5,494,0.03,19 - Ananthapur (Andhra Pradesh),1,19
21.0,DURGA PRASAD D BYATARAYANAJI,Challengers Party,439,5,444,0.03,19 - Ananthapur (Andhra Pradesh),1,19
22.0,NOTA,None of the Above,9014,185,9199,0.64,19 - Ananthapur (Andhra Pradesh),1,19
,Total,,1420357,20071,1440428,,19 - Ananthapur (Andhra Pradesh),1,19
1.0,B K PARTHASARATHI,Telugu Desam,713013,12521,725534,51.23,20 - Hindupur (Andhra Pradesh),1,20
2.0,J SHANTHA,Yuvajana Sramika Rythu Congress Party,587406,5701,593107,41.88,20 - Hindupur (Andhra Pradesh),1,20
3.0,B A SAMAD SHAHEEN,Indian National Congress,53989,1070,55059,3.89,20 - Hindupur (Andhra Pradesh),1,20
4.0,BHAGYA R S,Bahujan Samaj Party,7949,66,8015,0.57,20 - Hindupur (Andhra Pradesh),1,20
5.0,PRATHAP REDDY GORLA,Independent,5380,64,5444,0.38,20 - Hindupur (Andhra Pradesh),1,20
6.0,H D HANUMANTHE GOWD,Independent,2270,8,2278,0.16,20 - Hindupur (Andhra Pradesh),1,20
7.0,ANJINAPPA GARI SREENIVASULU,Revolutionary Socialist Party,2045,6,2051,0.14,20 - Hindupur (Andhra Pradesh),1,20
8.0,S N SURESH,Independent,1611,20,1631,0.12,20 - Hindupur (Andhra Pradesh),1,20
9.0,DASAGANIPALLI KULLAYAPPA,Independent,1317,11,1328,0.09,20 - Hindupur (Andhra Pradesh),1,20
10.0,ASHOK,Socialist Unity Centre Of India (COMMUNIST),1282,10,1292,0.09,20 - Hindupur (Andhra Pradesh),1,20
11.0,T SUDHAKAR REDDY,Independent,1227,10,1237,0.09,20 - Hindupur (Andhra Pradesh),1,20
12.0,S RAGHUNATHA REDDY,Independent,693,17,710,0.05,20 - Hindupur (Andhra Pradesh),1,20
13.0,BUDILI DHANUNJAYA,National Nava Kranthi Party,679,3,682,0.05,20 - Hindupur (Andhra Pradesh),1,20
14.0,NOTA,None of the Above,17826,145,17971,1.27,20 - Hindupur (Andhra Pradesh),1,20
,Total,,1396687,19652,1416339,,20 - Hindupur (Andhra Pradesh),1,20
1.0,Y. S. AVINASH REDDY,Yuvajana Sramika Rythu Congress Party,598406,6737,605143,45.78,21 - Kadapa (Andhra Pradesh),1,21
2.0,CHADIPIRALLA BHUPESH SUBBARAMI REDDY,Telugu Desam,532358,10090,542448,41.03,21 - Kadapa (Andhra Pradesh),1,21
3.0,Y.S. SHARMILA REDDY,Indian National Congress,136395,4644,141039,10.67,21 - Kadapa (Andhra Pradesh),1,21
4.0,PANDITI. GURAPPA.,Bahujan Samaj Party,3790,20,3810,0.29,21 - Kadapa (Andhra Pradesh),1,21
5.0,VENU GOPAL RACHINENI,Rashtriya Praja Congress (Secular),3500,70,3570,0.27,21 - Kadapa (Andhra Pradesh),1,21
6.0,CHINNAPUREDDY GOPALA KRISHNA REDDY,Independent,2414,16,2430,0.18,21 - Kadapa (Andhra Pradesh),1,21
7.0,KUNCHAM. VENKATA SUBBA REDDY,Rayalaseema Rashtra Samithi,2329,4,2333,0.18,21 - Kadapa (Andhra Pradesh),1,21
8.0,L. KHAJA HUSSAIN,Independent,1087,1,1088,0.08,21 - Kadapa (Andhra Pradesh),1,21
9.0,ANKIREDDY. SURESH KUMAR REDDY.,All India Forward Bloc,752,3,755,0.06,21 - Kadapa (Andhra Pradesh),1,21
10.0,KAKARLA SHANMUKHA REDDY,Independent,633,14,647,0.05,21 - Kadapa (Andhra Pradesh),1,21
11.0,PALLE RAMESH,Jaibhim Rao Bharat Party,619,5,624,0.05,21 - Kadapa (Andhra Pradesh),1,21
12.0,CHAN BASHA. S,Anna YSR Congress Party,432,7,439,0.03,21 - Kadapa (Andhra Pradesh),1,21
13.0,J. V. RAMANA,Jaathia Chethi Vruthula Ikya Vedika Party,414,20,434,0.03,21 - Kadapa (Andhra Pradesh),1,21
14.0,MALIKIREDDY. HANUMANTHA REDDY,Jana Sahayaka Sakthi,358,11,369,0.03,21 - Kadapa (Andhra Pradesh),1,21
15.0,NOTA,None of the Above,16660,186,16846,1.27,21 - Kadapa (Andhra Pradesh),1,21
,Total,,1300147,21828,1321975,,21 - Kadapa (Andhra Pradesh),1,21
1.0,PRABHAKAR REDDY VEMIREDDY,Telugu Desam,750771,15431,766202,55.7,22 - Nellore (Andhra Pradesh),1,22
2.0,VENUMBAKA VIJAYASAI REDDY,Yuvajana Sramika Rythu Congress Party,514375,5925,520300,37.82,22 - Nellore (Andhra Pradesh),1,22
3.0,KOPPULA RAJU,Indian National Congress,53264,1580,54844,3.99,22 - Nellore (Andhra Pradesh),1,22
4.0,BHASKAR NASINA,Bahujan Samaj Party,5710,101,5811,0.42,22 - Nellore (Andhra Pradesh),1,22
5.0,VIVEKA MANNEPALLI,Revolutionary Socialist Party,2794,10,2804,0.2,22 - Nellore (Andhra Pradesh),1,22
6.0,KOPPALA RAGHU,Independent,2010,5,2015,0.15,22 - Nellore (Andhra Pradesh),1,22
7.0,GAJULA SOMA SEKHAR,Jai Bharat National Party,1775,4,1779,0.13,22 - Nellore (Andhra Pradesh),1,22
8.0,SHAIK MUZIBUR RAHAMAN,Pyramid Party of India,1315,15,1330,0.1,22 - Nellore (Andhra Pradesh),1,22
9.0,SHAIK MAHABOOB BASHA (MABU),Republican Party of India (A),1228,5,1233,0.09,22 - Nellore (Andhra Pradesh),1,22
10.0,MALLEPALLY RAGHU,Navarang Congress Party,1104,1,1105,0.08,22 - Nellore (Andhra Pradesh),1,22
11.0,SHAIK SHAFI AHMED,All India Forward Bloc,1037,-,1037,0.08,22 - Nellore (Andhra Pradesh),1,22
12.0,NAKKA DINESH,Bharatha Chaitanya Yuvajana Party,576,24,600,0.04,22 - Nellore (Andhra Pradesh),1,22
13.0,TALARI VENKATAIAH,Jaibhim Rao Bharat Party,553,5,558,0.04,22 - Nellore (Andhra Pradesh),1,22
14.0,PUNGANURU PRASANNA GANAPATHI,Radical Party of India (Ambedkarist),452,2,454,0.03,22 - Nellore (Andhra Pradesh),1,22
15.0,NOTA,None of the Above,15454,123,15577,1.13,22 - Nellore (Andhra Pradesh),1,22
,Total,,1352418,23231,1375649,,22 - Nellore (Andhra Pradesh),1,22
1.0,GURUMOORTHY MADDILA,Yuvajana Sramika Rythu Congress Party,626702,5526,632228,45.73,23 - Thirupathi(SC) (Andhra Pradesh),1,23
2.0,VARA PRASAD RAO VELAGAPALLI,Bharatiya Janata Party,608494,9165,617659,44.67,23 - Thirupathi(SC) (Andhra Pradesh),1,23
3.0,CHINTA MOHAN,Indian National Congress,63790,1733,65523,4.74,23 - Thirupathi(SC) (Andhra Pradesh),1,23
4.0,PENUMURU. GURAPPA,Bahujan Samaj Party,10300,206,10506,0.76,23 - Thirupathi(SC) (Andhra Pradesh),1,23
5.0,KATTAMANCHI. PRABHAKAR,Independent,5796,6,5802,0.42,23 - Thirupathi(SC) (Andhra Pradesh),1,23
6.0,M UMADEVI,Janata Congress,5387,38,5425,0.39,23 - Thirupathi(SC) (Andhra Pradesh),1,23
7.0,ALLAM.RAJA,Independent,4948,22,4970,0.36,23 - Thirupathi(SC) (Andhra Pradesh),1,23
8.0,VIJAY KUMAR G.SRKR,Liberation Congress Party,4108,194,4302,0.31,23 - Thirupathi(SC) (Andhra Pradesh),1,23
9.0,ANJAIAH.P,Republican Party of India (A),3657,9,3666,0.27,23 - Thirupathi(SC) (Andhra Pradesh),1,23
10.0,V.C. NAVEEN GUPTA,Independent,1723,8,1731,0.13,23 - Thirupathi(SC) (Andhra Pradesh),1,23
11.0,A. VARAPRASAD,Jatiya Jana Sena Party,1668,30,1698,0.12,23 - Thirupathi(SC) (Andhra Pradesh),1,23
12.0,SYAMDHAN KURAPATI,Aihra National Party,1567,1,1568,0.11,23 - Thirupathi(SC) (Andhra Pradesh),1,23
13.0,C. PUNYAMURTHY,United Republican Party of India,1511,4,1515,0.11,23 - Thirupathi(SC) (Andhra Pradesh),1,23
14.0,KARRA SIVA,Pyramid Party of India,1501,9,1510,0.11,23 - Thirupathi(SC) (Andhra Pradesh),1,23
15.0,VELURU. THEJOVATHI,Samajwadi Party,1362,27,1389,0.1,23 - Thirupathi(SC) (Andhra Pradesh),1,23
16.0,C. DAVID,Indian Believers Party (IBP),1237,2,1239,0.09,23 - Thirupathi(SC) (Andhra Pradesh),1,23
17.0,K. JEEVARATHNAM,Independent,1203,1,1204,0.09,23 - Thirupathi(SC) (Andhra Pradesh),1,23
18.0,DASARI. GOWTHAM,Independent,1077,10,1087,0.08,23 - Thirupathi(SC) (Andhra Pradesh),1,23
19.0,VIJAYA KUMAR.G,Independent,797,4,801,0.06,23 - Thirupathi(SC) (Andhra Pradesh),1,23
20.0,A. MADHU,Jai Hindustan Party,711,-,711,0.05,23 - Thirupathi(SC) (Andhra Pradesh),1,23
21.0,B. BHARANI BAS,Ambedkar National Congress,688,-,688,0.05,23 - Thirupathi(SC) (Andhra Pradesh),1,23
22.0,Y. MAHESH,Independent,615,7,622,0.04,23 - Thirupathi(SC) (Andhra Pradesh),1,23
23.0,PRASAD PATIBANDLA,Independent,607,1,608,0.04,23 - Thirupathi(SC) (Andhra Pradesh),1,23
24.0,NOTA,None of the Above,15909,209,16118,1.17,23 - Thirupathi(SC) (Andhra Pradesh),1,23
,Total,,1365358,17212,1382570,,23 - Thirupathi(SC) (Andhra Pradesh),1,23
1.0,P V MIDHUN REDDY,Yuvajana Sramika Rythu Congress Party,639111,5733,644844,48.38,24 - Rajampet (Andhra Pradesh),1,24
2.0,NALLARI KIRAN KUMAR REDDY,Bharatiya Janata Party,557030,11743,568773,42.67,24 - Rajampet (Andhra Pradesh),1,24
3.0,SHAIK BASHEED,Indian National Congress,52229,1071,53300,4.0,24 - Rajampet (Andhra Pradesh),1,24
4.0,ABBAVARAM UGENDRA,Bahujan Samaj Party,12306,57,12363,0.93,24 - Rajampet (Andhra Pradesh),1,24
5.0,POOLA REDDY SEKHAR,Independent,6097,3,6100,0.46,24 - Rajampet (Andhra Pradesh),1,24
6.0,NAGARAJU JETTI,Independent,5984,15,5999,0.45,24 - Rajampet (Andhra Pradesh),1,24
7.0,PRADEEP PENAMADU,All India Forward Bloc,5671,1,5672,0.43,24 - Rajampet (Andhra Pradesh),1,24
8.0,CHOUDVARAM SUBBANARASAIAH,Independent,4731,4,4735,0.36,24 - Rajampet (Andhra Pradesh),1,24
9.0,PULI SREENIVASULU,Independent,4613,3,4616,0.35,24 - Rajampet (Andhra Pradesh),1,24
10.0,SREENIVASULU MARRIPATI,Independent,4436,7,4443,0.33,24 - Rajampet (Andhra Pradesh),1,24
11.0,AKBAR M BASHA,Anna YSR Congress Party,2394,17,2411,0.18,24 - Rajampet (Andhra Pradesh),1,24
12.0,SANGARAJU NAGESWARA RAJU,Independent,1523,12,1535,0.12,24 - Rajampet (Andhra Pradesh),1,24
13.0,MADA RAJA,Jaathia Chethi Vruthula Ikya Vedika Party,1415,-,1415,0.11,24 - Rajampet (Andhra Pradesh),1,24
14.0,BATTHALA RAMANAIAH,Jai Bharat National Party,1360,6,1366,0.1,24 - Rajampet (Andhra Pradesh),1,24
15.0,DODDAPANENI RAJA NAIDU,Independent,1315,3,1318,0.1,24 - Rajampet (Andhra Pradesh),1,24
16.0,MAYANA MOHAMMED SALMAN KHAN,Liberation Congress Party,1069,2,1071,0.08,24 - Rajampet (Andhra Pradesh),1,24
17.0,KASTURI OBAIAH NAIDU,Independent,885,2,887,0.07,24 - Rajampet (Andhra Pradesh),1,24
18.0,ASADI VENKATADRI,Independent,689,2,691,0.05,24 - Rajampet (Andhra Pradesh),1,24
19.0,NOTA,None of the Above,11324,76,11400,0.86,24 - Rajampet (Andhra Pradesh),1,24
,Total,,1314182,18757,1332939,,24 - Rajampet (Andhra Pradesh),1,24
1.0,DAGGUMALLA PRASADA RAO,Telugu Desam,765536,12535,778071,54.84,25 - Chittoor(SC) (Andhra Pradesh),1,25
2.0,REDDEPPA.N .,Yuvajana Sramika Rythu Congress Party,552469,5123,557592,39.3,25 - Chittoor(SC) (Andhra Pradesh),1,25
3.0,MOTUKUR JAGAPATHI,Indian National Congress,29431,719,30150,2.12,25 - Chittoor(SC) (Andhra Pradesh),1,25
4.0,THOGURU VIJAYA KUMAR,Bahujan Samaj Party,13389,122,13511,0.95,25 - Chittoor(SC) (Andhra Pradesh),1,25
5.0,YUGANDAR . KONDA,Independent,6889,84,6973,0.49,25 - Chittoor(SC) (Andhra Pradesh),1,25
6.0,K.MUNI KRISHNA,Independent,3954,2,3956,0.28,25 - Chittoor(SC) (Andhra Pradesh),1,25
7.0,P.JANAKI RAMA RAO ( BABU),National Maha Sabha Party,2822,11,2833,0.2,25 - Chittoor(SC) (Andhra Pradesh),1,25
8.0,PETA.MOHAN .,Independent,2365,1,2366,0.17,25 - Chittoor(SC) (Andhra Pradesh),1,25
9.0,C.SUDHAKAR,Independent,1934,1,1935,0.14,25 - Chittoor(SC) (Andhra Pradesh),1,25
10.0,N.CHANDRABABU,Independent,1878,7,1885,0.13,25 - Chittoor(SC) (Andhra Pradesh),1,25
11.0,MADASI SUDHARSHAN,Independent,1575,3,1578,0.11,25 - Chittoor(SC) (Andhra Pradesh),1,25
12.0,D.MAHESH,Independent,1109,10,1119,0.08,25 - Chittoor(SC) (Andhra Pradesh),1,25
13.0,P.MADHU,Independent,902,4,906,0.06,25 - Chittoor(SC) (Andhra Pradesh),1,25
14.0,N.BHUPATHI,Independent,862,32,894,0.06,25 - Chittoor(SC) (Andhra Pradesh),1,25
15.0,A. PURNA CHANDRA,Independent,856,1,857,0.06,25 - Chittoor(SC) (Andhra Pradesh),1,25
16.0,PALLIPATTU.ABHINAV VISHNU,Samajwadi Party,670,6,676,0.05,25 - Chittoor(SC) (Andhra Pradesh),1,25
17.0,N.GANGAIAH .,Independent,547,5,552,0.04,25 - Chittoor(SC) (Andhra Pradesh),1,25
18.0,T NARESH,Independent,532,2,534,0.04,25 - Chittoor(SC) (Andhra Pradesh),1,25
19.0,BANDAPALLI RAMESH,Independent,490,3,493,0.03,25 - Chittoor(SC) (Andhra Pradesh),1,25
20.0,NOTA,None of the Above,11812,164,11976,0.84,25 - Chittoor(SC) (Andhra Pradesh),1,25
,Total,,1400022,18835,1418857,,25 - Chittoor(SC) (Andhra Pradesh),1,25
1.0,KIREN RIJIJU,Bharatiya Janata Party,196415,9002,205417,51.38,1 - Arunachal West (Arunachal Pradesh),2,1
2.0,NABAM TUKI,Indian National Congress,100100,4579,104679,26.18,1 - Arunachal West (Arunachal Pradesh),2,1
3.0,TECHI RANA,Independent,31106,2208,33314,8.33,1 - Arunachal West (Arunachal Pradesh),2,1
4.0,TOKO SHEETAL,Gana Suraksha Party,27670,2860,30530,7.64,1 - Arunachal West (Arunachal Pradesh),2,1
5.0,BIMPAK SIGA,Independent,10569,949,11518,2.88,1 - Arunachal West (Arunachal Pradesh),2,1
6.0,RUHI TAGUNG,Independent,7559,262,7821,1.96,1 - Arunachal West (Arunachal Pradesh),2,1
7.0,LEKI NORBU,Independent,2139,132,2271,0.57,1 - Arunachal West (Arunachal Pradesh),2,1
8.0,TANIA JUNE,Independent,1920,38,1958,0.49,1 - Arunachal West (Arunachal Pradesh),2,1
9.0,NOTA,None of the Above,2133,163,2296,0.57,1 - Arunachal West (Arunachal Pradesh),2,1
,Total,,379611,20193,399804,,1 - Arunachal West (Arunachal Pradesh),2,1
1.0,TAPIR GAO,Bharatiya Janata Party,140715,4866,145581,45.01,2 - Arunachal East (Arunachal Pradesh),2,2
2.0,BOSIRAM SIRAM,Indian National Congress,109433,5727,115160,35.6,2 - Arunachal East (Arunachal Pradesh),2,2
3.0,TAMAT GAMOH,Independent,26691,912,27603,8.53,2 - Arunachal East (Arunachal Pradesh),2,2
4.0,SOTAI KRI,Independent,13227,986,14213,4.39,2 - Arunachal East (Arunachal Pradesh),2,2
5.0,OMAK NITIK,Independent,9074,295,9369,2.9,2 - Arunachal East (Arunachal Pradesh),2,2
6.0,BANDEY MILI,Arunachal Democratic Party,6419,203,6622,2.05,2 - Arunachal East (Arunachal Pradesh),2,2
7.0,NOTA,None of the Above,4654,241,4895,1.51,2 - Arunachal East (Arunachal Pradesh),2,2
,Total,,310213,13230,323443,,2 - Arunachal East (Arunachal Pradesh),2,2
1.0,JOYANTA BASUMATARY,"United People’s Party, Liberal",484681,4314,488995,39.39,1 - Kokrajhar (Assam),3,1
2.0,KAMPA BORGOYARI,Bodoland Peoples Front,432768,4644,437412,35.23,1 - Kokrajhar (Assam),3,1
3.0,GARJAN MASHAHARY,Indian National Congress,112624,1112,113736,9.16,1 - Kokrajhar (Assam),3,1
4.0,BINITA DEKA,Gana Suraksha Party,93266,923,94189,7.59,1 - Kokrajhar (Assam),3,1
5.0,PRITHVIRAJ NARAYAN DEV MECH,Independent,33636,101,33737,2.72,1 - Kokrajhar (Assam),3,1
6.0,GAURI SANKAR SARANIA,All India Trinamool Congress,23362,157,23519,1.89,1 - Kokrajhar (Assam),3,1
7.0,RANJAY KR BRAHMA,Independent,8782,48,8830,0.71,1 - Kokrajhar (Assam),3,1
8.0,LALIT PEGU,Voters Party International,7891,41,7932,0.64,1 - Kokrajhar (Assam),3,1
9.0,JYOTISH KUMAR DAS,Independent,5944,162,6106,0.49,1 - Kokrajhar (Assam),3,1
10.0,PANKAJ ISLARY,Independent,4473,35,4508,0.36,1 - Kokrajhar (Assam),3,1
11.0,TRIPTINA RABHA,Independent,4425,115,4540,0.37,1 - Kokrajhar (Assam),3,1
12.0,AJOY NARZARY,Independent,4032,48,4080,0.33,1 - Kokrajhar (Assam),3,1
13.0,NOTA,None of the Above,13662,250,13912,1.12,1 - Kokrajhar (Assam),3,1
,Total,,1229546,11950,1241496,,1 - Kokrajhar (Assam),3,1
1.0,RAKIBUL HUSSAIN,Indian National Congress,1468549,3336,1471885,59.99,2 - Dhubri (Assam),3,2
2.0,MOHAMMED BADRUDDIN AJMAL,All India United Democratic Front,458202,1207,459409,18.72,2 - Dhubri (Assam),3,2
3.0,ZABED ISLAM,Asom Gana Parishad,435822,2772,438594,17.88,2 - Dhubri (Assam),3,2
4.0,S. M. JIAUL HAQUE,Bharatiya Gana Parishad,11978,128,12106,0.49,2 - Dhubri (Assam),3,2
5.0,FARUK KHAN,Independent,10986,8,10994,0.45,2 - Dhubri (Assam),3,2
6.0,BISWAJIT RAY,Independent,7615,88,7703,0.31,2 - Dhubri (Assam),3,2
7.0,ALAKESH ROY,Independent,6950,40,6990,0.28,2 - Dhubri (Assam),3,2
8.0,HAFIZ BURHANUDDIN,The National Road Map Party of India,6934,6,6940,0.28,2 - Dhubri (Assam),3,2
9.0,RADHARANI BISWAS,Hindu Samaj Party,6137,150,6287,0.26,2 - Dhubri (Assam),3,2
10.0,TAHIDUR RAHMAN,Voters Party International,5384,8,5392,0.22,2 - Dhubri (Assam),3,2
11.0,SHUKUR ALI,Asom Jana Morcha,4749,43,4792,0.2,2 - Dhubri (Assam),3,2
12.0,SURAT ZAMAN MONDAL,Socialist Unity Centre Of India (COMMUNIST),3984,31,4015,0.16,2 - Dhubri (Assam),3,2
13.0,REJAUL KARIM,Republican Party of India (Athawale),3481,5,3486,0.14,2 - Dhubri (Assam),3,2
14.0,NOTA,None of the Above,14912,103,15015,0.61,2 - Dhubri (Assam),3,2
,Total,,2445683,7925,2453608,,2 - Dhubri (Assam),3,2
1.0,PHANI BHUSAN CHOUDHURY,Asom Gana Parishad,853642,6471,860113,51.02,3 - Barpeta (Assam),3,3
2.0,DEEP BAYAN,Indian National Congress,635411,2351,637762,37.83,3 - Barpeta (Assam),3,3
3.0,MANORANJAN TALUKDAR,Communist Party of India (Marxist),95020,1118,96138,5.7,3 - Barpeta (Assam),3,3
4.0,ABUL KALAM AZAD,All India Trinamool Congress,16359,73,16432,0.97,3 - Barpeta (Assam),3,3
5.0,DEWAN MOHIBUL ISLAM,Independent,9930,11,9941,0.59,3 - Barpeta (Assam),3,3
6.0,SAMEJ UDDIN,Bodoland Peoples Front,9515,177,9692,0.57,3 - Barpeta (Assam),3,3
7.0,DULU AHMED,Independent,9275,63,9338,0.55,3 - Barpeta (Assam),3,3
8.0,MATIAR RAHMAN,Independent,7920,15,7935,0.47,3 - Barpeta (Assam),3,3
9.0,JAGANNATH RAY,Independent,5474,74,5548,0.33,3 - Barpeta (Assam),3,3
10.0,SHAJAHAN ALI KHAN,Voters Party International,4441,7,4448,0.26,3 - Barpeta (Assam),3,3
11.0,AYNAL HAQUE,Independent,3174,18,3192,0.19,3 - Barpeta (Assam),3,3
12.0,CHITRALEKHA DAS,Socialist Unity Centre Of India (COMMUNIST),3060,71,3131,0.19,3 - Barpeta (Assam),3,3
13.0,AMZAD ALI,Republican Party of India (Athawale),2657,22,2679,0.16,3 - Barpeta (Assam),3,3
14.0,ABUBAKKAR SIDDIQUE,Rashtriya Ulama Council,2463,14,2477,0.15,3 - Barpeta (Assam),3,3
15.0,NOTA,None of the Above,16888,229,17117,1.02,3 - Barpeta (Assam),3,3
,Total,,1675229,10714,1685943,,3 - Barpeta (Assam),3,3
1.0,DILIP SAIKIA,Bharatiya Janata Party,864583,3804,868387,47.95,4 - Darrang-Udalguri (Assam),3,4
2.0,MADHAB RAJBANGSHI,Indian National Congress,538032,1343,539375,29.78,4 - Darrang-Udalguri (Assam),3,4
3.0,DURGADAS BORO,Bodoland Peoples Front,309040,1534,310574,17.15,4 - Darrang-Udalguri (Assam),3,4
4.0,DANIEL MARDI,Independent,14277,14,14291,0.79,4 - Darrang-Udalguri (Assam),3,4
5.0,AROON BAROOA,Bharatheeya Jawan Kisan Party,12519,44,12563,0.69,4 - Darrang-Udalguri (Assam),3,4
6.0,SWARNA DEVI,Gana Suraksha Party,11067,45,11112,0.61,4 - Darrang-Udalguri (Assam),3,4
7.0,LALIT PEGU,Voters Party International,10887,28,10915,0.6,4 - Darrang-Udalguri (Assam),3,4
8.0,JITENDRA CHALIHA,Socialist Unity Centre Of India (COMMUNIST),7421,31,7452,0.41,4 - Darrang-Udalguri (Assam),3,4
9.0,ABUL KASEM,Republican Party of India (Athawale),4956,17,4973,0.27,4 - Darrang-Udalguri (Assam),3,4
10.0,BIREN BASAK,Bharatiya Gana Parishad,4605,18,4623,0.26,4 - Darrang-Udalguri (Assam),3,4
11.0,ABDUL HAMED,Rashtriya Ulama Council,3721,10,3731,0.21,4 - Darrang-Udalguri (Assam),3,4
12.0,NOTA,None of the Above,23086,118,23204,1.28,4 - Darrang-Udalguri (Assam),3,4
,Total,,1804194,7006,1811200,,4 - Darrang-Udalguri (Assam),3,4
1.0,BIJULI KALITA MEDHI,Bharatiya Janata Party,891901,2986,894887,55.95,5 - Guwahati (Assam),3,5
2.0,MIRA BORTHAKUR GOSWAMI,Indian National Congress,642353,1444,643797,40.25,5 - Guwahati (Assam),3,5
3.0,DIPAK KR BORO,Voters Party International,8494,54,8548,0.53,5 - Guwahati (Assam),3,5
4.0,COLONEL GOKUL CHANDRA SINGHA,Independent,7644,34,7678,0.48,5 - Guwahati (Assam),3,5
5.0,AMITABH SARMA,Ekam Sanatan Bharat Dal,7508,19,7527,0.47,5 - Guwahati (Assam),3,5
6.0,KAZI NEKIB AHMED,Independent,6753,8,6761,0.42,5 - Guwahati (Assam),3,5
7.0,SAMAD CHOUDHURY,Bharatiya Gana Parishad,5081,14,5095,0.32,5 - Guwahati (Assam),3,5
8.0,SHEJON GOYARY,Bahujan Maha Party,4826,21,4847,0.3,5 - Guwahati (Assam),3,5
9.0,NOTA,None of the Above,20139,110,20249,1.27,5 - Guwahati (Assam),3,5
,Total,,1594699,4690,1599389,,5 - Guwahati (Assam),3,5
1.0,AMARSING TISSO,Bharatiya Janata Party,332440,2180,334620,49.01,6 - Diphu (Assam),3,6
2.0,J. I. KATHAR,Independent,185864,1153,187017,27.39,6 - Diphu (Assam),3,6
3.0,JOY RAM ENGLENG,Indian National Congress,123055,964,124019,18.16,6 - Diphu (Assam),3,6
4.0,JOHN BARNARD SANGMA,Gana Suraksha Party,11241,38,11279,1.65,6 - Diphu (Assam),3,6
5.0,JOTSON BEY,Autonomous State Demand Committee,9561,72,9633,1.41,6 - Diphu (Assam),3,6
6.0,NOTA,None of the Above,16127,132,16259,2.38,6 - Diphu (Assam),3,6
,Total,,678288,4539,682827,,6 - Diphu (Assam),3,6
1.0,KRIPANATH MALLAH,Bharatiya Janata Party,541220,3873,545093,47.53,7 - Karimganj (Assam),3,7
2.0,HAFIZ RASHID AHMED CHOUDHURY,Indian National Congress,524390,2343,526733,45.93,7 - Karimganj (Assam),3,7
3.0,SAHABUL ISLAM CHOUDHURY,All India United Democratic Front,29070,135,29205,2.55,7 - Karimganj (Assam),3,7
4.0,JIBESH DEB,Independent,7105,4,7109,0.62,7 - Karimganj (Assam),3,7
5.0,DEBOJYOTI NATH,Independent,5900,7,5907,0.52,7 - Karimganj (Assam),3,7
6.0,AHAD UDDIN,Rashtriya Ulama Council,4186,6,4192,0.37,7 - Karimganj (Assam),3,7
7.0,BINAY KRISHNA ROY,Independent,3621,7,3628,0.32,7 - Karimganj (Assam),3,7
8.0,DILIP KUMAR,Independent,2623,7,2630,0.23,7 - Karimganj (Assam),3,7
9.0,ROSID AHMED LASKAR,Independent,2600,1,2601,0.23,7 - Karimganj (Assam),3,7
10.0,MUZAKKIR HASAN LASKAR,Independent,2287,4,2291,0.2,7 - Karimganj (Assam),3,7
11.0,ABDUL BASIT TAPADAR,Independent,1912,11,1923,0.17,7 - Karimganj (Assam),3,7
12.0,GOPAL CHANDRA PAUL,Independent,1650,7,1657,0.14,7 - Karimganj (Assam),3,7
13.0,MD. NAZRUL ISLAM LASKAR,Independent,1382,-,1382,0.12,7 - Karimganj (Assam),3,7
14.0,SAHEL AHMED,Independent,1110,1,1111,0.1,7 - Karimganj (Assam),3,7
15.0,ABDUL GOFFAR TALUKDAR,Independent,1094,1,1095,0.1,7 - Karimganj (Assam),3,7
16.0,SAFIKUR RAHMAN HAZARI,Independent,1031,-,1031,0.09,7 - Karimganj (Assam),3,7
17.0,PRAJJWAL SUDIP DEB,Socialist Unity Centre Of India (COMMUNIST),994,7,1001,0.09,7 - Karimganj (Assam),3,7
18.0,ABDUL KALAM MAZUMDER,Independent,975,-,975,0.09,7 - Karimganj (Assam),3,7
19.0,ALIM UDDIN MAZUMDER,Independent,881,1,882,0.08,7 - Karimganj (Assam),3,7
20.0,ABDUL HAMEED,Independent,841,1,842,0.07,7 - Karimganj (Assam),3,7
21.0,DEBASHISH GHOSH,Bangali Nabanirman Sena,800,17,817,0.07,7 - Karimganj (Assam),3,7
22.0,RASHID AHMED CHOUDHURY,Independent,719,2,721,0.06,7 - Karimganj (Assam),3,7
23.0,ABDUS SUBHAN TAPADAR,Independent,568,3,571,0.05,7 - Karimganj (Assam),3,7
24.0,ROKIBUL HUSSAIN CHOUDHURY,Independent,539,6,545,0.05,7 - Karimganj (Assam),3,7
25.0,NOTA,None of the Above,2851,89,2940,0.26,7 - Karimganj (Assam),3,7
,Total,,1140349,6533,1146882,,7 - Karimganj (Assam),3,7
1.0,PARIMAL SUKLABAIDYA,Bharatiya Janata Party,647572,4833,652405,59.89,8 - Silchar (Assam),3,8
2.0,SURYA KANTA SARKAR,Indian National Congress,386453,1641,388094,35.62,8 - Silchar (Assam),3,8
3.0,RADHESHYAM BISWAS,All India Trinamool Congress,20384,109,20493,1.88,8 - Silchar (Assam),3,8
4.0,RAJU DAS,Independent,4580,17,4597,0.42,8 - Silchar (Assam),3,8
5.0,PROBASH CHANDRA SARKAR,Socialist Unity Centre Of India (COMMUNIST),4494,40,4534,0.42,8 - Silchar (Assam),3,8
6.0,ANANTA MOHAN ROY,Independent,3113,30,3143,0.29,8 - Silchar (Assam),3,8
7.0,RAJIB DAS,Bahujan Maha Party,1843,24,1867,0.17,8 - Silchar (Assam),3,8
8.0,BARINDRA KUMAR DAS,Bangali Nabanirman Sena,1575,18,1593,0.15,8 - Silchar (Assam),3,8
9.0,NOTA,None of the Above,12598,102,12700,1.17,8 - Silchar (Assam),3,8
,Total,,1082612,6814,1089426,,8 - Silchar (Assam),3,8
1.0,PRADYUT BORDOLOI,Indian National Congress,786620,2230,788850,50.89,9 - Nagaon (Assam),3,9
2.0,SURESH BORAH,Bharatiya Janata Party,573579,3040,576619,37.2,9 - Nagaon (Assam),3,9
3.0,AMINUL ISLAM,All India United Democratic Front,137033,307,137340,8.86,9 - Nagaon (Assam),3,9
4.0,SIKHA SARMA,Independent,6569,51,6620,0.43,9 - Nagaon (Assam),3,9
5.0,SAMSUL ALAM,Independent,5048,21,5069,0.33,9 - Nagaon (Assam),3,9
6.0,BIPAD BHANJAN SARKAR,Independent,4878,7,4885,0.32,9 - Nagaon (Assam),3,9
7.0,ANUPAM BARUAH,Jai Prakash Janata Dal,4290,29,4319,0.28,9 - Nagaon (Assam),3,9
8.0,NIKHIL DEKARAJA,Independent,3601,26,3627,0.23,9 - Nagaon (Assam),3,9
9.0,RABBUL HAQUE,Rashtriya Ulama Council,2547,12,2559,0.17,9 - Nagaon (Assam),3,9
10.0,ABU SHAMA,Independent,2216,22,2238,0.14,9 - Nagaon (Assam),3,9
11.0,ABU EUSUF MD RAIHAN UDDIN,Independent,2019,11,2030,0.13,9 - Nagaon (Assam),3,9
12.0,SANTANU MUKHERJEE,Bharatiya Gana Parishad,1993,17,2010,0.13,9 - Nagaon (Assam),3,9
13.0,SAIFUL ISLAM CHOUDHURY,Asom Jana Morcha,1823,14,1837,0.12,9 - Nagaon (Assam),3,9
14.0,NOTA,None of the Above,11910,85,11995,0.77,9 - Nagaon (Assam),3,9
,Total,,1544126,5872,1549998,,9 - Nagaon (Assam),3,9
1.0,KAMAKHYA PRASAD TASA,Bharatiya Janata Party,892766,4277,897043,55.04,10 - Kaziranga (Assam),3,10
2.0,ROSELINA TIRKEY,Indian National Congress,646123,1973,648096,39.76,10 - Kaziranga (Assam),3,10
3.0,DILUWARA BEGUM CHOWDHURY,Independent,11719,24,11743,0.72,10 - Kaziranga (Assam),3,10
4.0,BINOD GOGOI,Independent,10625,54,10679,0.66,10 - Kaziranga (Assam),3,10
5.0,ANIMA DEKA GUPTA,Voters Party International,8641,32,8673,0.53,10 - Kaziranga (Assam),3,10
6.0,TRIDIV JYOTI BHUYAN,Independent,8091,37,8128,0.5,10 - Kaziranga (Assam),3,10
7.0,ABDUL HOQUE,Independent,6395,46,6441,0.4,10 - Kaziranga (Assam),3,10
8.0,JYOTISKA RANJAN GOSWAMI,Independent,4494,44,4538,0.28,10 - Kaziranga (Assam),3,10
9.0,SAILEN CH MALAKAR,Bharatiya Gana Parishad,3698,22,3720,0.23,10 - Kaziranga (Assam),3,10
10.0,SALIM AHMED,Asom Jana Morcha,3243,23,3266,0.2,10 - Kaziranga (Assam),3,10
11.0,SALEH AHMED MAZUMDAR,Republican Party of India (Athawale),3160,19,3179,0.2,10 - Kaziranga (Assam),3,10
12.0,NOTA,None of the Above,24212,219,24431,1.5,10 - Kaziranga (Assam),3,10
,Total,,1623167,6770,1629937,,10 - Kaziranga (Assam),3,10
1.0,RANJIT DUTTA,Bharatiya Janata Party,771018,4770,775788,60.21,11 - Sonitpur (Assam),3,11
2.0,PREMLAL GANJU,Indian National Congress,412553,1827,414380,32.16,11 - Sonitpur (Assam),3,11
3.0,RISHIRAJ KAUNDINYA,Aam Aadmi Party,32771,277,33048,2.56,11 - Sonitpur (Assam),3,11
4.0,RAJU DEURI,Bodoland Peoples Front,19775,117,19892,1.54,11 - Sonitpur (Assam),3,11
5.0,PRADIP BHANDARI,Independent,8136,69,8205,0.64,11 - Sonitpur (Assam),3,11
6.0,KAMESWAR SWARGIARY,Voters Party International,7320,62,7382,0.57,11 - Sonitpur (Assam),3,11
7.0,RINKU ROY,Gana Suraksha Party,6780,43,6823,0.53,11 - Sonitpur (Assam),3,11
8.0,ALAM ALI,Bahujan Maha Party,4186,16,4202,0.33,11 - Sonitpur (Assam),3,11
9.0,NOTA,None of the Above,18535,213,18748,1.46,11 - Sonitpur (Assam),3,11
,Total,,1281074,7394,1288468,,11 - Sonitpur (Assam),3,11
1.0,PRADAN BARUAH,Bharatiya Janata Party,659307,3815,663122,54.75,12 - Lakhimpur (Assam),3,12
2.0,UDAY SHANKAR HAZARIKA,Indian National Congress,458720,3145,461865,38.13,12 - Lakhimpur (Assam),3,12
3.0,DHIREN KACHARI,Communist Party of India,19562,69,19631,1.62,12 - Lakhimpur (Assam),3,12
4.0,GHANA KANTA CHUTIA,All India Trinamool Congress,14055,142,14197,1.17,12 - Lakhimpur (Assam),3,12
5.0,BIKRAM RAMCHIARY,Independent,10218,75,10293,0.85,12 - Lakhimpur (Assam),3,12
6.0,GOBIN BISWAKARMA,Independent,7461,65,7526,0.62,12 - Lakhimpur (Assam),3,12
7.0,DEBA NATH PAIT,Independent,6143,20,6163,0.51,12 - Lakhimpur (Assam),3,12
8.0,PALLAB PEGU,Socialist Unity Centre Of India (COMMUNIST),6051,86,6137,0.51,12 - Lakhimpur (Assam),3,12
9.0,BIREN BAILUNG,Voters Party International,5329,30,5359,0.44,12 - Lakhimpur (Assam),3,12
10.0,NOTA,None of the Above,16716,205,16921,1.4,12 - Lakhimpur (Assam),3,12
,Total,,1203562,7652,1211214,,12 - Lakhimpur (Assam),3,12
1.0,SARBANANDA SONOWAL,Bharatiya Janata Party,691153,2609,693762,54.27,13 - Dibrugarh (Assam),3,13
2.0,LURINJYOTI GOGOI,Assam Jatiya Parishad,412793,1648,414441,32.42,13 - Dibrugarh (Assam),3,13
3.0,MANOJ DHANOWAR,Aam Aadmi Party,137618,246,137864,10.78,13 - Dibrugarh (Assam),3,13
4.0,NOTA,None of the Above,32163,92,32255,2.52,13 - Dibrugarh (Assam),3,13
,Total,,1273727,4595,1278322,,13 - Dibrugarh (Assam),3,13
1.0,GAURAV GOGOI,Indian National Congress,743194,8577,751771,54.04,14 - Jorhat (Assam),3,14
2.0,TOPON KUMAR GOGOI,Bharatiya Janata Party,602019,5359,607378,43.66,14 - Jorhat (Assam),3,14
3.0,ARUN CHANDRA HANDIQUE,Ekam Sanatan Bharat Dal,8998,88,9086,0.65,14 - Jorhat (Assam),3,14
4.0,RAJ KUMAR DUWARA,Independent,8315,55,8370,0.6,14 - Jorhat (Assam),3,14
5.0,NOTA,None of the Above,14477,78,14555,1.05,14 - Jorhat (Assam),3,14
,Total,,1377003,14157,1391160,,14 - Jorhat (Assam),3,14
1.0,SUNIL KUMAR,Janata Dal (United),522495,927,523422,47.5,1 - Valmiki Nagar (Bihar),4,1
2.0,DEEPAK YADAV,Rashtriya Janata Dal,422959,1788,424747,38.55,1 - Valmiki Nagar (Bihar),4,1
3.0,PRAVESH KUMAR MISHRA @ ANUP,Independent,23195,30,23225,2.11,1 - Valmiki Nagar (Bihar),4,1
4.0,DINESH AGRAWAL,Independent,19787,23,19810,1.8,1 - Valmiki Nagar (Bihar),4,1
5.0,DURGESH SINGH CHAUHAN,Bahujan Samaj Party,18739,77,18816,1.71,1 - Valmiki Nagar (Bihar),4,1
6.0,CHANDRESHWAR MISHRA,Independent,13590,8,13598,1.23,1 - Valmiki Nagar (Bihar),4,1
7.0,SHAFI MOHAMMAD MIYA,Aazad Samaj Party (Kanshi Ram),13419,13,13432,1.22,1 - Valmiki Nagar (Bihar),4,1
8.0,PARSHURAM SAH,Independent,12142,8,12150,1.1,1 - Valmiki Nagar (Bihar),4,1
9.0,NABA KUMAR SARANIA (HIRA BHAI),Gana Suraksha Party,11420,3,11423,1.04,1 - Valmiki Nagar (Bihar),4,1
10.0,SHAMBHU PRASAD,Independent,10478,20,10498,0.95,1 - Valmiki Nagar (Bihar),4,1
11.0,NOTA,None of the Above,30673,36,30709,2.79,1 - Valmiki Nagar (Bihar),4,1
,Total,,1098897,2933,1101830,,1 - Valmiki Nagar (Bihar),4,1
1.0,DR.SANJAY JAISWAL,Bharatiya Janata Party,578959,1462,580421,53.43,2 - Paschim Champaran (Bihar),4,2
2.0,MADAN MOHAN TIWARI,Indian National Congress,441363,2490,443853,40.86,2 - Paschim Champaran (Bihar),4,2
3.0,SANJAY KUMAR,Viro Ke Vir Indian Party,13139,6,13145,1.21,2 - Paschim Champaran (Bihar),4,2
4.0,UPENDRA RAM,Bahujan Samaj Party,10913,49,10962,1.01,2 - Paschim Champaran (Bihar),4,2
5.0,MOHAMMAD SOAIB,Independent,8992,2,8994,0.83,2 - Paschim Champaran (Bihar),4,2
6.0,RAUSHAN KUMAR SRIVASTAVA,Independent,8496,9,8505,0.78,2 - Paschim Champaran (Bihar),4,2
7.0,MD. KALAM SAI,Independent,4922,3,4925,0.45,2 - Paschim Champaran (Bihar),4,2
8.0,NAFISH AHMAD,Independent,4163,-,4163,0.38,2 - Paschim Champaran (Bihar),4,2
9.0,NOTA,None of the Above,11223,65,11288,1.04,2 - Paschim Champaran (Bihar),4,2
,Total,,1082170,4086,1086256,,2 - Paschim Champaran (Bihar),4,2
1.0,RADHA MOHAN SINGH,Bharatiya Janata Party,540598,1595,542193,50.5,3 - Purvi Champaran (Bihar),4,3
2.0,DR RAJESH KUMAR,Vikassheel Insaan Party,451118,2788,453906,42.28,3 - Purvi Champaran (Bihar),4,3
3.0,MOHAMMAD AJMER ALAM,Independent,13030,17,13047,1.22,3 - Purvi Champaran (Bihar),4,3
4.0,VIJAY KUMAR SAHANI,Rashtriya Jansambhavna Party,8158,27,8185,0.76,3 - Purvi Champaran (Bihar),4,3
5.0,RAJESH SINGH,Independent,7176,6,7182,0.67,3 - Purvi Champaran (Bihar),4,3
6.0,GYANTI DEVI,Prabuddha Republican Party,6963,45,7008,0.65,3 - Purvi Champaran (Bihar),4,3
7.0,PAWAN KUMAR,Bhartiya Sarthak Party,4895,19,4914,0.46,3 - Purvi Champaran (Bihar),4,3
8.0,MUNESHWAR TIWARI,Independent,4017,5,4022,0.37,3 - Purvi Champaran (Bihar),4,3
9.0,RAJESH KUMAR S/O GAGANLAL SAHNI,Independent,3930,4,3934,0.37,3 - Purvi Champaran (Bihar),4,3
10.0,RAJESH KUMAR S/O VISHUN SAH,Independent,3489,3,3492,0.33,3 - Purvi Champaran (Bihar),4,3
11.0,NAWAL KISHOR PRASAD,Viro Ke Vir Indian Party,3449,15,3464,0.32,3 - Purvi Champaran (Bihar),4,3
12.0,NIKESH KUMAR,Independent,2539,14,2553,0.24,3 - Purvi Champaran (Bihar),4,3
13.0,NOTA,None of the Above,19729,59,19788,1.84,3 - Purvi Champaran (Bihar),4,3
,Total,,1069091,4597,1073688,,3 - Purvi Champaran (Bihar),4,3
1.0,LOVELY ANAND,Janata Dal (United),475709,903,476612,45.15,4 - Sheohar (Bihar),4,4
2.0,RITU JAISWAL,Rashtriya Janata Dal,445482,1987,447469,42.39,4 - Sheohar (Bihar),4,4
3.0,AKHILESHWAR SHRIVAISHANV,Independent,29014,80,29094,2.76,4 - Sheohar (Bihar),4,4
4.0,KANHAIYA KUMAR,Independent,20585,7,20592,1.95,4 - Sheohar (Bihar),4,4
5.0,RANA RANJIT,All India Majlis-E-Ittehadul Muslimeen,11947,32,11979,1.13,4 - Sheohar (Bihar),4,4
6.0,SUDHIR KUMAR SINGH,Viro Ke Vir Indian Party,9096,6,9102,0.86,4 - Sheohar (Bihar),4,4
7.0,VIJENDRA THAKUR,Bahujan Samaj Party,8865,23,8888,0.84,4 - Sheohar (Bihar),4,4
8.0,UPENDRA SAHANI,Rashtriya Jansambhavna Party,6332,6,6338,0.6,4 - Sheohar (Bihar),4,4
9.0,MAMTA KUMARI,Samata Party,5431,4,5435,0.51,4 - Sheohar (Bihar),4,4
10.0,MOHAMMAD MAHTAB ALAM,Samaj Shakti Party,4867,4,4871,0.46,4 - Sheohar (Bihar),4,4
11.0,JAGDISH PRASAD,Bajjikanchal Vikas Party,2950,5,2955,0.28,4 - Sheohar (Bihar),4,4
12.0,DILIP KUMAR MISHRA,Prabal Bharat Party,2097,2,2099,0.2,4 - Sheohar (Bihar),4,4
13.0,NOTA,None of the Above,30130,38,30168,2.86,4 - Sheohar (Bihar),4,4
,Total,,1052505,3097,1055602,,4 - Sheohar (Bihar),4,4
1.0,DEVESH CHANDRA THAKUR,Janata Dal (United),514940,779,515719,47.14,5 - Sitamarhi (Bihar),4,5
2.0,ARJUN RAY,Rashtriya Janata Dal,463107,1256,464363,42.45,5 - Sitamarhi (Bihar),4,5
3.0,SAIQUA NAWAZ AZMAT,Independent,28911,1,28912,2.64,5 - Sitamarhi (Bihar),4,5
4.0,SHYAM NANDAN KISHOR PRASAD,Independent,11173,15,11188,1.02,5 - Sitamarhi (Bihar),4,5
5.0,BHOLA SINGH,Bahujan Samaj Party,8773,37,8810,0.81,5 - Sitamarhi (Bihar),4,5
6.0,UPENDRA SAHANI,Rashtriya Jansambhavna Party,8446,8,8454,0.77,5 - Sitamarhi (Bihar),4,5
7.0,CHANDRIKA PRASAD,Independent,7109,5,7114,0.65,5 - Sitamarhi (Bihar),4,5
8.0,VINOD SAH,Independent,4477,4,4481,0.41,5 - Sitamarhi (Bihar),4,5
9.0,KRISHNA KISHORE,Independent,3280,-,3280,0.3,5 - Sitamarhi (Bihar),4,5
10.0,MUSHAHID RAZA,Desh Janhit Party,2190,2,2192,0.2,5 - Sitamarhi (Bihar),4,5
11.0,UMESH KUMAR YADAV,Independent,2126,2,2128,0.19,5 - Sitamarhi (Bihar),4,5
12.0,RAJENDRA MAHTO,Karpoori Janta Dal,1976,5,1981,0.18,5 - Sitamarhi (Bihar),4,5
13.0,ANAND KUMAR,Independent,1787,9,1796,0.16,5 - Sitamarhi (Bihar),4,5
14.0,ABDUL SAMAD,Independent,1439,2,1441,0.13,5 - Sitamarhi (Bihar),4,5
15.0,NOTA,None of the Above,32102,31,32133,2.94,5 - Sitamarhi (Bihar),4,5
,Total,,1091836,2156,1093992,,5 - Sitamarhi (Bihar),4,5
1.0,ASHOK KUMAR YADAV,Bharatiya Janata Party,552705,723,553428,53.85,6 - Madhubani (Bihar),4,6
2.0,MD ALI ASHRAF FATMI,Rashtriya Janata Dal,400909,574,401483,39.07,6 - Madhubani (Bihar),4,6
3.0,SHIV BODHAN SAHU,Independent,13365,5,13370,1.3,6 - Madhubani (Bihar),4,6
4.0,BIKASH KUMAR,Bahujan Samaj Party,7197,26,7223,0.7,6 - Madhubani (Bihar),4,6
5.0,PRIYE RANJAN,Independent,7046,4,7050,0.69,6 - Madhubani (Bihar),4,6
6.0,VAIDYANATH YADAV,Peoples Party of India (Democratic),4980,3,4983,0.48,6 - Madhubani (Bihar),4,6
7.0,SARFARAJ ALAM,Akhil Bhartiya Parivar Party,4620,3,4623,0.45,6 - Madhubani (Bihar),4,6
8.0,MD WAQUAR SIDDIQUI,All India Majlis-E-Ittehadul Muslimeen,4492,6,4498,0.44,6 - Madhubani (Bihar),4,6
9.0,MOHAN SHARMA,Rashtriya Jansambhavna Party,4460,4,4464,0.43,6 - Madhubani (Bihar),4,6
10.0,ABU BAKAR RAHMANI,Country Citizen Party,2095,2,2097,0.2,6 - Madhubani (Bihar),4,6
11.0,UDAY MANDAL,Samata Party,1998,9,2007,0.2,6 - Madhubani (Bihar),4,6
12.0,KUL BHUSHAN PRASAD,Loktantrik Lok Rajyam Party,1780,3,1783,0.17,6 - Madhubani (Bihar),4,6
13.0,NOTA,None of the Above,20691,28,20719,2.02,6 - Madhubani (Bihar),4,6
,Total,,1026338,1390,1027728,,6 - Madhubani (Bihar),4,6
1.0,RAMPRIT MANDAL,Janata Dal (United),532138,894,533032,48.73,7 - Jhanjharpur (Bihar),4,7
2.0,SUMAN KUMAR MAHASETH,Vikassheel Insaan Party,347989,874,348863,31.9,7 - Jhanjharpur (Bihar),4,7
3.0,GULAB YADAV,Bahujan Samaj Party,73532,352,73884,6.76,7 - Jhanjharpur (Bihar),4,7
4.0,RAM PRASAD RAUT,Independent,25993,17,26010,2.38,7 - Jhanjharpur (Bihar),4,7
5.0,GANGA PRASAD YADAV,Independent,18064,10,18074,1.65,7 - Jhanjharpur (Bihar),4,7
6.0,GAURI SHANKAR SAHU,Independent,14307,18,14325,1.31,7 - Jhanjharpur (Bihar),4,7
7.0,RAJIV KUMAR JHA,Independent,12488,25,12513,1.14,7 - Jhanjharpur (Bihar),4,7
8.0,BABLU KUMAR,Aadarsh Mithila Party,11638,35,11673,1.07,7 - Jhanjharpur (Bihar),4,7
9.0,VIDYA NAND RAM,Wazib Adhikar Party,10843,19,10862,0.99,7 - Jhanjharpur (Bihar),4,7
10.0,VIJAY KUMAR MANDAL,Socialist Unity Centre Of India (COMMUNIST),8556,21,8577,0.78,7 - Jhanjharpur (Bihar),4,7
11.0,NOTA,None of the Above,35846,82,35928,3.28,7 - Jhanjharpur (Bihar),4,7
,Total,,1091394,2347,1093741,,7 - Jhanjharpur (Bihar),4,7
1.0,DILESHWAR KAMAIT,Janata Dal (United),592922,2116,595038,48.33,8 - Supaul (Bihar),4,8
2.0,CHANDRAHAS CHAUPAL,Rashtriya Janata Dal,422037,3198,425235,34.54,8 - Supaul (Bihar),4,8
3.0,BAIDYA NATH MEHTA,Independent,51325,327,51652,4.2,8 - Supaul (Bihar),4,8
4.0,YOG NARAYAN SINGH,Independent,27447,7,27454,2.23,8 - Supaul (Bihar),4,8
5.0,VINDESHWARI PRASAD,Independent,18450,7,18457,1.5,8 - Supaul (Bihar),4,8
6.0,KIRAN DEVI,Bahujan Samaj Party,17961,118,18079,1.47,8 - Supaul (Bihar),4,8
7.0,MOHD KALIM KHAN,Rashtriya Jansambhavna Party,14064,14,14078,1.14,8 - Supaul (Bihar),4,8
8.0,UMESH PRASAD SAH,Jai Hind Party,12971,43,13014,1.06,8 - Supaul (Bihar),4,8
9.0,RAJ KUMAR YADAV,Viro Ke Vir Indian Party,10795,11,10806,0.88,8 - Supaul (Bihar),4,8
10.0,RAMESH KUMAR ANAND,"Proutist Bloc, India",9439,12,9451,0.77,8 - Supaul (Bihar),4,8
11.0,ABDUL MATIN,Independent,7177,17,7194,0.58,8 - Supaul (Bihar),4,8
12.0,BAMBAM KUMAR,Independent,7000,6,7006,0.57,8 - Supaul (Bihar),4,8
13.0,NITISH KUMAR,Independent,5894,21,5915,0.48,8 - Supaul (Bihar),4,8
14.0,AJAY KUMAR SAH,Independent,5330,21,5351,0.43,8 - Supaul (Bihar),4,8
15.0,SHIV HARI AGRAWAL,Bharat Nirman Party,3770,2,3772,0.31,8 - Supaul (Bihar),4,8
16.0,NOTA,None of the Above,18444,168,18612,1.51,8 - Supaul (Bihar),4,8
,Total,,1225026,6088,1231114,,8 - Supaul (Bihar),4,8
1.0,PRADEEP KUMAR SINGH,Bharatiya Janata Party,599118,1028,600146,47.91,9 - Araria (Bihar),4,9
2.0,SHAHNAWAZ,Rashtriya Janata Dal,578904,1148,580052,46.31,9 - Araria (Bihar),4,9
3.0,SHATRUGHAN PRASAD SUMAN,Independent,13697,49,13746,1.1,9 - Araria (Bihar),4,9
4.0,MD GHOUSUL AZAM,Bahujan Samaj Party,12672,18,12690,1.01,9 - Araria (Bihar),4,9
5.0,MD. MOBINUL HAQUE,Independent,12005,3,12008,0.96,9 - Araria (Bihar),4,9
6.0,MD. ISMAIL,Bharatiya Momin Front,7353,1,7354,0.59,9 - Araria (Bihar),4,9
7.0,AKHILESH KUMAR,Independent,5086,34,5120,0.41,9 - Araria (Bihar),4,9
8.0,MUSHTAK ALAM,Independent,4897,2,4899,0.39,9 - Araria (Bihar),4,9
9.0,ZAWED AKHTAR,The National Road Map Party of India,3037,4,3041,0.24,9 - Araria (Bihar),4,9
10.0,NOTA,None of the Above,13438,66,13504,1.08,9 - Araria (Bihar),4,9
,Total,,1250207,2353,1252560,,9 - Araria (Bihar),4,9
1.0,MOHAMMAD JAWED,Indian National Congress,402470,380,402850,35.0,10 - Kishanganj (Bihar),4,10
2.0,MUJAHID ALAM,Janata Dal (United),342795,363,343158,29.81,10 - Kishanganj (Bihar),4,10
3.0,AKHTARUL IMAN,All India Majlis-E-Ittehadul Muslimeen,309011,253,309264,26.87,10 - Kishanganj (Bihar),4,10
4.0,BIDESHI RISHIDEV,Independent,11815,3,11818,1.03,10 - Kishanganj (Bihar),4,10
5.0,VISHWANATH TUDU,Independent,11300,2,11302,0.98,10 - Kishanganj (Bihar),4,10
6.0,MD GUFRAN JAMALI,Independent,9992,1,9993,0.87,10 - Kishanganj (Bihar),4,10
7.0,HASIRUL,Independent,9522,2,9524,0.83,10 - Kishanganj (Bihar),4,10
8.0,BABUL ALAM,Bahujan Samaj Party,7575,4,7579,0.66,10 - Kishanganj (Bihar),4,10
9.0,RAVI KUMAR ROY,Independent,7299,3,7302,0.63,10 - Kishanganj (Bihar),4,10
10.0,SHAHABUZZAMA BHARTIYA,Rashtriya Samaj Paksha,6055,-,6055,0.53,10 - Kishanganj (Bihar),4,10
11.0,CHHOTE LAL MAHTO,Independent,3758,5,3763,0.33,10 - Kishanganj (Bihar),4,10
12.0,MOHAMMAD KAUSAR PERWEZ,Independent,3525,-,3525,0.31,10 - Kishanganj (Bihar),4,10
13.0,NOTA,None of the Above,24953,13,24966,2.17,10 - Kishanganj (Bihar),4,10
,Total,,1150070,1029,1151099,,10 - Kishanganj (Bihar),4,10
1.0,TARIQ ANWAR,Indian National Congress,565025,2067,567092,48.41,11 - Katihar (Bihar),4,11
2.0,DULAL CHANDRA GOSWAMI,Janata Dal (United),516199,1030,517229,44.15,11 - Katihar (Bihar),4,11
3.0,GOPAL KUMAR MAHTO,Bahujan Samaj Party,14452,46,14498,1.24,11 - Katihar (Bihar),4,11
4.0,GYANESHWAR SOREN,Independent,12307,10,12317,1.05,11 - Katihar (Bihar),4,11
5.0,KHALID MOBARAK,Independent,10828,43,10871,0.93,11 - Katihar (Bihar),4,11
6.0,RAJ KUMAR MANDAL,Rashtriya Jansambhavna Party,8473,14,8487,0.72,11 - Katihar (Bihar),4,11
7.0,VISHNU SINGH,Bharat Jago Janta Party,6303,37,6340,0.54,11 - Katihar (Bihar),4,11
8.0,MARANG HANSADA,Peoples Party of India (Democratic),5875,14,5889,0.5,11 - Katihar (Bihar),4,11
9.0,BINDU KUMARI,Samaj Shakti Party,5866,18,5884,0.5,11 - Katihar (Bihar),4,11
10.0,NOTA,None of the Above,22866,73,22939,1.96,11 - Katihar (Bihar),4,11
,Total,,1168194,3352,1171546,,11 - Katihar (Bihar),4,11
1.0,RAJESH RANJAN ALIAS PAPPU YADAV,Independent,566867,689,567556,47.46,12 - Purnia (Bihar),4,12
2.0,SANTOSH KUMAR,Janata Dal (United),543313,396,543709,45.47,12 - Purnia (Bihar),4,12
3.0,BIMA BHARTI,Rashtriya Janata Dal,27017,103,27120,2.27,12 - Purnia (Bihar),4,12
4.0,ARUN DAS,Bahujan Samaj Party,10595,24,10619,0.89,12 - Purnia (Bihar),4,12
5.0,SATYENDRA YADAV,Independent,8457,2,8459,0.71,12 - Purnia (Bihar),4,12
6.0,NOMAN ALAM,Independent,7693,-,7693,0.64,12 - Purnia (Bihar),4,12
7.0,KISHOR KUMAR YADAV,All India Forward Bloc,6846,8,6854,0.57,12 - Purnia (Bihar),4,12
8.0,NOTA,None of the Above,23819,15,23834,1.99,12 - Purnia (Bihar),4,12
,Total,,1194607,1237,1195844,,12 - Purnia (Bihar),4,12
1.0,DINESH CHANDRA YADAV,Janata Dal (United),639758,891,640649,52.96,13 - Madhepura (Bihar),4,13
2.0,DA KUMAR CHANDRADEEP,Rashtriya Janata Dal,464982,1133,466115,38.53,13 - Madhepura (Bihar),4,13
3.0,SURESHWAR PODDAR,Aadarsh Mithila Party,15423,11,15434,1.28,13 - Madhepura (Bihar),4,13
4.0,MD ARSHAD HUSSAIN,Bahujan Samaj Party,12947,44,12991,1.07,13 - Madhepura (Bihar),4,13
5.0,JAWAHAR LAL JAISWAL,Socialist Unity Centre Of India (COMMUNIST),11320,2,11322,0.94,13 - Madhepura (Bihar),4,13
6.0,UCHESHWAR PANDIT,Samajhdar Party,11127,22,11149,0.92,13 - Madhepura (Bihar),4,13
7.0,PRO KAMESHWAR YADAV,Bharatiya Jan Kranti Dal (Democratic),10665,9,10674,0.88,13 - Madhepura (Bihar),4,13
8.0,AJABLAL MEHTA,Yuva Krantikari Party,8720,16,8736,0.72,13 - Madhepura (Bihar),4,13
9.0,NOTA,None of the Above,32557,68,32625,2.7,13 - Madhepura (Bihar),4,13
,Total,,1207499,2196,1209695,,13 - Madhepura (Bihar),4,13
1.0,GOPAL JEE THAKUR,Bharatiya Janata Party,565706,924,566630,55.33,14 - Darbhanga (Bihar),4,14
2.0,LALIT KUMAR YADAV,Rashtriya Janata Dal,387408,1066,388474,37.93,14 - Darbhanga (Bihar),4,14
3.0,SAROJ CHAUDHARY,Mithilanchal Mukti Morcha,18018,7,18025,1.76,14 - Darbhanga (Bihar),4,14
4.0,DURGANANDA MAHAVIR NAYAK,Bahujan Samaj Party,8259,9,8268,0.81,14 - Darbhanga (Bihar),4,14
5.0,MITHILESH MAHTO,Independent,6983,9,6992,0.68,14 - Darbhanga (Bihar),4,14
6.0,KISHOR KUMAR DAS,Akhil Bhartiya Parivar Party,5716,5,5721,0.56,14 - Darbhanga (Bihar),4,14
7.0,RAJNISH KUMAR,Jantantra Awaj Party,3634,4,3638,0.36,14 - Darbhanga (Bihar),4,14
8.0,RANJEET KUMAR RAM,Wazib Adhikar Party,2529,3,2532,0.25,14 - Darbhanga (Bihar),4,14
9.0,NOTA,None of the Above,23881,23,23904,2.33,14 - Darbhanga (Bihar),4,14
,Total,,1022134,2050,1024184,,14 - Darbhanga (Bihar),4,14
1.0,RAJ BHUSHAN CHOUDHARY,Bharatiya Janata Party,618569,1180,619749,55.71,15 - Muzaffarpur (Bihar),4,15
2.0,AJAY NISHAD,Indian National Congress,383759,1063,384822,34.59,15 - Muzaffarpur (Bihar),4,15
3.0,ALOK KUMAR SINH,Independent,17225,-,17225,1.55,15 - Muzaffarpur (Bihar),4,15
4.0,AWADHESH PRASAD SINGH,Independent,15617,1,15618,1.4,15 - Muzaffarpur (Bihar),4,15
5.0,JITENDRA KUMAR,Independent,8692,8,8700,0.78,15 - Muzaffarpur (Bihar),4,15
6.0,NILIMA KUMARI,Independent,7309,1,7310,0.66,15 - Muzaffarpur (Bihar),4,15
7.0,VIJAYESH KUMAR,Bahujan Samaj Party,6530,17,6547,0.59,15 - Muzaffarpur (Bihar),4,15
8.0,AJAY SAHNI,Independent,5157,1,5158,0.46,15 - Muzaffarpur (Bihar),4,15
9.0,SUNITA KUMARI,Bajjikanchal Vikas Party,4791,1,4792,0.43,15 - Muzaffarpur (Bihar),4,15
10.0,MOHAMMAD ANZARUL HASAN,All India Majlis-E-Ittehadul Muslimeen,4121,10,4131,0.37,15 - Muzaffarpur (Bihar),4,15
11.0,MD HAIDAR,Independent,3897,-,3897,0.35,15 - Muzaffarpur (Bihar),4,15
12.0,MUKESH KUMAR,Independent,3225,-,3225,0.29,15 - Muzaffarpur (Bihar),4,15
13.0,SUDHIR KUMAR OJHA,Bhartiya Sarthak Party,2890,3,2893,0.26,15 - Muzaffarpur (Bihar),4,15
14.0,SABINA KHATOON,Indian National League,2445,8,2453,0.22,15 - Muzaffarpur (Bihar),4,15
15.0,SANDIP KUMAR,Jantantra Awaj Party,1968,3,1971,0.18,15 - Muzaffarpur (Bihar),4,15
16.0,ARVIND KUMAR CHAUDHARY,Socialist Unity Centre Of India (COMMUNIST),1852,5,1857,0.17,15 - Muzaffarpur (Bihar),4,15
17.0,AJITANSH GAUR,The Agrani Party,1840,3,1843,0.17,15 - Muzaffarpur (Bihar),4,15
18.0,SANJAY KUMAR,Independent,1811,1,1812,0.16,15 - Muzaffarpur (Bihar),4,15
19.0,BASKIT KUMAR SHARMA,Independent,1778,1,1779,0.16,15 - Muzaffarpur (Bihar),4,15
20.0,SONELAL PASWAN,Independent,1730,1,1731,0.16,15 - Muzaffarpur (Bihar),4,15
21.0,MANORANJAN KUMAR,Independent,1595,3,1598,0.14,15 - Muzaffarpur (Bihar),4,15
22.0,NAND KISHORE SHARMA,Apna Kisan Party,1521,1,1522,0.14,15 - Muzaffarpur (Bihar),4,15
23.0,ABHAY KUMAR,Samata Party,1170,4,1174,0.11,15 - Muzaffarpur (Bihar),4,15
24.0,PRABHAKAR RANJAN,Ekam Sanatan Bharat Dal,1115,1,1116,0.1,15 - Muzaffarpur (Bihar),4,15
25.0,RAJU SINGH,Independent,984,-,984,0.09,15 - Muzaffarpur (Bihar),4,15
26.0,SAROJ KUMAR CHAUDHARY,Independent,965,-,965,0.09,15 - Muzaffarpur (Bihar),4,15
27.0,NOTA,None of the Above,7539,49,7588,0.68,15 - Muzaffarpur (Bihar),4,15
,Total,,1110095,2365,1112460,,15 - Muzaffarpur (Bihar),4,15
1.0,VEENA DEVI,Lok Janshakti Party(Ram Vilas),566225,818,567043,48.38,16 - Vaishali (Bihar),4,16
2.0,VIJAY KUMAR SHUKLA,Rashtriya Janata Dal,476199,1210,477409,40.73,16 - Vaishali (Bihar),4,16
3.0,VIKKY KUMAR,Independent,34253,3,34256,2.92,16 - Vaishali (Bihar),4,16
4.0,SHAMBHU KUMAR SINGH,Bahujan Samaj Party,21367,69,21436,1.83,16 - Vaishali (Bihar),4,16
5.0,RAJ NARAYAN YADAV,Independent,9614,2,9616,0.82,16 - Vaishali (Bihar),4,16
6.0,PARAMHANS SINGH,Independent,5316,1,5317,0.45,16 - Vaishali (Bihar),4,16
7.0,HARI NARAYAN RAM,Viro Ke Vir Indian Party,5097,3,5100,0.44,16 - Vaishali (Bihar),4,16
8.0,RAMESHWAR MAHTO,Bhartiya Sarthak Party,4141,9,4150,0.35,16 - Vaishali (Bihar),4,16
9.0,KUMAR SHISHIR,Independent,3903,4,3907,0.33,16 - Vaishali (Bihar),4,16
10.0,MUHAMAD AVAS,Independent,3758,-,3758,0.32,16 - Vaishali (Bihar),4,16
11.0,ABHA RAY,Peoples Party of India (Democratic),3263,11,3274,0.28,16 - Vaishali (Bihar),4,16
12.0,NARESH RAM,Socialist Unity Centre Of India (COMMUNIST),2998,11,3009,0.26,16 - Vaishali (Bihar),4,16
13.0,VINOD KUMAR SHARMA,Jantantra Awaj Party,2929,5,2934,0.25,16 - Vaishali (Bihar),4,16
14.0,ANIKET RAJ,Rashtriya Samaj Paksha,2018,7,2025,0.17,16 - Vaishali (Bihar),4,16
15.0,BALENDRA TIWARY,Hindustan Janta Party Secular,1360,6,1366,0.12,16 - Vaishali (Bihar),4,16
16.0,NOTA,None of the Above,27420,40,27460,2.34,16 - Vaishali (Bihar),4,16
,Total,,1169861,2199,1172060,,16 - Vaishali (Bihar),4,16
1.0,DR. ALOK KUMAR SUMAN,Janata Dal (United),510329,1537,511866,48.15,17 - Gopalganj (Bihar),4,17
2.0,PREM NATH CHANCHAL ALIAS CHANCHAL PASWAN,Vikassheel Insaan Party,383065,1621,384686,36.19,17 - Gopalganj (Bihar),4,17
3.0,DINANATH MANJHI,All India Majlis-E-Ittehadul Muslimeen,29900,92,29992,2.82,17 - Gopalganj (Bihar),4,17
4.0,SUJEET KUMAR RAM,Bahujan Samaj Party,29145,127,29272,2.75,17 - Gopalganj (Bihar),4,17
5.0,ANIL RAM,Independent,12988,14,13002,1.22,17 - Gopalganj (Bihar),4,17
6.0,SATYENDRA BAITHA,Independent,12253,16,12269,1.15,17 - Gopalganj (Bihar),4,17
7.0,BHOLA HARIJAN,Independent,11138,2,11140,1.05,17 - Gopalganj (Bihar),4,17
8.0,RAM KUMAR MANJHI,Gana Suraksha Party,8531,9,8540,0.8,17 - Gopalganj (Bihar),4,17
9.0,NAMI RAM,Independent,6716,-,6716,0.63,17 - Gopalganj (Bihar),4,17
10.0,SURENDRA RAM,Bhartiya Rashtriya Dal,6673,39,6712,0.63,17 - Gopalganj (Bihar),4,17
11.0,JITENDRA RAM,Bahujan Mukti Party,5942,27,5969,0.56,17 - Gopalganj (Bihar),4,17
12.0,NOTA,None of the Above,42713,150,42863,4.03,17 - Gopalganj (Bihar),4,17
,Total,,1059393,3634,1063027,,17 - Gopalganj (Bihar),4,17
1.0,VIJAYLAKSHMI DEVI,Janata Dal (United),385625,883,386508,38.73,18 - Siwan (Bihar),4,18
2.0,HENA SHAHAB,Independent,293084,567,293651,29.42,18 - Siwan (Bihar),4,18
3.0,AWADH BIHARI CHOUDHARY,Rashtriya Janata Dal,198063,760,198823,19.92,18 - Siwan (Bihar),4,18
4.0,SATYENDRA KUSHWAHA,Independent,21558,7,21565,2.16,18 - Siwan (Bihar),4,18
5.0,JEEWAN KUMAR,Independent,18489,101,18590,1.86,18 - Siwan (Bihar),4,18
6.0,DILIP KU SINGH,Bahujan Samaj Party,12032,80,12112,1.21,18 - Siwan (Bihar),4,18
7.0,SANJAY KUMAR SAH,Bhartiya Lok Nayak Party,8851,28,8879,0.89,18 - Siwan (Bihar),4,18
8.0,DR. RAVINDRA NATH SHUKLA,Independent,8681,12,8693,0.87,18 - Siwan (Bihar),4,18
9.0,DEVKANT MISHRA,Independent,6162,19,6181,0.62,18 - Siwan (Bihar),4,18
10.0,PRAMOD KUMAR,Independent,5666,2,5668,0.57,18 - Siwan (Bihar),4,18
11.0,PRAKASH MANI TIWARI,Independent,4503,6,4509,0.45,18 - Siwan (Bihar),4,18
12.0,MAHENDRA SINGH ALIAS MAHENDRA RAI,Independent,3920,2,3922,0.39,18 - Siwan (Bihar),4,18
13.0,DILIP KUMAR SINGH,Independent,1947,6,1953,0.2,18 - Siwan (Bihar),4,18
14.0,NOTA,None of the Above,26925,39,26964,2.7,18 - Siwan (Bihar),4,18
,Total,,995506,2512,998018,,18 - Siwan (Bihar),4,18
1.0,"JANARDAN SINGH ""SIGRIWAL""",Bharatiya Janata Party,527974,1559,529533,52.22,19 - Maharajganj (Bihar),4,19
2.0,AAKASH KUMAR SINGH,Indian National Congress,425887,995,426882,42.09,19 - Maharajganj (Bihar),4,19
3.0,TRIBHUWAN RAM,Peoples Party of India (Democratic),14830,8,14838,1.46,19 - Maharajganj (Bihar),4,19
4.0,MADHUSUDAN SINGH,Bahujan Samaj Party,13359,43,13402,1.32,19 - Maharajganj (Bihar),4,19
5.0,AKHILESHWAR PRASAD SINGH,All India Majlis-E-Ittehadul Muslimeen,7750,17,7767,0.77,19 - Maharajganj (Bihar),4,19
6.0,NOTA,None of the Above,21662,25,21687,2.14,19 - Maharajganj (Bihar),4,19
,Total,,1011462,2647,1014109,,19 - Maharajganj (Bihar),4,19
1.0,RAJIV PRATAP RUDY,Bharatiya Janata Party,470234,1518,471752,46.18,20 - Saran (Bihar),4,20
2.0,ROHINI ACHARYA,Rashtriya Janata Dal,456763,1328,458091,44.84,20 - Saran (Bihar),4,20
3.0,LAXAMAN PRAO YADAV,Independent,22041,2,22043,2.16,20 - Saran (Bihar),4,20
4.0,SHAK NAUSHAD,Independent,16101,2,16103,1.58,20 - Saran (Bihar),4,20
5.0,AVINASH KUMAR,Bahujan Samaj Party,14708,62,14770,1.45,20 - Saran (Bihar),4,20
6.0,RAGHWENDRA PRATAP SINGH,Independent,5165,2,5167,0.51,20 - Saran (Bihar),4,20
7.0,GAJENDRA PRASAD CHAURSIYA,Janhit Kisan Party,5025,5,5030,0.49,20 - Saran (Bihar),4,20
8.0,SHATRUDHAN TIWARY,Bhartiya Sarthak Party,3661,26,3687,0.36,20 - Saran (Bihar),4,20
9.0,MOHAMAD SALIM,Independent,3148,3,3151,0.31,20 - Saran (Bihar),4,20
10.0,ARTI KUMARI,Independent,3009,14,3023,0.3,20 - Saran (Bihar),4,20
11.0,PRABHAT KUMAR,Independent,2302,4,2306,0.23,20 - Saran (Bihar),4,20
12.0,BARUN KUMAR DAS,Gana Suraksha Party,1770,5,1775,0.17,20 - Saran (Bihar),4,20
13.0,GYANI KUMAR SHARMA,Bharatiya Ekta Dal,1699,5,1704,0.17,20 - Saran (Bihar),4,20
14.0,RAJESH KUSHWAHA,Bhartiya Lok Chetna Party,1486,3,1489,0.15,20 - Saran (Bihar),4,20
15.0,NOTA,None of the Above,11382,35,11417,1.12,20 - Saran (Bihar),4,20
,Total,,1018494,3014,1021508,,20 - Saran (Bihar),4,20
1.0,CHIRAG PASWAN,Lok Janshakti Party(Ram Vilas),613106,2612,615718,53.29,21 - Hajipur (Bihar),4,21
2.0,SHIV CHANDRA RAM,Rashtriya Janata Dal,442553,3060,445613,38.57,21 - Hajipur (Bihar),4,21
3.0,SURENDRA KUMAR PASWAN,Independent,17241,4,17245,1.49,21 - Hajipur (Bihar),4,21
4.0,SHASHI SWARAJ,Bahujan Samaj Party,8591,88,8679,0.75,21 - Hajipur (Bihar),4,21
5.0,HARIWANSH PASWAN,Independent,7113,4,7117,0.62,21 - Hajipur (Bihar),4,21
6.0,SHAILENDRA KUMAR,Independent,6153,8,6161,0.53,21 - Hajipur (Bihar),4,21
7.0,ASHOK KUMAR,Samata Party,4701,20,4721,0.41,21 - Hajipur (Bihar),4,21
8.0,RANDHIR PASWAN,Independent,2671,4,2675,0.23,21 - Hajipur (Bihar),4,21
9.0,RAJ KUMAR PASWAN,Yuva Bihar Sena,1983,7,1990,0.17,21 - Hajipur (Bihar),4,21
10.0,DHARMENDRA KUMAR,Jantantra Awaj Party,1971,7,1978,0.17,21 - Hajipur (Bihar),4,21
11.0,MADHUSUDHAN PASWAN,Independent,1793,8,1801,0.16,21 - Hajipur (Bihar),4,21
12.0,RAJESH KUMAR RAUSHAN,Socialist Unity Centre Of India (COMMUNIST),1694,7,1701,0.15,21 - Hajipur (Bihar),4,21
13.0,MEGHNATH PASWAN,Independent,1680,-,1680,0.15,21 - Hajipur (Bihar),4,21
14.0,BALENDRA DAS,Janshakti Janta Dal,1308,10,1318,0.11,21 - Hajipur (Bihar),4,21
15.0,NOTA,None of the Above,36836,91,36927,3.2,21 - Hajipur (Bihar),4,21
,Total,,1149394,5930,1155324,,21 - Hajipur (Bihar),4,21
1.0,NITYANAND RAI,Bharatiya Janata Party,515159,806,515965,49.51,22 - Ujiarpur (Bihar),4,22
2.0,ALOK KUMAR MEHTA,Rashtriya Janata Dal,454870,993,455863,43.75,22 - Ujiarpur (Bihar),4,22
3.0,SANJAY PASWAN,Independent,16961,2,16963,1.63,22 - Ujiarpur (Bihar),4,22
4.0,MOHAN KUMAR MAURYA,Bahujan Samaj Party,7081,20,7101,0.68,22 - Ujiarpur (Bihar),4,22
5.0,RAKESH KUMAR,Independent,5953,4,5957,0.57,22 - Ujiarpur (Bihar),4,22
6.0,SANTHOSH RAI,Rashtriya Jansambhavna Party,4423,3,4426,0.42,22 - Ujiarpur (Bihar),4,22
7.0,NARENDRA GIRI,Independent,3150,1,3151,0.3,22 - Ujiarpur (Bihar),4,22
8.0,KISHOR KUMAR,Independent,2209,-,2209,0.21,22 - Ujiarpur (Bihar),4,22
9.0,AMARESH RAY,Independent,2140,3,2143,0.21,22 - Ujiarpur (Bihar),4,22
10.0,ANSHU KUMAR,Subhashwadi Bhartiya Samajwadi Party (Subhas Party),1749,7,1756,0.17,22 - Ujiarpur (Bihar),4,22
11.0,RAMPUKAR RAY,Socialist Unity Centre Of India (COMMUNIST),1299,7,1306,0.13,22 - Ujiarpur (Bihar),4,22
12.0,NIKKI JHA,Jagrook Janta Party,1006,14,1020,0.1,22 - Ujiarpur (Bihar),4,22
13.0,MANOJ KUMAR,Janta Raj Vikas Party,937,2,939,0.09,22 - Ujiarpur (Bihar),4,22
14.0,NOTA,None of the Above,23246,23,23269,2.23,22 - Ujiarpur (Bihar),4,22
,Total,,1040183,1885,1042068,,22 - Ujiarpur (Bihar),4,22
1.0,SHAMBHAVI,Lok Janshakti Party(Ram Vilas),579095,691,579786,52.97,23 - Samastipur (Bihar),4,23
2.0,SUNNY HAZARI,Indian National Congress,391558,977,392535,35.86,23 - Samastipur (Bihar),4,23
3.0,SHASHI BHUSHAN DAS,Independent,25953,4,25957,2.37,23 - Samastipur (Bihar),4,23
4.0,RAVI RAUSHAN KUMAR,Independent,16151,4,16155,1.48,23 - Samastipur (Bihar),4,23
5.0,RAM LAKHAN MAHTO,Bahujan Samaj Party,12698,34,12732,1.16,23 - Samastipur (Bihar),4,23
6.0,PINKU PASWAN,Rashtriya Jansambhavna Party,12426,11,12437,1.14,23 - Samastipur (Bihar),4,23
7.0,MUKESH CHAUPAL,Independent,5574,5,5579,0.51,23 - Samastipur (Bihar),4,23
8.0,JIBACHH KUMAR HAJARI,Independent,4686,8,4694,0.43,23 - Samastipur (Bihar),4,23
9.0,RATAN BIHARI,Desh Janhit Party,3411,8,3419,0.31,23 - Samastipur (Bihar),4,23
10.0,VIDYA NAND RAM,Wazib Adhikar Party,3110,2,3112,0.28,23 - Samastipur (Bihar),4,23
11.0,AMRITA KUMARI,Independent,2849,3,2852,0.26,23 - Samastipur (Bihar),4,23
12.0,LAL BABU MAHTO,Sathi Aur Aapka Faisala Party,2665,1,2666,0.24,23 - Samastipur (Bihar),4,23
13.0,NOTA,None of the Above,32645,23,32668,2.98,23 - Samastipur (Bihar),4,23
,Total,,1092821,1771,1094592,,23 - Samastipur (Bihar),4,23
1.0,GIRIRAJ SINGH,Bharatiya Janata Party,646912,2419,649331,50.15,24 - Begusarai (Bihar),4,24
2.0,ABDHESH KUMAR ROY,Communist Party of India,564310,3541,567851,43.86,24 - Begusarai (Bihar),4,24
3.0,INDRAJEET KUMAR ROY,Independent,12947,6,12953,1.0,24 - Begusarai (Bihar),4,24
4.0,RAJNISH KUMAR MUKHIYA,Rashtriya Jansambhavna Party,10846,26,10872,0.84,24 - Begusarai (Bihar),4,24
5.0,ADV CHANDAN KUMAR DAS,Bahujan Samaj Party,8362,91,8453,0.65,24 - Begusarai (Bihar),4,24
6.0,RAM BADAN RAI,Karpoori Janta Dal,6599,45,6644,0.51,24 - Begusarai (Bihar),4,24
7.0,MD SHAHNAWAZ HASSAN,Independent,6144,8,6152,0.48,24 - Begusarai (Bihar),4,24
8.0,ARUN KUMAR,Independent,4030,15,4045,0.31,24 - Begusarai (Bihar),4,24
9.0,RAJ KUMAR SAH,Akhil Bhartiya Parivar Party,3329,21,3350,0.26,24 - Begusarai (Bihar),4,24
10.0,RAMUDGAR,Socialist Unity Centre Of India (COMMUNIST),2633,7,2640,0.2,24 - Begusarai (Bihar),4,24
11.0,NOTA,None of the Above,22283,99,22382,1.73,24 - Begusarai (Bihar),4,24
,Total,,1288395,6278,1294673,,24 - Begusarai (Bihar),4,24
1.0,RAJESH VERMA,Lok Janshakti Party(Ram Vilas),537331,1326,538657,50.73,25 - Khagaria (Bihar),4,25
2.0,SANJAY KUMAR,Communist Party of India (Marxist),375988,1538,377526,35.55,25 - Khagaria (Bihar),4,25
3.0,RUPAM DEVI,Independent,27370,25,27395,2.58,25 - Khagaria (Bihar),4,25
4.0,SONU KUMAR,Independent,24478,5,24483,2.31,25 - Khagaria (Bihar),4,25
5.0,PINKESH KUMAR,Rashtriya Jan Kalyan Party Secular,19487,8,19495,1.84,25 - Khagaria (Bihar),4,25
6.0,DR RAVI KUMAR,Bahujan Samaj Party,13894,159,14053,1.32,25 - Khagaria (Bihar),4,25
7.0,AJAY KUMAR,Rashtriya Jansambhavna Party,8256,54,8310,0.78,25 - Khagaria (Bihar),4,25
8.0,PRIYADARSHEE DINKAR,Independent,7892,12,7904,0.74,25 - Khagaria (Bihar),4,25
9.0,DINANATH CHANDRAVANSHI,Independent,6142,20,6162,0.58,25 - Khagaria (Bihar),4,25
10.0,CHANDRA KISHOR THAKUR,Aam Janta Party Rashtriya,2806,43,2849,0.27,25 - Khagaria (Bihar),4,25
11.0,ASIF IMAM,Aadarsh Mithila Party,2434,9,2443,0.23,25 - Khagaria (Bihar),4,25
12.0,KANCHAN MALA,Hindustan People's Party (Democratic),1478,28,1506,0.14,25 - Khagaria (Bihar),4,25
13.0,NOTA,None of the Above,31056,55,31111,2.93,25 - Khagaria (Bihar),4,25
,Total,,1058612,3282,1061894,,25 - Khagaria (Bihar),4,25
1.0,AJAY KUMAR MANDAL,Janata Dal (United),534923,1108,536031,50.38,26 - Bhagalpur (Bihar),4,26
2.0,AJEET SHARMA,Indian National Congress,430025,1138,431163,40.52,26 - Bhagalpur (Bihar),4,26
3.0,POONAM SINGH,Bahujan Samaj Party,12547,99,12646,1.19,26 - Bhagalpur (Bihar),4,26
4.0,HARERAM YADAV,Independent,12255,3,12258,1.15,26 - Bhagalpur (Bihar),4,26
5.0,DEEPAK KUMAR SINGH,Rashtriya Jansambhavna Party,7654,16,7670,0.72,26 - Bhagalpur (Bihar),4,26
6.0,CHHOTE LAL KUMAR,Independent,6677,6,6683,0.63,26 - Bhagalpur (Bihar),4,26
7.0,RAMESH TUDU,Independent,6629,5,6634,0.62,26 - Bhagalpur (Bihar),4,26
8.0,UMESH PRASAD YADAV,Peoples Party of India (Democratic),5105,21,5126,0.48,26 - Bhagalpur (Bihar),4,26
9.0,DEEPAK KUMAR,Socialist Unity Centre Of India (COMMUNIST),3758,5,3763,0.35,26 - Bhagalpur (Bihar),4,26
10.0,MUKESH KUMAR,Akhil Bhartiya Parivar Party,3670,11,3681,0.35,26 - Bhagalpur (Bihar),4,26
11.0,DAYARAM MANDAL,Lok Sewa Dal,3509,10,3519,0.33,26 - Bhagalpur (Bihar),4,26
12.0,OM PRAKASH PODDAR,Independent,3091,13,3104,0.29,26 - Bhagalpur (Bihar),4,26
13.0,NOTA,None of the Above,31771,32,31803,2.99,26 - Bhagalpur (Bihar),4,26
,Total,,1061614,2467,1064081,,26 - Bhagalpur (Bihar),4,26
1.0,GIRIDHARI YADAV,Janata Dal (United),505674,1004,506678,49.96,27 - Banka (Bihar),4,27
2.0,JAI PRAKASH NARAYAN YADAV,Rashtriya Janata Dal,401567,1267,402834,39.72,27 - Banka (Bihar),4,27
3.0,NARESH YADAV,Independent,14936,3,14939,1.47,27 - Banka (Bihar),4,27
4.0,JAY PRAKASH YADAV,Rashtriya Jansambhavna Party,12254,23,12277,1.21,27 - Banka (Bihar),4,27
5.0,AMRIT TANTI,Bhartiya Dalit Party,9615,55,9670,0.95,27 - Banka (Bihar),4,27
6.0,NARESH KUMAR PRIYADARSHI,Independent,8103,22,8125,0.8,27 - Banka (Bihar),4,27
7.0,GANESH KUMAR KUSHAWAHA,Samata Party,7627,18,7645,0.75,27 - Banka (Bihar),4,27
8.0,UTTAM KUMAR SINGH,Aam Janta Party Rashtriya,6874,37,6911,0.68,27 - Banka (Bihar),4,27
9.0,KAVINDRA PANDIT,Socialist Unity Centre Of India (COMMUNIST),5226,20,5246,0.52,27 - Banka (Bihar),4,27
10.0,UMAKANT YADAV,Independent,4932,9,4941,0.49,27 - Banka (Bihar),4,27
11.0,NOTA,None of the Above,34808,81,34889,3.44,27 - Banka (Bihar),4,27
,Total,,1011616,2539,1014155,,27 - Banka (Bihar),4,27
1.0,RAJIV RANJAN SINGH ALIAS LALAN SINGH,Janata Dal (United),547814,2332,550146,48.3,28 - Munger (Bihar),4,28
2.0,KUMARI ANITA,Rashtriya Janata Dal,467412,1864,469276,41.2,28 - Munger (Bihar),4,28
3.0,SHANKAR PRASAD BIND,Independent,21016,7,21023,1.85,28 - Munger (Bihar),4,28
4.0,PRIYADARSHI PIYUSH,Independent,15718,13,15731,1.38,28 - Munger (Bihar),4,28
5.0,A. K. SINGH ‘ASHOK’,Independent,13809,16,13825,1.21,28 - Munger (Bihar),4,28
6.0,KUMAR NAVNEET HIMANSHU,Bahujan Samaj Party,12143,137,12280,1.08,28 - Munger (Bihar),4,28
7.0,KULDIP YADAV,Hindustan People's Party (Democratic),9455,31,9486,0.83,28 - Munger (Bihar),4,28
8.0,NEETISH KUMAR,Independent,7470,37,7507,0.66,28 - Munger (Bihar),4,28
9.0,PRAVAL KUMAR,Independent,5366,9,5375,0.47,28 - Munger (Bihar),4,28
10.0,RAVINDRA MANDAL,Socialist Unity Centre Of India (COMMUNIST),4893,20,4913,0.43,28 - Munger (Bihar),4,28
11.0,ADITYA SINGH MADHUKAR,Independent,4124,16,4140,0.36,28 - Munger (Bihar),4,28
12.0,PANKAJ KUMAR,Independent,3410,18,3428,0.3,28 - Munger (Bihar),4,28
13.0,NOTA,None of the Above,21920,31,21951,1.93,28 - Munger (Bihar),4,28
,Total,,1134550,4531,1139081,,28 - Munger (Bihar),4,28
1.0,KAUSHALENDRA KUMAR,Janata Dal (United),557054,2368,559422,48.88,29 - Nalanda (Bihar),4,29
2.0,DR. SANDEEP SAURAV,Communist Party of India (Marxist-Leninist) (Liberation),388052,2256,390308,34.11,29 - Nalanda (Bihar),4,29
3.0,SUDHIR KUMAR,Sanyukt Kisan Vikas Party,25286,5,25291,2.21,29 - Nalanda (Bihar),4,29
4.0,SURENDRA PRASAD,Al-Hind Party,18571,5,18576,1.62,29 - Nalanda (Bihar),4,29
5.0,SHASHI KUMAR,Samaj Shakti Party,18472,8,18480,1.61,29 - Nalanda (Bihar),4,29
6.0,PRAMOD KUMAR NIRALA,Bahujan Samaj Party,15233,99,15332,1.34,29 - Nalanda (Bihar),4,29
7.0,AJEET KUMAR,Independent,14746,4,14750,1.29,29 - Nalanda (Bihar),4,29
8.0,VINAY PRATAP SINGH,Rashtriya Sanatan Party,9593,9,9602,0.84,29 - Nalanda (Bihar),4,29
9.0,SANJAY RAJESH,Karpoori Janta Dal,7878,9,7887,0.69,29 - Nalanda (Bihar),4,29
10.0,SUDHIR DAS,Independent,6804,2,6806,0.59,29 - Nalanda (Bihar),4,29
11.0,KANHAIYA LAL YADAV,Jagrook Janta Party,6665,27,6692,0.58,29 - Nalanda (Bihar),4,29
12.0,SANYUKTA KUMARI,Independent,6232,6,6238,0.55,29 - Nalanda (Bihar),4,29
13.0,AJIT KUMAR,Independent,5515,5,5520,0.48,29 - Nalanda (Bihar),4,29
14.0,SHYAM SUNDAR PRASAD,Independent,3922,10,3932,0.34,29 - Nalanda (Bihar),4,29
15.0,RAMESH KUMAR,Naki Bharatiya Ekta Party,3840,5,3845,0.34,29 - Nalanda (Bihar),4,29
16.0,KISLAY KUMAR,Independent,3599,3,3602,0.31,29 - Nalanda (Bihar),4,29
17.0,KESHO JAMADAR,Peoples Party of India (Democratic),3369,18,3387,0.3,29 - Nalanda (Bihar),4,29
18.0,SURENDER SINGH,Independent,3341,4,3345,0.29,29 - Nalanda (Bihar),4,29
19.0,DILIP KUMAR,Moolniwasi Samaj Party,2724,5,2729,0.24,29 - Nalanda (Bihar),4,29
20.0,NAND KISHOR PARASAD,Pragatisheel Magahi Samaj,2456,12,2468,0.22,29 - Nalanda (Bihar),4,29
21.0,NISHA RANJAN,Samata Party,2397,18,2415,0.21,29 - Nalanda (Bihar),4,29
22.0,SHASHIRANJAN SUMAN,Independent,2331,9,2340,0.2,29 - Nalanda (Bihar),4,29
23.0,GHANSHYAM PRASAD SINGH,Independent,2108,2,2110,0.18,29 - Nalanda (Bihar),4,29
24.0,KUMAR HARI CHARAN SINGH YADAV,Bharatiya Momin Front,1971,9,1980,0.17,29 - Nalanda (Bihar),4,29
25.0,MUNNA KUMAR,Sankhyanupati Bhagidari Party,1937,12,1949,0.17,29 - Nalanda (Bihar),4,29
26.0,MUNNA KUMAR,Samajwadi Lok Parishad,1867,13,1880,0.16,29 - Nalanda (Bihar),4,29
27.0,PAWAN KUMAR,Independent,1595,2,1597,0.14,29 - Nalanda (Bihar),4,29
28.0,PUJA DEVI,Independent,1491,14,1505,0.13,29 - Nalanda (Bihar),4,29
29.0,CHANDRA KISHOR PRASAD YADAV,Independent,1177,1,1178,0.1,29 - Nalanda (Bihar),4,29
30.0,NOTA,None of the Above,19110,107,19217,1.68,29 - Nalanda (Bihar),4,29
,Total,,1139336,5047,1144383,,29 - Nalanda (Bihar),4,29
1.0,RAVI SHANKAR PRASAD,Bharatiya Janata Party,587212,1058,588270,54.7,30 - Patna Sahib (Bihar),4,30
2.0,ANSHUL AVIJIT,Indian National Congress,433818,606,434424,40.39,30 - Patna Sahib (Bihar),4,30
3.0,RAKESH SHARMA,Independent,9942,1,9943,0.92,30 - Patna Sahib (Bihar),4,30
4.0,NEERAJ KUMAR,Bahujan Samaj Party,5912,16,5928,0.55,30 - Patna Sahib (Bihar),4,30
5.0,AWADHESH PRASAD,Independent,4973,1,4974,0.46,30 - Patna Sahib (Bihar),4,30
6.0,ENG UMESH RAJAK,Peoples Party of India (Democratic),4664,8,4672,0.43,30 - Patna Sahib (Bihar),4,30
7.0,SANJAY KUMAR URF SANJAY BALMIKI,Independent,4643,-,4643,0.43,30 - Patna Sahib (Bihar),4,30
8.0,DHARMVIR KUMAR BHASKAR,Independent,2415,1,2416,0.22,30 - Patna Sahib (Bihar),4,30
9.0,AMIT KUMAR ALBELA,Independent,2050,3,2053,0.19,30 - Patna Sahib (Bihar),4,30
10.0,MAHESH KUMAR,Samata Party,2003,-,2003,0.19,30 - Patna Sahib (Bihar),4,30
11.0,DHANJAY KUMAR,Rashtriya Jansambhavna Party,1969,2,1971,0.18,30 - Patna Sahib (Bihar),4,30
12.0,GULAB PRASAD,Loktantrik Samajwadi Party,1923,2,1925,0.18,30 - Patna Sahib (Bihar),4,30
13.0,SUMIT RANJAN SINHA,Akhand Bharat Janpriya Party,1715,1,1716,0.16,30 - Patna Sahib (Bihar),4,30
14.0,MAHBOOB ALAM ANSARI,Bharatiya Momin Front,1635,3,1638,0.15,30 - Patna Sahib (Bihar),4,30
15.0,DR RAKESH DUTTA MISHRA,Bharatiya Jan Kranti Dal (Democratic),1238,2,1240,0.12,30 - Patna Sahib (Bihar),4,30
16.0,SAROJ KUMAR SUMAN,Socialist Unity Centre Of India (COMMUNIST),1078,-,1078,0.1,30 - Patna Sahib (Bihar),4,30
17.0,SHAHID ALAM,Jantantra Awaj Party,1040,3,1043,0.1,30 - Patna Sahib (Bihar),4,30
18.0,NOTA,None of the Above,5532,27,5559,0.52,30 - Patna Sahib (Bihar),4,30
,Total,,1073762,1734,1075496,,30 - Patna Sahib (Bihar),4,30
1.0,MISHA BHARTI,Rashtriya Janata Dal,612147,1136,613283,49.86,31 - Patliputra (Bihar),4,31
2.0,RAM KRIPAL YADAV,Bharatiya Janata Party,526608,1501,528109,42.93,31 - Patliputra (Bihar),4,31
3.0,DR S P SHARMA,Hindustan Vikas Dal,15139,1,15140,1.23,31 - Patliputra (Bihar),4,31
4.0,HARIKESHWAR RAM,Bahujan Samaj Party,10931,34,10965,0.89,31 - Patliputra (Bihar),4,31
5.0,VINDU DEVI,Rashtriya Jansambhavna Party,10741,3,10744,0.87,31 - Patliputra (Bihar),4,31
6.0,SHIV KUMAR SINGH,Apna Kisan Party,9011,5,9016,0.73,31 - Patliputra (Bihar),4,31
7.0,SANJAY KUMAR SINGH,Bhartiya Sarthak Party,4753,-,4753,0.39,31 - Patliputra (Bihar),4,31
8.0,MD FAROOQUE RAZA,All India Majlis-E-Ittehadul Muslimeen,4010,13,4023,0.33,31 - Patliputra (Bihar),4,31
9.0,RAM NIRANJAN ROY,Rashtrawadi Chetna Party,3914,1,3915,0.32,31 - Patliputra (Bihar),4,31
10.0,MRITUNJAY KUMAR,Bhagidari Party(P),3483,-,3483,0.28,31 - Patliputra (Bihar),4,31
11.0,DURGESH NANDAN SINGH,Independent,3104,2,3106,0.25,31 - Patliputra (Bihar),4,31
12.0,NAGESHWAR PRASAD,Peoples Party of India (Democratic),2048,3,2051,0.17,31 - Patliputra (Bihar),4,31
13.0,SUBHASH KUMAR,Bhartiya Lok Chetna Party,1979,-,1979,0.16,31 - Patliputra (Bihar),4,31
14.0,NITESH KUMAR PATEL,Adarsh Jankalyan Dal,1816,1,1817,0.15,31 - Patliputra (Bihar),4,31
15.0,RANJAN KUMAR,Independent,1807,2,1809,0.15,31 - Patliputra (Bihar),4,31
16.0,NIRAJ KUMAR,Independent,1767,4,1771,0.14,31 - Patliputra (Bihar),4,31
17.0,KUNAL KUMAR,Hamara Sahara Party,1607,7,1614,0.13,31 - Patliputra (Bihar),4,31
18.0,KHUSHBOO KUMARI,Akhil Bhartiya Parivar Party,1479,4,1483,0.12,31 - Patliputra (Bihar),4,31
19.0,ANIL DAS,Bhartiya Dalit Party,1465,4,1469,0.12,31 - Patliputra (Bihar),4,31
20.0,ANIL KUMAR CHAND,Socialist Unity Centre Of India (COMMUNIST),1421,3,1424,0.12,31 - Patliputra (Bihar),4,31
21.0,MADHURI KUMARI,All India Forward Bloc,1301,1,1302,0.11,31 - Patliputra (Bihar),4,31
22.0,JAWAHAR SINGH,Bhartiya Manavta Party,1235,2,1237,0.1,31 - Patliputra (Bihar),4,31
23.0,NOTA,None of the Above,5573,33,5606,0.46,31 - Patliputra (Bihar),4,31
,Total,,1227339,2760,1230099,,31 - Patliputra (Bihar),4,31
1.0,SUDAMA PRASAD,Communist Party of India (Marxist-Leninist) (Liberation),526564,2818,529382,48.28,32 - Arrah (Bihar),4,32
2.0,R. K. SINGH,Bharatiya Janata Party,464736,4838,469574,42.82,32 - Arrah (Bihar),4,32
3.0,VIRENDRA KUMAR SINGH,Independent,23630,5,23635,2.16,32 - Arrah (Bihar),4,32
4.0,SHIV DAS SINGH,Independent,13373,6,13379,1.22,32 - Arrah (Bihar),4,32
5.0,LAL BADSAH SINGH,Bahujan Samaj Party,10631,195,10826,0.99,32 - Arrah (Bihar),4,32
6.0,KRISHNA PASWAN,Bhartiya Kranti Vir Party,8709,40,8749,0.8,32 - Arrah (Bihar),4,32
7.0,RANDHIR LAL,Independent,5765,1,5766,0.53,32 - Arrah (Bihar),4,32
8.0,NAVNIT KUMAR,Independent,4764,9,4773,0.44,32 - Arrah (Bihar),4,32
9.0,RAM SARE SINGH,Peoples Party of India (Democratic),2531,10,2541,0.23,32 - Arrah (Bihar),4,32
10.0,DHARMATMA SHARMA,Socialist Unity Centre Of India (COMMUNIST),2449,18,2467,0.22,32 - Arrah (Bihar),4,32
11.0,RAMJEE SINGH,Voters Party International,2435,5,2440,0.22,32 - Arrah (Bihar),4,32
12.0,ASHOK TIWARY,Independent,2263,32,2295,0.21,32 - Arrah (Bihar),4,32
13.0,MANMOHAN SINGH,Rashtrawadi Janlok Party (Satya),2055,42,2097,0.19,32 - Arrah (Bihar),4,32
14.0,SUMITRA DEVI,Jagrook Janta Party,1640,34,1674,0.15,32 - Arrah (Bihar),4,32
15.0,NOTA,None of the Above,16864,99,16963,1.55,32 - Arrah (Bihar),4,32
,Total,,1088409,8152,1096561,,32 - Arrah (Bihar),4,32
1.0,SUDHAKAR SINGH,Rashtriya Janata Dal,435062,3283,438345,40.82,33 - Buxar (Bihar),4,33
2.0,MITHILESH TIWARI,Bharatiya Janata Party,405795,2459,408254,38.02,33 - Buxar (Bihar),4,33
3.0,ANIL KUMAR,Bahujan Samaj Party,114312,402,114714,10.68,33 - Buxar (Bihar),4,33
4.0,ANAND MISHRA S/O- PARAM HANS MISHRA,Independent,46527,882,47409,4.42,33 - Buxar (Bihar),4,33
5.0,DADAN YADAV,Independent,15653,183,15836,1.47,33 - Buxar (Bihar),4,33
6.0,SUDHAKAR MISHRA,Independent,12742,7,12749,1.19,33 - Buxar (Bihar),4,33
7.0,SUNIL KUMAR DUBY,Independent,7757,2,7759,0.72,33 - Buxar (Bihar),4,33
8.0,RAM SWAROOP CHAUHAN,Independent,5506,10,5516,0.51,33 - Buxar (Bihar),4,33
9.0,RAJU SINGH,Bahujan Mukti Party,4322,17,4339,0.4,33 - Buxar (Bihar),4,33
10.0,AANAND MISRA S/O MADAN KUMAR MISRA,Independent,2697,137,2834,0.26,33 - Buxar (Bihar),4,33
11.0,BHAGWAN SINGH YADAV,Independent,2045,8,2053,0.19,33 - Buxar (Bihar),4,33
12.0,NIRANJAN KUMAR RAY,Independent,1667,2,1669,0.16,33 - Buxar (Bihar),4,33
13.0,HEM LATA,Jagrook Janta Party,1554,16,1570,0.15,33 - Buxar (Bihar),4,33
14.0,AKHILESH KUMAR PANDEY,Independent,1089,6,1095,0.1,33 - Buxar (Bihar),4,33
15.0,NOTA,None of the Above,9572,45,9617,0.9,33 - Buxar (Bihar),4,33
,Total,,1066300,7459,1073759,,33 - Buxar (Bihar),4,33
1.0,MANOJ KUMAR,Indian National Congress,509977,3027,513004,46.76,34 - Sasaram (Bihar),4,34
2.0,SHIVESH KUMAR,Bharatiya Janata Party,492177,1670,493847,45.01,34 - Sasaram (Bihar),4,34
3.0,SANTOSH KUMAR,Bahujan Samaj Party,45491,107,45598,4.16,34 - Sasaram (Bihar),4,34
4.0,SHIV SHANKAR RAM,Independent,8009,10,8019,0.73,34 - Sasaram (Bihar),4,34
5.0,SANTOSH KUMAR KHARWAR,Bhartiya Gandhiwadi Party,4817,5,4822,0.44,34 - Sasaram (Bihar),4,34
6.0,BANARSI DAS,Peoples Party of India (Democratic),4498,-,4498,0.41,34 - Sasaram (Bihar),4,34
7.0,AMIT KUMAR AMBEDKAR,Bahujan Mukti Party,2823,11,2834,0.26,34 - Sasaram (Bihar),4,34
8.0,PUNAM DEVI,Jantantra Awaj Party,2634,20,2654,0.24,34 - Sasaram (Bihar),4,34
9.0,UJARAN MUSAHAR,Jan Janwadi Party,2616,4,2620,0.24,34 - Sasaram (Bihar),4,34
10.0,NANDLAL RAM,Rashtriya Samaj Paksha,1956,4,1960,0.18,34 - Sasaram (Bihar),4,34
11.0,NOTA,None of the Above,17160,59,17219,1.57,34 - Sasaram (Bihar),4,34
,Total,,1092158,4917,1097075,,34 - Sasaram (Bihar),4,34
1.0,RAJA RAM SINGH,Communist Party of India (Marxist-Leninist) (Liberation),378922,1659,380581,36.89,35 - Karakat (Bihar),4,35
2.0,PAWAN SINGH,Independent,273546,1177,274723,26.63,35 - Karakat (Bihar),4,35
3.0,UPENDRA KUSHWAHA,Rashtriya Lok Morcha,253088,788,253876,24.61,35 - Karakat (Bihar),4,35
4.0,DHEERAJ KUMAR SINGH,Bahujan Samaj Party,23549,108,23657,2.29,35 - Karakat (Bihar),4,35
5.0,RAJA RAM SINGH,Independent,21357,26,21383,2.07,35 - Karakat (Bihar),4,35
6.0,PRIYANKA PRASAD CHOUDHARY,All India Majlis-E-Ittehadul Muslimeen,10983,23,11006,1.07,35 - Karakat (Bihar),4,35
7.0,AJEET KUMAR SINGH,Peoples Party of India (Democratic),9634,19,9653,0.94,35 - Karakat (Bihar),4,35
8.0,VIKASH VINAYAK,Jan Janwadi Party,7661,3,7664,0.74,35 - Karakat (Bihar),4,35
9.0,INDRA RAJ ROUSHAN,Independent,6315,9,6324,0.61,35 - Karakat (Bihar),4,35
10.0,PRADEEP KUMAR JOSHI,Rashtra Sewa Dal,5891,28,5919,0.57,35 - Karakat (Bihar),4,35
11.0,AVADHESH PASAWAN,Bharatiya Aam Awam Party,5527,58,5585,0.54,35 - Karakat (Bihar),4,35
12.0,RAJESHWAR PASWAN,Akhil Hind Forward Bloc (Krantikari),5003,3,5006,0.49,35 - Karakat (Bihar),4,35
13.0,PRAYAG PASWAN,Socialist Unity Centre Of India (COMMUNIST),4641,5,4646,0.45,35 - Karakat (Bihar),4,35
14.0,NOTA,None of the Above,21548,47,21595,2.09,35 - Karakat (Bihar),4,35
,Total,,1027665,3953,1031618,,35 - Karakat (Bihar),4,35
1.0,SURENDRA PRASAD YADAV,Rashtriya Janata Dal,440352,2683,443035,47.88,36 - Jahanabad (Bihar),4,36
2.0,CHANDESHWAR PRASAD,Janata Dal (United),299044,1400,300444,32.47,36 - Jahanabad (Bihar),4,36
3.0,ARUN KUMAR,Bahujan Samaj Party,85696,684,86380,9.33,36 - Jahanabad (Bihar),4,36
4.0,MINTA DEVI,Independent,16112,11,16123,1.74,36 - Jahanabad (Bihar),4,36
5.0,MUNILAL YADAV,Independent,13021,8,13029,1.41,36 - Jahanabad (Bihar),4,36
6.0,ASHUTOSH KUMAR,Rashtriya Jan Jan Party,12954,259,13213,1.43,36 - Jahanabad (Bihar),4,36
7.0,DEEPAK KUMAR,Jagrook Janta Party,8944,26,8970,0.97,36 - Jahanabad (Bihar),4,36
8.0,BUDDHADEV SAV,Independent,5765,8,5773,0.62,36 - Jahanabad (Bihar),4,36
9.0,NARESH KUMAR,Independent,5709,3,5712,0.62,36 - Jahanabad (Bihar),4,36
10.0,CHANDESHWAR PRASAD,Independent,5356,22,5378,0.58,36 - Jahanabad (Bihar),4,36
11.0,PIYUSH SINGH,Shoshit Samaj Dal,4611,7,4618,0.5,36 - Jahanabad (Bihar),4,36
12.0,RAJ KISHOR SHARMA,Bhartiya Sarthak Party,3230,13,3243,0.35,36 - Jahanabad (Bihar),4,36
13.0,KAPIL CHAUHAN,Jan Janwadi Party,2954,10,2964,0.32,36 - Jahanabad (Bihar),4,36
14.0,ASHUTOSH VINAY KUMAR,Rashtriya Garib Dal,2895,14,2909,0.31,36 - Jahanabad (Bihar),4,36
15.0,UMA SHANKAR VERMA,Socialist Unity Centre Of India (COMMUNIST),2509,15,2524,0.27,36 - Jahanabad (Bihar),4,36
16.0,NOTA,None of the Above,10960,95,11055,1.19,36 - Jahanabad (Bihar),4,36
,Total,,920112,5258,925370,,36 - Jahanabad (Bihar),4,36
1.0,ABHAY KUMAR SINHA,Rashtriya Janata Dal,463845,1722,465567,49.22,37 - Aurangabad (Bihar),4,37
2.0,SUSHIL KUMAR SINGH,Bharatiya Janata Party,384819,1637,386456,40.86,37 - Aurangabad (Bihar),4,37
3.0,SUNESH KUMAR,Bahujan Samaj Party,20232,77,20309,2.15,37 - Aurangabad (Bihar),4,37
4.0,PRATIBHA RANI,Peoples Party of India (Democratic),12265,43,12308,1.3,37 - Aurangabad (Bihar),4,37
5.0,RAJ BALLABH SINGH,Independent,11150,9,11159,1.18,37 - Aurangabad (Bihar),4,37
6.0,RAMJIT SINGH,Rashtriya Jansambhavna Party,9237,6,9243,0.98,37 - Aurangabad (Bihar),4,37
7.0,SURESH PRASAD VERMA,Independent,6704,7,6711,0.71,37 - Aurangabad (Bihar),4,37
8.0,MOHAMMAD WALIULLAH KHAN,Independent,6591,13,6604,0.7,37 - Aurangabad (Bihar),4,37
9.0,SHAILESH RAHI,Akhil Hind Forward Bloc (Krantikari),4892,4,4896,0.52,37 - Aurangabad (Bihar),4,37
10.0,NOTA,None of the Above,22566,61,22627,2.39,37 - Aurangabad (Bihar),4,37
,Total,,942301,3579,945880,,37 - Aurangabad (Bihar),4,37
1.0,JITAN RAM MANJHI,Hindustani Awam Morcha (Secular),492732,2228,494960,51.36,38 - Gaya (Bihar),4,38
2.0,KUMAR SARVJEET,Rashtriya Janata Dal,390469,2679,393148,40.8,38 - Gaya (Bihar),4,38
3.0,SUSHMA KUMARI,Bahujan Samaj Party,12234,142,12376,1.28,38 - Gaya (Bihar),4,38
4.0,DEVENDRA PRATAP,Independent,9209,2,9211,0.96,38 - Gaya (Bihar),4,38
5.0,DHEERENDRA PRASAD,Loktantrik Samajwadi Party,5616,13,5629,0.58,38 - Gaya (Bihar),4,38
6.0,GIRIDHAR SAPERA,The National Road Map Party of India,4708,19,4727,0.49,38 - Gaya (Bihar),4,38
7.0,RANU KUMAR CHAUDHARY,Independent,4495,10,4505,0.47,38 - Gaya (Bihar),4,38
8.0,RANJAN KUMAR,Independent,4233,1,4234,0.44,38 - Gaya (Bihar),4,38
9.0,AYUSH KUMAR,Independent,4098,5,4103,0.43,38 - Gaya (Bihar),4,38
10.0,SURENDRA MANJHI,Rashtriya Jansambhavna Party,3023,12,3035,0.31,38 - Gaya (Bihar),4,38
11.0,AMRESH KUMAR,Independent,2800,21,2821,0.29,38 - Gaya (Bihar),4,38
12.0,ASHOK KUMAR PASWAN,Independent,2692,9,2701,0.28,38 - Gaya (Bihar),4,38
13.0,ARUN KUMAR,Independent,2531,23,2554,0.27,38 - Gaya (Bihar),4,38
14.0,SHEO SHANKAR,Bhartiya Lok Chetna Party,2370,14,2384,0.25,38 - Gaya (Bihar),4,38
15.0,NOTA,None of the Above,17177,111,17288,1.79,38 - Gaya (Bihar),4,38
,Total,,958387,5289,963676,,38 - Gaya (Bihar),4,38
1.0,VIVEK THAKUR,Bharatiya Janata Party,408537,2071,410608,47.2,39 - Nawada (Bihar),4,39
2.0,SHRAWAN KUMAR,Rashtriya Janata Dal,340562,2376,342938,39.42,39 - Nawada (Bihar),4,39
3.0,BINOD YADAV,Independent,39391,128,39519,4.54,39 - Nawada (Bihar),4,39
4.0,GUNJAN KUMAR,Independent,29444,238,29682,3.41,39 - Nawada (Bihar),4,39
5.0,RANJIT KUMAR,Bahujan Samaj Party,16240,76,16316,1.88,39 - Nawada (Bihar),4,39
6.0,ANAND KUMAR VERMA,Bharat Jan Jagran Dal,7727,9,7736,0.89,39 - Nawada (Bihar),4,39
7.0,GAUTAM KUMAR BABLOO,Bhagidari Party(P),5886,3,5889,0.68,39 - Nawada (Bihar),4,39
8.0,GANAURI PANDIT,Peoples Party of India (Democratic),4558,32,4590,0.53,39 - Nawada (Bihar),4,39
9.0,NOTA,None of the Above,12555,37,12592,1.45,39 - Nawada (Bihar),4,39
,Total,,864900,4970,869870,,39 - Nawada (Bihar),4,39
1.0,ARUN BHARTI,Lok Janshakti Party(Ram Vilas),508179,867,509046,51.98,40 - Jamui (Bihar),4,40
2.0,ARCHANA KUMARI,Rashtriya Janata Dal,395696,868,396564,40.5,40 - Jamui (Bihar),4,40
3.0,SUBHASH PASWAN,Independent,13841,34,13875,1.42,40 - Jamui (Bihar),4,40
4.0,SAKALDEO DAS,Bahujan Samaj Party,12313,53,12366,1.26,40 - Jamui (Bihar),4,40
5.0,SRAWON KUMAR,Rashtriya Jansambhavna Party,8604,21,8625,0.88,40 - Jamui (Bihar),4,40
6.0,JAGDISH PRASAD,Loktantrik Samajik Nyay Party,6532,10,6542,0.67,40 - Jamui (Bihar),4,40
7.0,SANTOSH KUMAR DAS,Socialist Unity Centre Of India (COMMUNIST),6025,8,6033,0.62,40 - Jamui (Bihar),4,40
8.0,NOTA,None of the Above,26148,34,26182,2.67,40 - Jamui (Bihar),4,40
,Total,,977338,1895,979233,,40 - Jamui (Bihar),4,40
1.0,SHRIPAD YESSO NAIK,Bharatiya Janata Party,253812,3514,257326,56.43,1 - North Goa (Goa),5,1
2.0,RAMAKANT KHALAP,Indian National Congress,140191,1120,141311,30.99,1 - North Goa (Goa),5,1
3.0,TUKARAM BHARAT PARAB,Revolutionary Goans Party,45460,233,45693,10.02,1 - North Goa (Goa),5,1
4.0,MILAN R VAINGANKAR,Bahujan Samaj Party,1600,25,1625,0.36,1 - North Goa (Goa),5,1
5.0,MR SAKHARAM NAIK,Akhil Bhartiya Parivar Party,1404,13,1417,0.31,1 - North Goa (Goa),5,1
6.0,SHAKEEL JAMAL SHAIKH,Independent,800,7,807,0.18,1 - North Goa (Goa),5,1
7.0,THOMAS AUGUSTINE FERNANDES,Independent,746,13,759,0.17,1 - North Goa (Goa),5,1
8.0,ADV VISHAL NAIK,Independent,744,8,752,0.16,1 - North Goa (Goa),5,1
9.0,NOTA,None of the Above,6297,31,6328,1.39,1 - North Goa (Goa),5,1
,Total,,451054,4964,456018,,1 - North Goa (Goa),5,1
1.0,CAPTAIN VIRIATO FERNANDES,Indian National Congress,216022,1814,217836,48.35,2 - South Goa (Goa),5,2
2.0,PALLAVI SHRINIVAS DEMPO,Bharatiya Janata Party,201806,2495,204301,45.35,2 - South Goa (Goa),5,2
3.0,RUBERT PEREIRA,Revolutionary Goans Party,18718,167,18885,4.19,2 - South Goa (Goa),5,2
4.0,DR SWETA GAONKAR,Bahujan Samaj Party,1545,36,1581,0.35,2 - South Goa (Goa),5,2
5.0,DEEPKUMAR D MAPARI,Independent,1309,8,1317,0.29,2 - South Goa (Goa),5,2
6.0,DR KALIDAS VAINGANKAR,Independent,707,13,720,0.16,2 - South Goa (Goa),5,2
7.0,ALEXY FERNANDES,Independent,526,16,542,0.12,2 - South Goa (Goa),5,2
8.0,HARISHCHANDRA SUDHAKAR NAIK,Corruption Abolition Party,487,14,501,0.11,2 - South Goa (Goa),5,2
9.0,NOTA,None of the Above,4804,33,4837,1.07,2 - South Goa (Goa),5,2
,Total,,445924,4596,450520,,2 - South Goa (Goa),5,2
1.0,CHAVDA VINOD LAKHAMSHI,Bharatiya Janata Party,656979,2595,659574,60.23,1 - Kachchh (Gujarat),6,1
2.0,NITESH PARBATBHAI LALAN (MATANG),Indian National Congress,389384,1408,390792,35.68,1 - Kachchh (Gujarat),6,1
3.0,VIJAY BHACHRA,Bahujan Samaj Party,6075,36,6111,0.56,1 - Kachchh (Gujarat),6,1
4.0,VANAZARA HIRABEN DALPATBHAI,Independent,5145,6,5151,0.47,1 - Kachchh (Gujarat),6,1
5.0,BABULAL LADHA CHAVDA,Independent,3348,6,3354,0.31,1 - Kachchh (Gujarat),6,1
6.0,KAVITABEN DINESHBHAI MACHCHHOYA,Independent,3342,24,3366,0.31,1 - Kachchh (Gujarat),6,1
7.0,DEVABHAI MITHABHAI GOHIL,Rashtriya Power Party,2087,14,2101,0.19,1 - Kachchh (Gujarat),6,1
8.0,SHAMLIA VIRJI CHAKU,Hindvi Swarajyay Dal,1560,13,1573,0.14,1 - Kachchh (Gujarat),6,1
9.0,ARVIND ASHOK SANGHELA,Gujarat Sarva Samaj Party,1509,17,1526,0.14,1 - Kachchh (Gujarat),6,1
10.0,BOCHIYA BHIMJI BHIKHA,Sarva Samaj Janata Party,1491,6,1497,0.14,1 - Kachchh (Gujarat),6,1
11.0,RAMJIBHAI JAKHUBHAI DAFDA,Right to Recall Party,1357,13,1370,0.13,1 - Kachchh (Gujarat),6,1
12.0,NOTA,None of the Above,18604,138,18742,1.71,1 - Kachchh (Gujarat),6,1
,Total,,1090881,4276,1095157,,1 - Kachchh (Gujarat),6,1
1.0,GENIBEN NAGAJI THAKOR,Indian National Congress,667072,4811,671883,48.83,2 - Banaskantha (Gujarat),6,2
2.0,DR. REKHABEN HITESHBHAI CHAUDHARI,Bharatiya Janata Party,635760,5717,641477,46.62,2 - Banaskantha (Gujarat),6,2
3.0,MANSUNGBHAI MASHRUBHAI PARMAR,Bahujan Samaj Party,9900,29,9929,0.72,2 - Banaskantha (Gujarat),6,2
4.0,RATHOD MAVJI BHEMAJI,Independent,7690,6,7696,0.56,2 - Banaskantha (Gujarat),6,2
5.0,SHRIMALI ASHOKBHAI BALCHANDBHAI,Independent,5473,8,5481,0.4,2 - Banaskantha (Gujarat),6,2
6.0,JASUBHAI GAMAR,Bharat Adivasi Party,4615,11,4626,0.34,2 - Banaskantha (Gujarat),6,2
7.0,PATEL PIYUSHBHAI KARSHANBHAI,Bharatiya Yuva Jan Ekta Party,3503,10,3513,0.26,2 - Banaskantha (Gujarat),6,2
8.0,BAJAG LASHABHAI LAVAJIBHAI,Independent,2994,15,3009,0.22,2 - Banaskantha (Gujarat),6,2
9.0,PRAVINBHAI ISHVARBHAI CHAUHAN,Swatantrata Abhivyakti Party,1822,1,1823,0.13,2 - Banaskantha (Gujarat),6,2
10.0,IBRAHIMBHAI PARASANI,Independent,1588,3,1591,0.12,2 - Banaskantha (Gujarat),6,2
11.0,PARMAR CHHAGANCHANDRARAJ,Independent,1369,5,1374,0.1,2 - Banaskantha (Gujarat),6,2
12.0,CHETANKUMAR KESHAVLAL OZA,Independent,1321,13,1334,0.1,2 - Banaskantha (Gujarat),6,2
13.0,NOTA,None of the Above,22034,133,22167,1.61,2 - Banaskantha (Gujarat),6,2
,Total,,1365141,10762,1375903,,2 - Banaskantha (Gujarat),6,2
1.0,DABHI BHARATSINHJI SHANKARJI,Bharatiya Janata Party,585591,6356,591947,49.61,3 - Patan (Gujarat),6,3
2.0,CHANDANJI TALAJI THAKOR,Indian National Congress,555134,4937,560071,46.94,3 - Patan (Gujarat),6,3
3.0,BALVANT CHHATRALIYA,Bahujan Samaj Party,5811,54,5865,0.49,3 - Patan (Gujarat),6,3
4.0,SOYAB HASAM BHORANIYA,Independent,5473,1,5474,0.46,3 - Patan (Gujarat),6,3
5.0,THAKOR KISHANBHAI KALUBHAI,Independent,2909,7,2916,0.24,3 - Patan (Gujarat),6,3
6.0,SHARMA RAKESHBHAI,Rashtriya Samaj Paksha,2765,9,2774,0.23,3 - Patan (Gujarat),6,3
7.0,GHAGHA MASIHULLAH ABDULHAMID,Social Democratic Party Of India,2305,7,2312,0.19,3 - Patan (Gujarat),6,3
8.0,CHANDURA DHANJIBHAI LAXAMANBHAI,Independent,2135,25,2160,0.18,3 - Patan (Gujarat),6,3
9.0,ABDULHAQ ISMAIL NEDARIYA,Independent,1510,14,1524,0.13,3 - Patan (Gujarat),6,3
10.0,ABDULKUDDUS,Independent,1358,2,1360,0.11,3 - Patan (Gujarat),6,3
11.0,NOTA,None of the Above,16382,340,16722,1.4,3 - Patan (Gujarat),6,3
,Total,,1181373,11752,1193125,,3 - Patan (Gujarat),6,3
1.0,HARIBHAI PATEL,Bharatiya Janata Party,675614,10792,686406,63.74,4 - Mahesana (Gujarat),6,4
2.0,RAMJI THAKOR,Indian National Congress,352578,5782,358360,33.28,4 - Mahesana (Gujarat),6,4
3.0,AMRUTLAL MAKWANA,Bahujan Samaj Party,9710,164,9874,0.92,4 - Mahesana (Gujarat),6,4
4.0,CHAUHAN PRAKASHKUMAR TRIBHOVANDAS,Akhila Vijaya Party,3866,16,3882,0.36,4 - Mahesana (Gujarat),6,4
5.0,PATEL MANUBHAI SHANKARLAL,Independent,3597,75,3672,0.34,4 - Mahesana (Gujarat),6,4
6.0,ZALA VIKRAMSINH BANESINH,Rashtra Nirman Party,2949,58,3007,0.28,4 - Mahesana (Gujarat),6,4
7.0,NOTA,None of the Above,11002,624,11626,1.08,4 - Mahesana (Gujarat),6,4
,Total,,1059316,17511,1076827,,4 - Mahesana (Gujarat),6,4
1.0,SHOBHANABEN MAHENDRASINH BARAIYA,Bharatiya Janata Party,670929,6389,677318,53.36,5 - Sabarkantha (Gujarat),6,5
2.0,CHAUDHARI TUSHAR AMARSINH,Indian National Congress,515902,5734,521636,41.09,5 - Sabarkantha (Gujarat),6,5
3.0,PARMAR RAMESHCHANDRA NANJIBHAI,Bahujan Samaj Party,9850,117,9967,0.79,5 - Sabarkantha (Gujarat),6,5
4.0,SOLANKI CHHAGANBHAI KEVLABHAI,Independent,7539,12,7551,0.59,5 - Sabarkantha (Gujarat),6,5
5.0,VIJAYSINH NAVALSINH CHAUHAN,Independent,6692,29,6721,0.53,5 - Sabarkantha (Gujarat),6,5
6.0,BHAVNABA NARENDRASINH PARMAR,Independent,5365,94,5459,0.43,5 - Sabarkantha (Gujarat),6,5
7.0,ANILKUMAR NIRANJANKUMAR MUNDADA,Log Party,5225,22,5247,0.41,5 - Sabarkantha (Gujarat),6,5
8.0,MUSTAKBHAI JAMALBHAI SANGHANI,Independent,3196,7,3203,0.25,5 - Sabarkantha (Gujarat),6,5
9.0,KATARA VARUNKUMAR KALYANSINH,Gunj Satya Ni Janata Party,2717,56,2773,0.22,5 - Sabarkantha (Gujarat),6,5
10.0,RAKESHSINH MAHOBATSINH ZALA,Bhartiya Jan Parishad,1882,69,1951,0.15,5 - Sabarkantha (Gujarat),6,5
11.0,PANDOR KAUSHIKKUMAR SHANKARBHAI,Independent,1782,45,1827,0.14,5 - Sabarkantha (Gujarat),6,5
12.0,ASHOK L VAGHELA,Independent,1673,15,1688,0.13,5 - Sabarkantha (Gujarat),6,5
13.0,KANUBHAI KHIMJIBHAI GADHAVI,Independent,1467,38,1505,0.12,5 - Sabarkantha (Gujarat),6,5
14.0,THAKOR INDIRABEN JITENDRASINH,Insaniyat Party,1402,34,1436,0.11,5 - Sabarkantha (Gujarat),6,5
15.0,NOTA,None of the Above,20665,411,21076,1.66,5 - Sabarkantha (Gujarat),6,5
,Total,,1256286,13072,1269358,,5 - Sabarkantha (Gujarat),6,5
1.0,AMIT SHAH,Bharatiya Janata Party,999984,10988,1010972,76.48,6 - Gandhinagar (Gujarat),6,6
2.0,SONAL RAMANBHAI PATEL,Indian National Congress,261411,4845,266256,20.14,6 - Gandhinagar (Gujarat),6,6
3.0,MOHAMMEDANISH DESAI,Bahujan Samaj Party,7272,122,7394,0.56,6 - Gandhinagar (Gujarat),6,6
4.0,SHAHNAWAZKHAN SULTANKHAN PATHAN,Independent,2325,7,2332,0.18,6 - Gandhinagar (Gujarat),6,6
5.0,MALEK MAKBUL SHAKIB,Independent,2052,6,2058,0.16,6 - Gandhinagar (Gujarat),6,6
6.0,THAKOR JITENDRASINH JASHAVANTSINH,Insaniyat Party,1949,60,2009,0.15,6 - Gandhinagar (Gujarat),6,6
7.0,PARIKH RAJIVBHAI KALABHAI,Independent,1719,32,1751,0.13,6 - Gandhinagar (Gujarat),6,6
8.0,MANSURI SUHANA,Independent,1437,16,1453,0.11,6 - Gandhinagar (Gujarat),6,6
9.0,MAURYA SUMITRA DEVNARIAN,Prajatantra Aadhar Party,1205,12,1217,0.09,6 - Gandhinagar (Gujarat),6,6
10.0,UMADIYA ALIBHAI RAJABHAI,Independent,1004,5,1009,0.08,6 - Gandhinagar (Gujarat),6,6
11.0,RAHUL CHIMANBHAI MEHTA,Right to Recall Party,982,19,1001,0.08,6 - Gandhinagar (Gujarat),6,6
12.0,PATHAN IMTIYAJKHAN,Independent,786,56,842,0.06,6 - Gandhinagar (Gujarat),6,6
13.0,BAGVAN BAHADURSHAH GULMOHAMMAD,Independent,755,16,771,0.06,6 - Gandhinagar (Gujarat),6,6
14.0,NAVSADALAM IBRAHIMBHAI MALEK,Independent,726,6,732,0.06,6 - Gandhinagar (Gujarat),6,6
15.0,NOTA,None of the Above,21233,772,22005,1.66,6 - Gandhinagar (Gujarat),6,6
,Total,,1304840,16962,1321802,,6 - Gandhinagar (Gujarat),6,6
1.0,HASMUKHBHAI PATEL (H.S.PATEL),Bharatiya Janata Party,763028,7431,770459,68.28,7 - Ahmedabad East (Gujarat),6,7
2.0,HIMMATSINH PRAHLADSINH PATEL,Indian National Congress,303713,4991,308704,27.36,7 - Ahmedabad East (Gujarat),6,7
3.0,MAKWANA JAYANTIBHAI KANJIBHAI,Bahujan Samaj Party,10235,247,10482,0.93,7 - Ahmedabad East (Gujarat),6,7
4.0,BRIJESH SHARMA,Independent,4514,12,4526,0.4,7 - Ahmedabad East (Gujarat),6,7
5.0,HARSHAD BABUBHAI NANDOLIYA,Independent,3554,17,3571,0.32,7 - Ahmedabad East (Gujarat),6,7
6.0,MAHESHKUMAR SOMABHAI THAKOR,Independent,3005,28,3033,0.27,7 - Ahmedabad East (Gujarat),6,7
7.0,KALPESHBHAI SHETE,Gunj Satya Ni Janata Party,2927,10,2937,0.26,7 - Ahmedabad East (Gujarat),6,7
8.0,PATANI VISHNUBHAI NATAVARBHAI,Independent,2377,43,2420,0.21,7 - Ahmedabad East (Gujarat),6,7
9.0,ZALA SANJAYKUMAR MAHOBATSINH,Independent,2310,56,2366,0.21,7 - Ahmedabad East (Gujarat),6,7
10.0,DASHARATHBHAI KANTILAL PANCHAL,Independent,1474,6,1480,0.13,7 - Ahmedabad East (Gujarat),6,7
11.0,PRAMOD SAHDEVBHAI GUDADE,Swatantrata Abhivyakti Party,1275,4,1279,0.11,7 - Ahmedabad East (Gujarat),6,7
12.0,RAJESH HARIRAM MAURYA,Prajatantra Aadhar Party,1199,13,1212,0.11,7 - Ahmedabad East (Gujarat),6,7
13.0,INGOLE ROOPESHBHAI BABUBHAI,Independent,1153,16,1169,0.1,7 - Ahmedabad East (Gujarat),6,7
14.0,DHANANJAY GIRJASHANKAR RAJPUT,Bhartiya Jan Parishad,1083,37,1120,0.1,7 - Ahmedabad East (Gujarat),6,7
15.0,MANISH KUMAR DUBEY,Swaraj Kranti Party,898,11,909,0.08,7 - Ahmedabad East (Gujarat),6,7
16.0,CHAUHAN MOHAMADFARUK AHEMADHASANBHAI,Independent,771,7,778,0.07,7 - Ahmedabad East (Gujarat),6,7
17.0,HITENDRABHAI PATEL,Aadi Bharat Party,722,20,742,0.07,7 - Ahmedabad East (Gujarat),6,7
18.0,PIYUSHBHAI BHAVSAR,Youth India Peace Party,642,7,649,0.06,7 - Ahmedabad East (Gujarat),6,7
19.0,NOTA,None of the Above,9911,592,10503,0.93,7 - Ahmedabad East (Gujarat),6,7
,Total,,1114791,13548,1128339,,7 - Ahmedabad East (Gujarat),6,7
1.0,DINESHBHAI MAKWANA (ADVOCATE),Bharatiya Janata Party,606545,5159,611704,63.28,8 - Ahmedabad West (Gujarat),6,8
2.0,BHARAT YOGENDRA MAKWANA,Indian National Congress,321972,3295,325267,33.65,8 - Ahmedabad West (Gujarat),6,8
3.0,ANILKUMAR VASANTBHAI VAGHELA,Bahujan Samaj Party,9448,152,9600,0.99,8 - Ahmedabad West (Gujarat),6,8
4.0,BHITORA BHAVESHKUMAR CHIMANLAL,Gujarat Loktantra Party,2443,15,2458,0.25,8 - Ahmedabad West (Gujarat),6,8
5.0,SHANKARBHAI KHUSHALBHAI RATHOD,Democratic Bharatiya Samaj Party,2345,44,2389,0.25,8 - Ahmedabad West (Gujarat),6,8
6.0,VEDUBHAI KAUTIKBHAI SIRASAT,Jan Sewa Driver Party,1214,7,1221,0.13,8 - Ahmedabad West (Gujarat),6,8
7.0,NOTA,None of the Above,13604,403,14007,1.45,8 - Ahmedabad West (Gujarat),6,8
,Total,,957571,9075,966646,,8 - Ahmedabad West (Gujarat),6,8
1.0,CHANDUBHAI CHHAGANBHAI SHIHORA,Bharatiya Janata Party,664093,5656,669749,59.2,9 - Surendranagar (Gujarat),6,9
2.0,RUTVIKBHAI LAVJIBHAI MAKWANA,Indian National Congress,403461,4671,408132,36.07,9 - Surendranagar (Gujarat),6,9
3.0,DABHI ASHOKBHAI SUKHABHAI,Bahujan Samaj Party,11885,151,12036,1.06,9 - Surendranagar (Gujarat),6,9
4.0,VINODBHAI BABUBHAI SATROTIYA,Independent,5940,6,5946,0.53,9 - Surendranagar (Gujarat),6,9
5.0,KOLI RAMESHBHAI VIRSANGBHAI VAGHELA,Independent,5173,16,5189,0.46,9 - Surendranagar (Gujarat),6,9
6.0,CHAVDA NILESHBHAI MANSUKHBHAI,Rashtra Nirman Party,4103,26,4129,0.36,9 - Surendranagar (Gujarat),6,9
7.0,ZALA DEVRAJBHAI BABUBHAI,Independent,2442,21,2463,0.22,9 - Surendranagar (Gujarat),6,9
8.0,J.K.PATEL,Independent,2308,59,2367,0.21,9 - Surendranagar (Gujarat),6,9
9.0,DEVENDRA MOHANDAS MAHANT,Gunj Satya Ni Janata Party,2042,9,2051,0.18,9 - Surendranagar (Gujarat),6,9
10.0,GEDIYA KRUSHANAVADAN HARIPRASADBHAI,Independent,1435,24,1459,0.13,9 - Surendranagar (Gujarat),6,9
11.0,ANANDBHAI PACHANBHAI RATHOD,Independent,1241,8,1249,0.11,9 - Surendranagar (Gujarat),6,9
12.0,DILIPBHAI PARSHOTTAMBHAI MAKWANA,New India United Party,1222,35,1257,0.11,9 - Surendranagar (Gujarat),6,9
13.0,ASHOK PALAJIBHAI RATHOD,Independent,1087,4,1091,0.1,9 - Surendranagar (Gujarat),6,9
14.0,PATEL MADHUSUDAN BALDEVBHAI,Mission All India Independent Justice Party,948,12,960,0.08,9 - Surendranagar (Gujarat),6,9
15.0,NOTA,None of the Above,12799,500,13299,1.18,9 - Surendranagar (Gujarat),6,9
,Total,,1120179,11198,1131377,,9 - Surendranagar (Gujarat),6,9
1.0,PARSHOTTAMBHAI RUPALA,Bharatiya Janata Party,850846,7138,857984,67.37,10 - Rajkot (Gujarat),6,10
2.0,DHANANI PARESH,Indian National Congress,368964,4760,373724,29.35,10 - Rajkot (Gujarat),6,10
3.0,CHAMANBHAI NAGJIBHAI SAVSANI,Bahujan Samaj Party,10356,109,10465,0.82,10 - Rajkot (Gujarat),6,10
4.0,AJAGIYA NIRALBHAI AMRUTLAL,Independent,3674,6,3680,0.29,10 - Rajkot (Gujarat),6,10
5.0,BHAVESHBHAI KANTILAL PIPALIYA,Independent,2846,10,2856,0.22,10 - Rajkot (Gujarat),6,10
6.0,BHAVESH UPENDRABHAI ACHARYA,Independent,2806,34,2840,0.22,10 - Rajkot (Gujarat),6,10
7.0,PRAKASH GOVINDBHAI SINDHAV,Independent,2355,34,2389,0.19,10 - Rajkot (Gujarat),6,10
8.0,ZALA NAYAN J.,Independent,2321,29,2350,0.18,10 - Rajkot (Gujarat),6,10
9.0,JIGNESHBHAI MAHAJAN,Independent,1322,10,1332,0.1,10 - Rajkot (Gujarat),6,10
10.0,NOTA,None of the Above,15288,634,15922,1.25,10 - Rajkot (Gujarat),6,10
,Total,,1260778,12764,1273542,,10 - Rajkot (Gujarat),6,10
1.0,DR. MANSUKH MANDAVIYA,Bharatiya Janata Party,625962,7156,633118,68.15,11 - Porbandar (Gujarat),6,11
2.0,LALIT VASOYA,Indian National Congress,245677,4081,249758,26.89,11 - Porbandar (Gujarat),6,11
3.0,N. P. RATHOD,Bahujan Samaj Party,10560,362,10922,1.18,11 - Porbandar (Gujarat),6,11
4.0,NATHABHAI BHURABHAI ODEDRA,Independent,7164,132,7296,0.79,11 - Porbandar (Gujarat),6,11
5.0,LAKHANSI ODEDARA,Viro Ke Vir Indian Party,3130,33,3163,0.34,11 - Porbandar (Gujarat),6,11
6.0,SOLANKI JATIN DHIRUBHAI,Independent,2469,17,2486,0.27,11 - Porbandar (Gujarat),6,11
7.0,SODHA HUSHENBHAI ALIBHAI,Independent,2432,3,2435,0.26,11 - Porbandar (Gujarat),6,11
8.0,RATHOD CHANDUBHAI MOHANBHAI,Independent,1705,24,1729,0.19,11 - Porbandar (Gujarat),6,11
9.0,SHEKHAVA NILESHKUMAR RAMJIBHAI,Samajwadi Party,1587,22,1609,0.17,11 - Porbandar (Gujarat),6,11
10.0,SIDHHAPARA HARSUKHLAL JIVANBHAI,Log Party,1059,13,1072,0.12,11 - Porbandar (Gujarat),6,11
11.0,MAHEMUDBHAI SAIYAD,Independent,1023,6,1029,0.11,11 - Porbandar (Gujarat),6,11
12.0,JETHAVA BIPINKUMAR BHIKHALAL,Independent,786,11,797,0.09,11 - Porbandar (Gujarat),6,11
13.0,NOTA,None of the Above,13004,559,13563,1.46,11 - Porbandar (Gujarat),6,11
,Total,,916558,12419,928977,,11 - Porbandar (Gujarat),6,11
1.0,POONAMBEN HEMATBHAI MAADAM,Bharatiya Janata Party,618120,1929,620049,58.98,12 - Jamnagar (Gujarat),6,12
2.0,ADVOCATE J. P. MARAVIYA,Indian National Congress,380949,1092,382041,36.34,12 - Jamnagar (Gujarat),6,12
3.0,JAYSUKH NATHUBHAI PINGALSUR,Bahujan Samaj Party,11429,33,11462,1.09,12 - Jamnagar (Gujarat),6,12
4.0,KANZARIYA RANCHHODBHAI NARANBHAI,Viro Ke Vir Indian Party,6973,29,7002,0.67,12 - Jamnagar (Gujarat),6,12
5.0,VIJAYSINH PRAVINSINH JADEJA,Independent,4817,17,4834,0.46,12 - Jamnagar (Gujarat),6,12
6.0,RATHOD PUNJABHAI PALABHAI,Independent,3727,5,3732,0.36,12 - Jamnagar (Gujarat),6,12
7.0,BHURALAL MEGHJIBHAI PARMAR,Independent,1923,5,1928,0.18,12 - Jamnagar (Gujarat),6,12
8.0,GHUGHA ALARAKHABHAI ISHAKBHAI,Independent,1582,3,1585,0.15,12 - Jamnagar (Gujarat),6,12
9.0,KHIRA YUSUF SIDIKBHAI,Independent,1368,3,1371,0.13,12 - Jamnagar (Gujarat),6,12
10.0,NANJI AMARSHI BATHWAR,Independent,1365,5,1370,0.13,12 - Jamnagar (Gujarat),6,12
11.0,ANWAR NOORMAMAD SANGHAR,Independent,1299,-,1299,0.12,12 - Jamnagar (Gujarat),6,12
12.0,PARESHBHAI PARSOTTAMBHAI MUNGARA,Rashtriya Mahaswaraj Bhumi Party,1266,4,1270,0.12,12 - Jamnagar (Gujarat),6,12
13.0,POPATPUTRA RAFIK ABUBAKAR,Independent,1133,5,1138,0.11,12 - Jamnagar (Gujarat),6,12
14.0,NADEEM MAHAMMAD HALA,Independent,1069,1,1070,0.1,12 - Jamnagar (Gujarat),6,12
15.0,NOTA,None of the Above,10972,112,11084,1.05,12 - Jamnagar (Gujarat),6,12
,Total,,1047992,3243,1051235,,12 - Jamnagar (Gujarat),6,12
1.0,CHUDASAMA RAJESHBHAI NARANBHAI,Bharatiya Janata Party,578516,5533,584049,54.67,13 - Junagadh (Gujarat),6,13
2.0,JOTVA HIRABHAI ARJANBHAI,Indian National Congress,444156,4399,448555,41.99,13 - Junagadh (Gujarat),6,13
3.0,MAKADIA JAYANTILAL MALDEBHAI,Bahujan Samaj Party,7132,150,7282,0.68,13 - Junagadh (Gujarat),6,13
4.0,VADHER DANSING CHINABHAI,Independent,5161,28,5189,0.49,13 - Junagadh (Gujarat),6,13
5.0,DEVENDRABHAI DHANJIBHAI MOTIVARAS,Independent,2302,7,2309,0.22,13 - Junagadh (Gujarat),6,13
6.0,BORICHANGAR BHAVESH DALPATRAI,Independent,1884,24,1908,0.18,13 - Junagadh (Gujarat),6,13
7.0,DAKI NATHABHAI MENSIBHAI,Independent,1329,15,1344,0.13,13 - Junagadh (Gujarat),6,13
8.0,ISHWAR RAMBHAI SOLANKI,Right to Recall Party,1150,21,1171,0.11,13 - Junagadh (Gujarat),6,13
9.0,ALPESHKUMAR CHANDULAL TRAMBADIYA,Log Party,943,21,964,0.09,13 - Junagadh (Gujarat),6,13
10.0,GORDHANBHAI MANGABHAI GOHEL,Independent,758,17,775,0.07,13 - Junagadh (Gujarat),6,13
11.0,AARAB HASAM SUMRA,Independent,689,5,694,0.06,13 - Junagadh (Gujarat),6,13
12.0,NOTA,None of the Above,13434,579,14013,1.31,13 - Junagadh (Gujarat),6,13
,Total,,1057454,10799,1068253,,13 - Junagadh (Gujarat),6,13
1.0,BHARATBHAI MANUBHAI SUTARIYA,Bharatiya Janata Party,577820,3052,580872,66.28,14 - Amreli (Gujarat),6,14
2.0,JENNY THUMMAR,Indian National Congress,258231,1573,259804,29.64,14 - Amreli (Gujarat),6,14
3.0,CHAUHAN RAVAJIBHAI MULABHAI,Bahujan Samaj Party,7486,57,7543,0.86,14 - Amreli (Gujarat),6,14
4.0,SANKHAT VIKRAMBHAI VISABHAI,Global Republican Party,4958,51,5009,0.57,14 - Amreli (Gujarat),6,14
5.0,BAVKUBHAI AMARUBHAI VALA,Independent,3733,44,3777,0.43,14 - Amreli (Gujarat),6,14
6.0,BHAVESHBHAI JENTIBHAI RANK,Independent,3663,8,3671,0.42,14 - Amreli (Gujarat),6,14
7.0,PUNJABHAI BAVBHAI DAFDA,Independent,2598,23,2621,0.3,14 - Amreli (Gujarat),6,14
8.0,PRITESH CHAUHAN (LALU),Independent,1759,21,1780,0.2,14 - Amreli (Gujarat),6,14
9.0,NOTA,None of the Above,11125,224,11349,1.29,14 - Amreli (Gujarat),6,14
,Total,,871373,5053,876426,,14 - Amreli (Gujarat),6,14
1.0,NIMUBEN JAYANTIBHAI BAMBHANIYA (NIMUBEN BAMBHANIYA),Bharatiya Janata Party,707428,9455,716883,68.46,15 - Bhavnagar (Gujarat),6,15
2.0,UMESHBHAI NARANBHAI MAKWANA,Aam Aadmi Party,256902,4692,261594,24.98,15 - Bhavnagar (Gujarat),6,15
3.0,RATHOD DINESHBHAI LAKHABHAI,Bahujan Samaj Party,9989,141,10130,0.97,15 - Bhavnagar (Gujarat),6,15
4.0,ANILBHAI NARENDRABHAI CHAVDA,Swatantrata Abhivyakti Party,7574,45,7619,0.73,15 - Bhavnagar (Gujarat),6,15
5.0,PARMAR RAJESHKUMAR PREMJIBHAI,New India United Party,6456,37,6493,0.62,15 - Bhavnagar (Gujarat),6,15
6.0,KALANIYA SAGARBHAI POPATBHAI,Aapki Awaaz Party,6039,48,6087,0.58,15 - Bhavnagar (Gujarat),6,15
7.0,SANJAYBHAI MAGANBHAI MAKAWANA,Independent,4131,22,4153,0.4,15 - Bhavnagar (Gujarat),6,15
8.0,HARSH GOKLANI,Independent,3593,41,3634,0.35,15 - Bhavnagar (Gujarat),6,15
9.0,SHRI MULSHANKARBHAI RAGHURAMBHAI CHAUHAN,Independent,3386,20,3406,0.33,15 - Bhavnagar (Gujarat),6,15
10.0,SHRI TIDABHAI DEVSHIBHAI,Gujarat Sarva Samaj Party,2641,44,2685,0.26,15 - Bhavnagar (Gujarat),6,15
11.0,BHUPATBHAI MOHANBHAI VALA,Right to Recall Party,2370,24,2394,0.23,15 - Bhavnagar (Gujarat),6,15
12.0,NARESHBHAI NARANBHAI RATHOD,Independent,1745,20,1765,0.17,15 - Bhavnagar (Gujarat),6,15
13.0,BRAHMAKSHTRIYA BHAGVATIBEN KHETSINH,Independent,1562,62,1624,0.16,15 - Bhavnagar (Gujarat),6,15
14.0,NOTA,None of the Above,17717,1048,18765,1.79,15 - Bhavnagar (Gujarat),6,15
,Total,,1031533,15699,1047232,,15 - Bhavnagar (Gujarat),6,15
1.0,MITESH PATEL (BAKABHAI),Bharatiya Janata Party,607394,5090,612484,52.44,16 - Anand (Gujarat),6,16
2.0,AMIT CHAVDA,Indian National Congress,516453,6092,522545,44.74,16 - Anand (Gujarat),6,16
3.0,SURESHBHAI DHULABHAI PATEL,Bahujan Samaj Party,5778,53,5831,0.5,16 - Anand (Gujarat),6,16
4.0,BHOI ASHISHKUMAR THAKORBHAI,Independent,5525,17,5542,0.47,16 - Anand (Gujarat),6,16
5.0,KEYURBHAI PRAVINBHAI PATEL (BAKABHAI),Independent,2290,8,2298,0.2,16 - Anand (Gujarat),6,16
6.0,DHEERAJKUMAR KSHATRIYA,Garib Kalyan Party,1723,24,1747,0.15,16 - Anand (Gujarat),6,16
7.0,BHATT SUNILKUMAR NARENDRABHAI,Right to Recall Party,1584,8,1592,0.14,16 - Anand (Gujarat),6,16
8.0,NOTA,None of the Above,15679,251,15930,1.36,16 - Anand (Gujarat),6,16
,Total,,1156426,11543,1167969,,16 - Anand (Gujarat),6,16
1.0,DEVUSINH CHAUHAN,Bharatiya Janata Party,738609,5826,744435,63.31,17 - Kheda (Gujarat),6,17
2.0,KALUSINH DABHI,Indian National Congress,381656,5021,386677,32.88,17 - Kheda (Gujarat),6,17
3.0,SODHA SANJAYKUMAR PARVATSINH,Independent,6123,16,6139,0.52,17 - Kheda (Gujarat),6,17
4.0,BHAILALBHAI KALUBHAI PANDAV,Bahujan Samaj Party,6055,97,6152,0.52,17 - Kheda (Gujarat),6,17
5.0,PARMAR HITESHKUMAR PARSOTTAMBHAI,Independent,2730,11,2741,0.23,17 - Kheda (Gujarat),6,17
6.0,UPENDRAKUMAR VALLAVBHAI PATEL,Independent,2703,12,2715,0.23,17 - Kheda (Gujarat),6,17
7.0,PATEL ANILKUMAR BHAILALBHAI,Rashtriya Mahaswaraj Bhumi Party,2493,30,2523,0.21,17 - Kheda (Gujarat),6,17
8.0,SAIYAD KADARI MOHAMMAD SABIR ANVAR HUSAIN,Bhartiya Jan Nayak Party,1812,26,1838,0.16,17 - Kheda (Gujarat),6,17
9.0,INDIRADEVI HIRALAL VORA,Garib Kalyan Party,1126,9,1135,0.1,17 - Kheda (Gujarat),6,17
10.0,KAMLESHBHAI POPATBHAI PATEL,Bhartiya Jan Parishad,933,16,949,0.08,17 - Kheda (Gujarat),6,17
11.0,IMRANBHAI VANKAWALA,Right to Recall Party,924,4,928,0.08,17 - Kheda (Gujarat),6,17
12.0,KANTIYA DASRATH HARJIVANBHAI,New India United Party,789,3,792,0.07,17 - Kheda (Gujarat),6,17
13.0,NOTA,None of the Above,18444,380,18824,1.6,17 - Kheda (Gujarat),6,17
,Total,,1164397,11451,1175848,,17 - Kheda (Gujarat),6,17
1.0,RAJPALSINH MAHENDRASINH JADAV,Bharatiya Janata Party,785830,8749,794579,70.22,18 - Panchmahal (Gujarat),6,18
2.0,GULABSINH SOMSINH CHAUHAN,Indian National Congress,279396,5841,285237,25.21,18 - Panchmahal (Gujarat),6,18
3.0,HASMUKHKUMAR GANPATSINH RATHOD,Independent,10376,23,10399,0.92,18 - Panchmahal (Gujarat),6,18
4.0,JITESHKUMAR GHANSHYAMBHAI SEVAK,Dhanwan Bharat Party,8350,39,8389,0.74,18 - Panchmahal (Gujarat),6,18
5.0,MANOJSINH RANAJITSINH RATHOD,Independent,3984,29,4013,0.35,18 - Panchmahal (Gujarat),6,18
6.0,LAXMANBHAI GALABHAI BARIYA,"Aam Janmat Party,",3108,97,3205,0.28,18 - Panchmahal (Gujarat),6,18
7.0,TASLIM MOHAMMEDRAFIK DURVESH,Independent,3051,14,3065,0.27,18 - Panchmahal (Gujarat),6,18
8.0,PANDOR KAUSHIKKUMAR SHANKARBHAI,Independent,2486,21,2507,0.22,18 - Panchmahal (Gujarat),6,18
9.0,NOTA,None of the Above,19629,474,20103,1.78,18 - Panchmahal (Gujarat),6,18
,Total,,1116210,15287,1131497,,18 - Panchmahal (Gujarat),6,18
1.0,JASWANTSINH SUMANBHAI BHABHOR,Bharatiya Janata Party,685734,2981,688715,61.59,19 - Dahod (Gujarat),6,19
2.0,DR. PRABHABEN KISHORSINH TAVIYAD,Indian National Congress,352238,2800,355038,31.75,19 - Dahod (Gujarat),6,19
3.0,MEDA DEVENDRAKUMAR LAXMANBHAI,Independent,11068,7,11075,0.99,19 - Dahod (Gujarat),6,19
4.0,BHABHOR DHULABHAI DITABHAI,Bahujan Samaj Party,8621,11,8632,0.77,19 - Dahod (Gujarat),6,19
5.0,BARIYA MANILAL HIRABHAI,Independent,6576,12,6588,0.59,19 - Dahod (Gujarat),6,19
6.0,DAMOR VESTABHAI JOKHANABHAI,Independent,4374,26,4400,0.39,19 - Dahod (Gujarat),6,19
7.0,DAMOR MANABHAI BHAVSINGBHAI,Independent,3144,29,3173,0.28,19 - Dahod (Gujarat),6,19
8.0,JAGDISHBHAI MANILAL MEDA,Bharatiya National Janata Dal,3053,9,3062,0.27,19 - Dahod (Gujarat),6,19
9.0,PASAYA NAVALSINH MULABHAI,Saath Sahakar Vikas Party,2667,6,2673,0.24,19 - Dahod (Gujarat),6,19
10.0,NOTA,None of the Above,34774,164,34938,3.12,19 - Dahod (Gujarat),6,19
,Total,,1112249,6045,1118294,,19 - Dahod (Gujarat),6,19
1.0,DR. HEMANG JOSHI,Bharatiya Janata Party,865825,7364,873189,72.04,20 - Vadodara (Gujarat),6,20
2.0,PADHIYAR JASHPALSINH MAHENDRASINH (BAPU),Indian National Congress,287570,3493,291063,24.01,20 - Vadodara (Gujarat),6,20
3.0,JADAV AMITKUMAR RAMJIBHAI,Bahujan Samaj Party,7473,56,7529,0.62,20 - Vadodara (Gujarat),6,20
4.0,RAJESH RATHOD,Independent,5416,53,5469,0.45,20 - Vadodara (Gujarat),6,20
5.0,ANILBHAI SHARMA,Hindrashtra Sangh,3436,17,3453,0.28,20 - Vadodara (Gujarat),6,20
6.0,DR. RAHUL VASUDEVBHAI VYAS,Independent,2731,21,2752,0.23,20 - Vadodara (Gujarat),6,20
7.0,PARMAR MAYURSINH ARVINDSINH,Independent,2122,86,2208,0.18,20 - Vadodara (Gujarat),6,20
8.0,NILKANTHKUMAR MANSUKHLAL MISTRI,Independent,1748,8,1756,0.14,20 - Vadodara (Gujarat),6,20
9.0,PARMAR HEMANTKUMAR ARVINDBHAI,Independent,1388,23,1411,0.12,20 - Vadodara (Gujarat),6,20
10.0,TAPAN DASGUPTA,Socialist Unity Centre Of India (COMMUNIST),1252,23,1275,0.11,20 - Vadodara (Gujarat),6,20
11.0,ATUL GAMECHI,Independent,1061,23,1084,0.09,20 - Vadodara (Gujarat),6,20
12.0,PARTHIV VIJAYKUMAR DAVE,Right to Recall Party,1052,5,1057,0.09,20 - Vadodara (Gujarat),6,20
13.0,NILESH JAGANNATH VASAIKAR,Independent,840,18,858,0.07,20 - Vadodara (Gujarat),6,20
14.0,DOSHI HARDIK BIPINBHAI,Satyawadi Rakshak Party,643,14,657,0.05,20 - Vadodara (Gujarat),6,20
15.0,NOTA,None of the Above,17823,565,18388,1.52,20 - Vadodara (Gujarat),6,20
,Total,,1200380,11769,1212149,,20 - Vadodara (Gujarat),6,20
1.0,JASHUBHAI BHILUBHAI RATHVA,Bharatiya Janata Party,791727,4862,796589,62.84,21 - Chhota Udaipur (Gujarat),6,21
2.0,SUKHRAMBHAI HARIYABHAI RATHWA,Indian National Congress,394433,3379,397812,31.38,21 - Chhota Udaipur (Gujarat),6,21
3.0,BHIL SOMABHAI GOKALBHAI,Bahujan Samaj Party,16021,72,16093,1.27,21 - Chhota Udaipur (Gujarat),6,21
4.0,RATHVA FURAKANBHAI BALJIBHAI,Malwa Congress,11091,70,11161,0.88,21 - Chhota Udaipur (Gujarat),6,21
5.0,TADVI RANCHHODBHAI,Bharatiya Bahujan Congress,8292,52,8344,0.66,21 - Chhota Udaipur (Gujarat),6,21
6.0,RATHVA MUKESHBHAI NURABHAI,Independent,8032,33,8065,0.64,21 - Chhota Udaipur (Gujarat),6,21
7.0,NOTA,None of the Above,29394,261,29655,2.34,21 - Chhota Udaipur (Gujarat),6,21
,Total,,1258990,8729,1267719,,21 - Chhota Udaipur (Gujarat),6,21
1.0,MANSUKHBHAI DHANJIBHAI VASAVA,Bharatiya Janata Party,605489,2668,608157,50.72,22 - Bharuch (Gujarat),6,22
2.0,CHAITARBHAI DAMJIBHAI VASAVA,Aam Aadmi Party,518419,4042,522461,43.58,22 - Bharuch (Gujarat),6,22
3.0,DILIPBHAI CHHOTUBHAI VASAVA,Bharat Adivasi Party,9981,33,10014,0.84,22 - Bharuch (Gujarat),6,22
4.0,SAJID YAKUB MUNSHI,Independent,9934,3,9937,0.83,22 - Bharuch (Gujarat),6,22
5.0,VASAVA CHETANBHAI KANJIBHAI,Bahujan Samaj Party,6312,12,6324,0.53,22 - Bharuch (Gujarat),6,22
6.0,NAVINBHAI BHIKHABHAI PATEL,Independent,3440,13,3453,0.29,22 - Bharuch (Gujarat),6,22
7.0,YUSUF VALI HASANALI,Independent,3245,2,3247,0.27,22 - Bharuch (Gujarat),6,22
8.0,GITABEN MANUBHAI MACHHI,Malwa Congress,2750,14,2764,0.23,22 - Bharuch (Gujarat),6,22
9.0,MITESHBHAI THAKORBHAI PADHIYAR,Independent,2451,8,2459,0.21,22 - Bharuch (Gujarat),6,22
10.0,MIRZA AABIDBEG YASINBEG,Independent,2043,7,2050,0.17,22 - Bharuch (Gujarat),6,22
11.0,ISMAIL AHMAD PATEL,Independent,1887,15,1902,0.16,22 - Bharuch (Gujarat),6,22
12.0,NARAYANBHAI LILADHARJI RAVAL,Independent,1574,9,1583,0.13,22 - Bharuch (Gujarat),6,22
13.0,DHARMESHKUMAR VISHNUBHAI VASAVA,Independent,1324,6,1330,0.11,22 - Bharuch (Gujarat),6,22
14.0,NOTA,None of the Above,23151,132,23283,1.94,22 - Bharuch (Gujarat),6,22
,Total,,1192000,6964,1198964,,22 - Bharuch (Gujarat),6,22
1.0,PARBHUBHAI NAGARBHAI VASAVA,Bharatiya Janata Party,757787,6163,763950,57.04,23 - Bardoli (Gujarat),6,23
2.0,CHAUDHARY SIDDHARTH AMARSINH,Indian National Congress,526054,7643,533697,39.85,23 - Bardoli (Gujarat),6,23
3.0,REKHABEN HARSINGBHAI CHAUDHARI,Bahujan Samaj Party,15872,272,16144,1.21,23 - Bardoli (Gujarat),6,23
4.0,NOTA,None of the Above,24762,780,25542,1.91,23 - Bardoli (Gujarat),6,23
,Total,,1324475,14858,1339333,,23 - Bardoli (Gujarat),6,23
1.0,MUKESHKUMAR CHANDRAKAANT DALAL ( Uncontested ),Bharatiya Janata Party,-,-,-,-,24 - Surat (Gujarat),6,24
,Total,,-,-,-,,24 - Surat (Gujarat),6,24
1.0,C R PATIL,Bharatiya Janata Party,1023366,7699,1031065,77.05,25 - Navsari (Gujarat),6,25
2.0,NAISHADHBHAI BHUPATBHAI DESAI,Indian National Congress,254567,2947,257514,19.24,25 - Navsari (Gujarat),6,25
3.0,MALKHAN RAMKISHOR VARMA,Bahujan Samaj Party,8076,57,8133,0.61,25 - Navsari (Gujarat),6,25
4.0,KIRIT L. SURATI,Independent,4190,21,4211,0.31,25 - Navsari (Gujarat),6,25
5.0,RAJU VARDE,Independent,3139,45,3184,0.24,25 - Navsari (Gujarat),6,25
6.0,RAMZAN MANSURI (SENIOR JOURNALIST),Log Party,2652,1,2653,0.2,25 - Navsari (Gujarat),6,25
7.0,KADIR MAHEBOOB SAIYED,Social Democratic Party Of India,2527,11,2538,0.19,25 - Navsari (Gujarat),6,25
8.0,SHEKH MOHMMAD NISHAR (MUNNABHAI GARAGE),Independent,1481,2,1483,0.11,25 - Navsari (Gujarat),6,25
9.0,DR. KANUBHAI KHADADIYA,Socialist Unity Centre Of India (COMMUNIST),1470,15,1485,0.11,25 - Navsari (Gujarat),6,25
10.0,SUMANBEN KHUSHWA (HANSIKA RAJPUT),Sardar Vallabhbhai Patel Party,1397,29,1426,0.11,25 - Navsari (Gujarat),6,25
11.0,ADVOCATE NAVINKUMAR SHANKERBHAI PATEL,Independent,1091,4,1095,0.08,25 - Navsari (Gujarat),6,25
12.0,MOHAMMAD HANIF SHAH,Garib Kalyan Party,1089,8,1097,0.08,25 - Navsari (Gujarat),6,25
13.0,CHANDANSINGH SHIVBADANSINGH THAKUR,Independent,1070,17,1087,0.08,25 - Navsari (Gujarat),6,25
14.0,KAZI AYAZ HUSNUDDIN,Independent,775,8,783,0.06,25 - Navsari (Gujarat),6,25
15.0,NOTA,None of the Above,19653,809,20462,1.53,25 - Navsari (Gujarat),6,25
,Total,,1326543,11673,1338216,,25 - Navsari (Gujarat),6,25
1.0,DHAVAL LAXMANBHAI PATEL,Bharatiya Janata Party,760935,3291,764226,56.13,26 - Valsad (Gujarat),6,26
2.0,ANANTKUMAR HASMUKHBHAI PATEL,Indian National Congress,547307,6215,553522,40.66,26 - Valsad (Gujarat),6,26
3.0,MANAKBHAI JATRUBHAI SHANKAR,Bahujan Samaj Party,7487,12,7499,0.55,26 - Valsad (Gujarat),6,26
4.0,RAMANBHAI KARSHANBHAI PATEL,Independent,6732,13,6745,0.5,26 - Valsad (Gujarat),6,26
5.0,JAYANTIBHAI KHANDUBHAI SHALUA,Viro Ke Vir Indian Party,4763,11,4774,0.35,26 - Valsad (Gujarat),6,26
6.0,CHIRAGKUMAR BHARATBHAI PATEL,Independent,3431,9,3440,0.25,26 - Valsad (Gujarat),6,26
7.0,UMESHBHAI MAGANBHAI PATEL,Bahujan Republican Socialist Party,2813,19,2832,0.21,26 - Valsad (Gujarat),6,26
8.0,NOTA,None of the Above,18169,204,18373,1.35,26 - Valsad (Gujarat),6,26
,Total,,1351637,9774,1361411,,26 - Valsad (Gujarat),6,26
1.0,VARUN CHAUDHRY,Indian National Congress,662592,1065,663657,49.28,1 - AMBALA (Haryana),7,1
2.0,BANTO KATARIA,Bharatiya Janata Party,613786,835,614621,45.64,1 - AMBALA (Haryana),7,1
3.0,PAWAN RANDHAWA,Bahujan Samaj Party,23535,48,23583,1.75,1 - AMBALA (Haryana),7,1
4.0,GURPREET SINGH,Indian National Lok Dal,8902,84,8986,0.67,1 - AMBALA (Haryana),7,1
5.0,KAMAL KUMAR BARARA,Aazad Samaj Party (Kanshi Ram),8741,13,8754,0.65,1 - AMBALA (Haryana),7,1
6.0,KIRAN PUNIA,Jannayak Janta Party,6055,37,6092,0.45,1 - AMBALA (Haryana),7,1
7.0,RAKESH KUMAR,Haryana Jansena Party,3110,1,3111,0.23,1 - AMBALA (Haryana),7,1
8.0,BALJEET SINGH,Bharatheeya Jawan Kisan Party,2459,43,2502,0.19,1 - AMBALA (Haryana),7,1
9.0,MEHAR SINGH CHALIA,Ekam Sanatan Bharat Dal,2383,14,2397,0.18,1 - AMBALA (Haryana),7,1
10.0,GULAB SINGH NARWAL,Peoples Party of India (Democratic),1683,7,1690,0.13,1 - AMBALA (Haryana),7,1
11.0,SURAJ KUMAR,Bahujan Mukti Party,1501,5,1506,0.11,1 - AMBALA (Haryana),7,1
12.0,MOHAR SINGH STATION MASTER (RETD.),Independent,1257,6,1263,0.09,1 - AMBALA (Haryana),7,1
13.0,BETA MAM CHAND RATTUWALA,Bharatiya Yuva Jan Ekta Party,1248,3,1251,0.09,1 - AMBALA (Haryana),7,1
14.0,DR. NITESH CHOPRA (HONEY),Bhartiya Shakti Chetna Party,854,3,857,0.06,1 - AMBALA (Haryana),7,1
15.0,NOTA,None of the Above,6427,25,6452,0.48,1 - AMBALA (Haryana),7,1
,Total,,1344533,2189,1346722,,1 - AMBALA (Haryana),7,1
1.0,NAVEEN JINDAL,Bharatiya Janata Party,540677,1498,542175,44.96,2 - KURUKSHETRA (Haryana),7,2
2.0,DR SUSHIL GUPTA,Aam Aadmi Party,511770,1384,513154,42.55,2 - KURUKSHETRA (Haryana),7,2
3.0,ABHAY SINGH CHAUTALA,Indian National Lok Dal,78362,346,78708,6.53,2 - KURUKSHETRA (Haryana),7,2
4.0,DEEPAK MEHRA,Bahujan Samaj Party,20864,80,20944,1.74,2 - KURUKSHETRA (Haryana),7,2
5.0,JAI KUMAR SAINI HAMIDPUR,Independent,8090,3,8093,0.67,2 - KURUKSHETRA (Haryana),7,2
6.0,PALA RAM SAINI,Jannayak Janta Party,6159,23,6182,0.51,2 - KURUKSHETRA (Haryana),7,2
7.0,SATBIR KASHYAP,Rashtriya Janshakti Party(Eklavya),3251,12,3263,0.27,2 - KURUKSHETRA (Haryana),7,2
8.0,KHAZAN SINGH SEHGAL,Shiromani Akali Dal (Amritsar)(Simranjit Singh Mann),2824,35,2859,0.24,2 - KURUKSHETRA (Haryana),7,2
9.0,MAHAVIR SINGH,Ekam Sanatan Bharat Dal,2779,4,2783,0.23,2 - KURUKSHETRA (Haryana),7,2
10.0,INDERJEET KAMBOJ,Peoples Party of India (Democratic),2107,6,2113,0.18,2 - KURUKSHETRA (Haryana),7,2
11.0,PANDIT ANIL UPADHYAY,Independent,2053,3,2056,0.17,2 - KURUKSHETRA (Haryana),7,2
12.0,ADV ASHWINI SHARMA HRITTWAL,Independent,2027,2,2029,0.17,2 - KURUKSHETRA (Haryana),7,2
13.0,COMRADE OM PARKASH SHASTRI,Socialist Unity Centre Of India (COMMUNIST),1806,6,1812,0.15,2 - KURUKSHETRA (Haryana),7,2
14.0,SURENDER SINGH,Independent,1599,-,1599,0.13,2 - KURUKSHETRA (Haryana),7,2
15.0,AMIT MALIK,Independent,1503,3,1506,0.12,2 - KURUKSHETRA (Haryana),7,2
16.0,PATASHO DEVI EX-SARPANCH,Independent,1379,-,1379,0.11,2 - KURUKSHETRA (Haryana),7,2
17.0,DR MAHESH CHAND GAUR,Independent,1338,2,1340,0.11,2 - KURUKSHETRA (Haryana),7,2
18.0,JAI PARKASH SHARMA,Independent,1152,2,1154,0.1,2 - KURUKSHETRA (Haryana),7,2
19.0,VARUN GUPTA,Independent,1129,5,1134,0.09,2 - KURUKSHETRA (Haryana),7,2
20.0,SATNAM BHAZIGAR,Loktantrik Lok Rajyam Party,1063,3,1066,0.09,2 - KURUKSHETRA (Haryana),7,2
21.0,NARESH KUMAR,Samata Party,1028,4,1032,0.09,2 - KURUKSHETRA (Haryana),7,2
22.0,SATISH DHULL,Bharatiya Asha Party,991,6,997,0.08,2 - KURUKSHETRA (Haryana),7,2
23.0,ADVOCATE PARDEEP SAINI,Rashtriya Garib Dal,958,2,960,0.08,2 - KURUKSHETRA (Haryana),7,2
24.0,SEWA SINGH,Independent,717,1,718,0.06,2 - KURUKSHETRA (Haryana),7,2
25.0,ER VISHAL KUMAR,Independent,715,-,715,0.06,2 - KURUKSHETRA (Haryana),7,2
26.0,COMRADE RAMESH KHATKAR,Independent,714,3,717,0.06,2 - KURUKSHETRA (Haryana),7,2
27.0,OM PARKASH INDAL,Global Republican Party,675,3,678,0.06,2 - KURUKSHETRA (Haryana),7,2
28.0,PHOOL SINGH,Independent,625,1,626,0.05,2 - KURUKSHETRA (Haryana),7,2
29.0,SUNNY KASHYAP TEORA,Independent,576,-,576,0.05,2 - KURUKSHETRA (Haryana),7,2
30.0,RAMDIYA,Independent,553,3,556,0.05,2 - KURUKSHETRA (Haryana),7,2
31.0,MANGAT RAM,Independent,509,-,509,0.04,2 - KURUKSHETRA (Haryana),7,2
32.0,NOTA,None of the Above,2420,19,2439,0.2,2 - KURUKSHETRA (Haryana),7,2
,Total,,1202413,3459,1205872,,2 - KURUKSHETRA (Haryana),7,2
1.0,SELJA,Indian National Congress,732298,1525,733823,54.17,3 - SIRSA (Haryana),7,3
2.0,ASHOK TANWAR,Bharatiya Janata Party,464472,854,465326,34.35,3 - SIRSA (Haryana),7,3
3.0,SANDEEP LOT VALMIKI,Indian National Lok Dal,92279,174,92453,6.82,3 - SIRSA (Haryana),7,3
4.0,RAMESH KHATAK,Jannayak Janta Party,20049,31,20080,1.48,3 - SIRSA (Haryana),7,3
5.0,LILU RAM ASAKHERA,Bahujan Samaj Party,10120,31,10151,0.75,3 - SIRSA (Haryana),7,3
6.0,RAHUL CHOUHAN,Independent,6159,1,6160,0.45,3 - SIRSA (Haryana),7,3
7.0,KARNAIL SINGH ODHAN,Independent,4152,14,4166,0.31,3 - SIRSA (Haryana),7,3
8.0,SATPAL LADWAL,Independent,3413,-,3413,0.25,3 - SIRSA (Haryana),7,3
9.0,MISTRI DAULAT RAM ROLAN,Peoples Party of India (Democratic),3058,3,3061,0.23,3 - SIRSA (Haryana),7,3
10.0,JOGINDER RAM,Independent,2140,2,2142,0.16,3 - SIRSA (Haryana),7,3
11.0,RAN SINGH PANWAR,Independent,1548,2,1550,0.11,3 - SIRSA (Haryana),7,3
12.0,RAJINDER KUMAR,Bharatiya Asha Party,1239,3,1242,0.09,3 - SIRSA (Haryana),7,3
13.0,BAGDAWAT RAM,Independent,1221,3,1224,0.09,3 - SIRSA (Haryana),7,3
14.0,JASVIR SINGH,Independent,1128,8,1136,0.08,3 - SIRSA (Haryana),7,3
15.0,NAVEEN KUMAR COMMANDO,Independent,1113,3,1116,0.08,3 - SIRSA (Haryana),7,3
16.0,SUKHDEV SINGH SANDHU,Independent,993,6,999,0.07,3 - SIRSA (Haryana),7,3
17.0,DR. RAJESH MEHANDIA,Bahujan Republican Socialist Party,931,-,931,0.07,3 - SIRSA (Haryana),7,3
18.0,DHARAMPAL VARTIA,Loktantrik Lok Rajyam Party,916,3,919,0.07,3 - SIRSA (Haryana),7,3
19.0,SURENDER KUMAR PHULAN,Independent,614,3,617,0.05,3 - SIRSA (Haryana),7,3
20.0,NOTA,None of the Above,4106,17,4123,0.3,3 - SIRSA (Haryana),7,3
,Total,,1351949,2683,1354632,,3 - SIRSA (Haryana),7,3
1.0,JAI PARKASH (J P) S/O HARIKESH,Indian National Congress,567194,3230,570424,48.58,4 - HISAR (Haryana),7,4
2.0,RANJIT SINGH,Bharatiya Janata Party,504944,2099,507043,43.19,4 - HISAR (Haryana),7,4
3.0,DESH RAJ,Bahujan Samaj Party,25892,123,26015,2.22,4 - HISAR (Haryana),7,4
4.0,SUNAINA CHAUTALA,Indian National Lok Dal,22171,132,22303,1.9,4 - HISAR (Haryana),7,4
5.0,NAINA SINGH CHAUTALA,Jannayak Janta Party,21910,122,22032,1.88,4 - HISAR (Haryana),7,4
6.0,PARDEEP DAHIYA,Independent,3607,1,3608,0.31,4 - HISAR (Haryana),7,4
7.0,JAI PRAKASH (J.P.) S/O UMA DUTT,Independent,3267,6,3273,0.28,4 - HISAR (Haryana),7,4
8.0,JILE SINGH,Independent,3196,-,3196,0.27,4 - HISAR (Haryana),7,4
9.0,POONAM MOR,Independent,1237,4,1241,0.11,4 - HISAR (Haryana),7,4
10.0,ISHWAR JHAJHRIA,Independent,1121,1,1122,0.1,4 - HISAR (Haryana),7,4
11.0,ATMA RAM BISHNOI,Independent,1091,6,1097,0.09,4 - HISAR (Haryana),7,4
12.0,KULBIR,Independent,1041,-,1041,0.09,4 - HISAR (Haryana),7,4
13.0,CHANDER MOHAN,Independent,995,3,998,0.09,4 - HISAR (Haryana),7,4
14.0,ADVOCATE PARDEEP SIHMAR,Peoples Party of India (Democratic),871,5,876,0.07,4 - HISAR (Haryana),7,4
15.0,AJIT SINGH,Independent,794,2,796,0.07,4 - HISAR (Haryana),7,4
16.0,DEV GIRI,Rashtriya Lokswaraj Party,719,7,726,0.06,4 - HISAR (Haryana),7,4
17.0,DINESH KUMAR,Independent,699,4,703,0.06,4 - HISAR (Haryana),7,4
18.0,MASTER VIJENDER JITPURA,Socialist Unity Centre Of India (COMMUNIST),654,3,657,0.06,4 - HISAR (Haryana),7,4
19.0,RAJENDER KUMAR,Independent,485,1,486,0.04,4 - HISAR (Haryana),7,4
20.0,NEERAJ KUMAR “CHHATTAR”,Bharatiya Asha Party,419,4,423,0.04,4 - HISAR (Haryana),7,4
21.0,MANDEEP,Independent,404,1,405,0.03,4 - HISAR (Haryana),7,4
22.0,JAGAT SINGH,Vikas India Party,374,8,382,0.03,4 - HISAR (Haryana),7,4
23.0,PARJAPATI RAKESH DHUWARIA,Independent,372,2,374,0.03,4 - HISAR (Haryana),7,4
24.0,RANDHIR SINGH,Independent,352,1,353,0.03,4 - HISAR (Haryana),7,4
25.0,SURENDER KUMAR,Independent,326,-,326,0.03,4 - HISAR (Haryana),7,4
26.0,SURENDER,Independent,308,-,308,0.03,4 - HISAR (Haryana),7,4
27.0,VIJAY SINGH,Independent,270,2,272,0.02,4 - HISAR (Haryana),7,4
28.0,YOGESH BOORA,Independent,267,2,269,0.02,4 - HISAR (Haryana),7,4
29.0,NOTA,None of the Above,3333,33,3366,0.29,4 - HISAR (Haryana),7,4
,Total,,1168313,5802,1174115,,4 - HISAR (Haryana),7,4
1.0,MANOHAR LAL,Bharatiya Janata Party,737282,2003,739285,54.93,5 - KARNAL (Haryana),7,5
2.0,DIVYANSHU BUDHIRAJA,Indian National Congress,504437,2271,506708,37.65,5 - KARNAL (Haryana),7,5
3.0,INDER SINGH,Bahujan Samaj Party,32410,98,32508,2.42,5 - KARNAL (Haryana),7,5
4.0,MARATHA VIRENDER VERMA,Nationalist Congress Party – Sharadchandra Pawar,28984,167,29151,2.17,5 - KARNAL (Haryana),7,5
5.0,DEVENDER KADIAN,Jannayak Janta Party,11399,68,11467,0.85,5 - KARNAL (Haryana),7,5
6.0,MANOJ BANSAL,Independent,4000,4,4004,0.3,5 - KARNAL (Haryana),7,5
7.0,GULSHAN KASHYAP,Independent,2987,7,2994,0.22,5 - KARNAL (Haryana),7,5
8.0,ASHOK KATARIA,Samst Samaj Party,2898,6,2904,0.22,5 - KARNAL (Haryana),7,5
9.0,HARJEET SINGH VIRK,Shiromani Akali Dal (Amritsar)(Simranjit Singh Mann),1857,9,1866,0.14,5 - KARNAL (Haryana),7,5
10.0,SONIA,Independent,1846,5,1851,0.14,5 - KARNAL (Haryana),7,5
11.0,MANISH,Independent,1587,-,1587,0.12,5 - KARNAL (Haryana),7,5
12.0,LEENA KOHLI,Independent,1281,11,1292,0.1,5 - KARNAL (Haryana),7,5
13.0,NITIN GEHLOT,Peoples Party of India (Democratic),1252,1,1253,0.09,5 - KARNAL (Haryana),7,5
14.0,BALWAN SINGH,Independent,1186,2,1188,0.09,5 - KARNAL (Haryana),7,5
15.0,VINEET CHOUDHARY,Bharatiya Asha Party,1018,2,1020,0.08,5 - KARNAL (Haryana),7,5
16.0,ROOP SINGH,Rashtriya Garib Dal,766,3,769,0.06,5 - KARNAL (Haryana),7,5
17.0,SAWAMI AGNIVESH,Independent,748,4,752,0.06,5 - KARNAL (Haryana),7,5
18.0,AZAD SINGH PUNIA,Independent,703,2,705,0.05,5 - KARNAL (Haryana),7,5
19.0,ASHOK KUMAR,Independent,631,2,633,0.05,5 - KARNAL (Haryana),7,5
20.0,NOTA,None of the Above,3925,30,3955,0.29,5 - KARNAL (Haryana),7,5
,Total,,1341197,4695,1345892,,5 - KARNAL (Haryana),7,5
1.0,SATPAL BRAHAMCHARI,Indian National Congress,546163,2519,548682,48.82,6 - SONIPAT (Haryana),7,6
2.0,MOHAN LAL BADOLI,Bharatiya Janata Party,525069,1797,526866,46.88,6 - SONIPAT (Haryana),7,6
3.0,UMESH KUMAR,Bahujan Samaj Party,12742,80,12822,1.14,6 - SONIPAT (Haryana),7,6
4.0,ANOOP SINGH,Indian National Lok Dal,11384,139,11523,1.03,6 - SONIPAT (Haryana),7,6
5.0,BHUPENDER SINGH MALIK,Jannayak Janta Party,7716,104,7820,0.7,6 - SONIPAT (Haryana),7,6
6.0,SANT DHARAMVEER CHOTIVALA,Independent,2150,4,2154,0.19,6 - SONIPAT (Haryana),7,6
7.0,RAMESH,Independent,1651,-,1651,0.15,6 - SONIPAT (Haryana),7,6
8.0,NARESH KASHYAP,Aam Aadmi Parivartan Party,1622,36,1658,0.15,6 - SONIPAT (Haryana),7,6
9.0,SATPAL,Independent,1215,2,1217,0.11,6 - SONIPAT (Haryana),7,6
10.0,GAUBHAGAT SUMIT LATHER,Independent,877,5,882,0.08,6 - SONIPAT (Haryana),7,6
11.0,DR. KAMLESH KUMAR SAINI,Independent,863,3,866,0.08,6 - SONIPAT (Haryana),7,6
12.0,ROHTASH,Independent,775,2,777,0.07,6 - SONIPAT (Haryana),7,6
13.0,BALBIR SINGH,Socialist Unity Centre Of India (COMMUNIST),765,3,768,0.07,6 - SONIPAT (Haryana),7,6
14.0,ASHWANI,Independent,694,1,695,0.06,6 - SONIPAT (Haryana),7,6
15.0,SANJAY DASS,Independent,569,3,572,0.05,6 - SONIPAT (Haryana),7,6
16.0,JAGBEER,Independent,521,3,524,0.05,6 - SONIPAT (Haryana),7,6
17.0,SUNIL KUMAR,Rashtriya Garib Dal,456,11,467,0.04,6 - SONIPAT (Haryana),7,6
18.0,RADHEY SHYAM,Peoples Party of India (Democratic),438,3,441,0.04,6 - SONIPAT (Haryana),7,6
19.0,RAKESH,Samata Party,407,3,410,0.04,6 - SONIPAT (Haryana),7,6
20.0,NIRMAL SINGH,Independent,317,1,318,0.03,6 - SONIPAT (Haryana),7,6
21.0,SURENDER SINGH,Independent,295,1,296,0.03,6 - SONIPAT (Haryana),7,6
22.0,RAKESH DHARIWAL,Rashtriya Jatigat Aarakshan Virodhi Party,214,1,215,0.02,6 - SONIPAT (Haryana),7,6
23.0,NOTA,None of the Above,2287,33,2320,0.21,6 - SONIPAT (Haryana),7,6
,Total,,1119190,4754,1123944,,6 - SONIPAT (Haryana),7,6
1.0,DEEPENDER SINGH HOODA,Indian National Congress,778259,5319,783578,62.76,7 - ROHTAK (Haryana),7,7
2.0,DR. ARVIND KUMAR SHARMA,Bharatiya Janata Party,435028,3252,438280,35.11,7 - ROHTAK (Haryana),7,7
3.0,RAVINDER,Jannayak Janta Party,6209,41,6250,0.5,7 - ROHTAK (Haryana),7,7
4.0,RAKESH SINGH,Rashtrawadi Janlok Party (Satya),2706,8,2714,0.22,7 - ROHTAK (Haryana),7,7
5.0,BISHAMBAR KUMAR,Independent,2394,-,2394,0.19,7 - ROHTAK (Haryana),7,7
6.0,KALAWATI,Independent,2135,15,2150,0.17,7 - ROHTAK (Haryana),7,7
7.0,PARVEEN KUMAR,Independent,1927,1,1928,0.15,7 - ROHTAK (Haryana),7,7
8.0,UDEVIR,Independent,1530,2,1532,0.12,7 - ROHTAK (Haryana),7,7
9.0,VINOD KUMAR,Peoples Party of India (Democratic),805,4,809,0.06,7 - ROHTAK (Haryana),7,7
10.0,ASHOK KUMAR,Independent,627,2,629,0.05,7 - ROHTAK (Haryana),7,7
11.0,VISHESH BAMEL,Bharatiya Asha Party,613,5,618,0.05,7 - ROHTAK (Haryana),7,7
12.0,JAIKARAN MANDAUTHI,Socialist Unity Centre Of India (COMMUNIST),600,7,607,0.05,7 - ROHTAK (Haryana),7,7
13.0,JAGBIR SINGH,Bharatheeya Jawan Kisan Party,574,19,593,0.05,7 - ROHTAK (Haryana),7,7
14.0,SATISH KUMAR,Independent,524,-,524,0.04,7 - ROHTAK (Haryana),7,7
15.0,SURENDER,Aam Aadmi Parivartan Party,447,23,470,0.04,7 - ROHTAK (Haryana),7,7
16.0,MANISHA,Independent,410,21,431,0.03,7 - ROHTAK (Haryana),7,7
17.0,ARVIND KUMAR SHARMA,Independent,360,7,367,0.03,7 - ROHTAK (Haryana),7,7
18.0,SATISH KUMAR,Ekam Sanatan Bharat Dal,359,4,363,0.03,7 - ROHTAK (Haryana),7,7
19.0,ARVIND,Independent,330,-,330,0.03,7 - ROHTAK (Haryana),7,7
20.0,ADVOCATE ADITYA DHANKHAR,Super Power India Party,275,12,287,0.02,7 - ROHTAK (Haryana),7,7
21.0,MASTER RANDHIR SINGH,Independent,267,2,269,0.02,7 - ROHTAK (Haryana),7,7
22.0,MANJEET,Independent,267,2,269,0.02,7 - ROHTAK (Haryana),7,7
23.0,SANJAY,Independent,210,2,212,0.02,7 - ROHTAK (Haryana),7,7
24.0,YOGESH SHARMA,Independent,190,-,190,0.02,7 - ROHTAK (Haryana),7,7
25.0,VINAY,Independent,156,3,159,0.01,7 - ROHTAK (Haryana),7,7
26.0,LALIT KUMAR,Independent,129,2,131,0.01,7 - ROHTAK (Haryana),7,7
27.0,NOTA,None of the Above,2321,41,2362,0.19,7 - ROHTAK (Haryana),7,7
,Total,,1239652,8794,1248446,,7 - ROHTAK (Haryana),7,7
1.0,DHARAMBIR SINGH,Bharatiya Janata Party,582735,5929,588664,49.74,8 - BHIWANI-MAHENDRAGARH (Haryana),7,8
2.0,RAO DAN SINGH,Indian National Congress,541926,5228,547154,46.24,8 - BHIWANI-MAHENDRAGARH (Haryana),7,8
3.0,BAHADUR SINGH,Jannayak Janta Party,15076,189,15265,1.29,8 - BHIWANI-MAHENDRAGARH (Haryana),7,8
4.0,SUNIL KUMAR SHARMA,Bahujan Samaj Party,6239,97,6336,0.54,8 - BHIWANI-MAHENDRAGARH (Haryana),7,8
5.0,SUBHASH,Rashtrawadi Janlok Party (Satya),4663,32,4695,0.4,8 - BHIWANI-MAHENDRAGARH (Haryana),7,8
6.0,HEMANT,Independent,3876,5,3881,0.33,8 - BHIWANI-MAHENDRAGARH (Haryana),7,8
7.0,SEEMA,Independent,2961,18,2979,0.25,8 - BHIWANI-MAHENDRAGARH (Haryana),7,8
8.0,VED PRAKASH,Independent,1897,3,1900,0.16,8 - BHIWANI-MAHENDRAGARH (Haryana),7,8
9.0,ANAND KUMAR,Bharatheeya Jawan Kisan Party,1642,26,1668,0.14,8 - BHIWANI-MAHENDRAGARH (Haryana),7,8
10.0,YOGBIR SINGH,Independent,1473,5,1478,0.12,8 - BHIWANI-MAHENDRAGARH (Haryana),7,8
11.0,VARSHA,Independent,993,60,1053,0.09,8 - BHIWANI-MAHENDRAGARH (Haryana),7,8
12.0,BALWAN,Peoples Party of India (Democratic),854,3,857,0.07,8 - BHIWANI-MAHENDRAGARH (Haryana),7,8
13.0,ROHTASH,Socialist Unity Centre Of India (COMMUNIST),637,3,640,0.05,8 - BHIWANI-MAHENDRAGARH (Haryana),7,8
14.0,JAI SINGH,Independent,442,9,451,0.04,8 - BHIWANI-MAHENDRAGARH (Haryana),7,8
15.0,BHARAT BHUSHAN,Bhartiya Shakti Chetna Party,440,3,443,0.04,8 - BHIWANI-MAHENDRAGARH (Haryana),7,8
16.0,ENGINEER MAHAVIR SINGH YADAV,Independent,406,9,415,0.04,8 - BHIWANI-MAHENDRAGARH (Haryana),7,8
17.0,JAGDISH,Independent,219,10,229,0.02,8 - BHIWANI-MAHENDRAGARH (Haryana),7,8
18.0,NOTA,None of the Above,5188,99,5287,0.45,8 - BHIWANI-MAHENDRAGARH (Haryana),7,8
,Total,,1171667,11728,1183395,,8 - BHIWANI-MAHENDRAGARH (Haryana),7,8
1.0,RAO INDERJIT SINGH,Bharatiya Janata Party,805161,3175,808336,50.48,9 - GURGAON (Haryana),7,9
2.0,RAJ BABBAR,Indian National Congress,731696,1561,733257,45.79,9 - GURGAON (Haryana),7,9
3.0,RAHUL YADAV FAZILPURIA,Jannayak Janta Party,13214,64,13278,0.83,9 - GURGAON (Haryana),7,9
4.0,VIJAY KHATANA,Bahujan Samaj Party,8900,46,8946,0.56,9 - GURGAON (Haryana),7,9
5.0,SORAB KHAN,Indian National Lok Dal,4897,20,4917,0.31,9 - GURGAON (Haryana),7,9
6.0,AJAY KUMAR,Independent,3527,1,3528,0.22,9 - GURGAON (Haryana),7,9
7.0,ASHOK JANGRA,Independent,3002,3,3005,0.19,9 - GURGAON (Haryana),7,9
8.0,AZAD SINGH,Independent,2744,1,2745,0.17,9 - GURGAON (Haryana),7,9
9.0,AKSHAT GAIT,Independent,2549,1,2550,0.16,9 - GURGAON (Haryana),7,9
10.0,LAL CHAND YADAV,Bharatheeya Jawan Kisan Party,2214,8,2222,0.14,9 - GURGAON (Haryana),7,9
11.0,SAMAY SINGH,Independent,1885,2,1887,0.12,9 - GURGAON (Haryana),7,9
12.0,DHARMENDER THAKRAN,Swayam Shashan Party,1402,6,1408,0.09,9 - GURGAON (Haryana),7,9
13.0,VIJAY YADAV,Jan Sewak Kranti Party,1120,-,1120,0.07,9 - GURGAON (Haryana),7,9
14.0,ISHWAR SINGH SUTHANI,Peoples Party of India (Democratic),1110,4,1114,0.07,9 - GURGAON (Haryana),7,9
15.0,COMRADE SARWAN KUMAR GUPTA,Socialist Unity Centre Of India (COMMUNIST),1066,8,1074,0.07,9 - GURGAON (Haryana),7,9
16.0,VANDNA GULIYA,Right to Recall Party,980,20,1000,0.06,9 - GURGAON (Haryana),7,9
17.0,SAMPOORN ANAND,Rashtriya Lokswaraj Party,911,4,915,0.06,9 - GURGAON (Haryana),7,9
18.0,KUSHESHWAR BHAGAT,Independent,794,-,794,0.05,9 - GURGAON (Haryana),7,9
19.0,SINGH RAM,Independent,789,2,791,0.05,9 - GURGAON (Haryana),7,9
20.0,ANWAR,Social Democratic Party Of India,572,6,578,0.04,9 - GURGAON (Haryana),7,9
21.0,FAUJI JAI KAWAR TYAGI (DIXIT),Independent,469,5,474,0.03,9 - GURGAON (Haryana),7,9
22.0,AKASH VYAS,Bhartiya Shakti Chetna Party,436,3,439,0.03,9 - GURGAON (Haryana),7,9
23.0,VISHNU,Independent,436,1,437,0.03,9 - GURGAON (Haryana),7,9
24.0,NOTA,None of the Above,6377,40,6417,0.4,9 - GURGAON (Haryana),7,9
,Total,,1596251,4981,1601232,,9 - GURGAON (Haryana),7,9
1.0,KRISHAN PAL,Bharatiya Janata Party,787332,1237,788569,53.6,10 - FARIDABAD (Haryana),7,10
2.0,MAHENDER PRATAP SINGH,Indian National Congress,614908,747,615655,41.84,10 - FARIDABAD (Haryana),7,10
3.0,KISHAN THAKUR,Bahujan Samaj Party,25164,42,25206,1.71,10 - FARIDABAD (Haryana),7,10
4.0,SUNIL TEWATIA,Indian National Lok Dal,8057,28,8085,0.55,10 - FARIDABAD (Haryana),7,10
5.0,NALIN HOODA,Jannayak Janta Party,5335,26,5361,0.36,10 - FARIDABAD (Haryana),7,10
6.0,SAWATANTAR SINGH CHAUHAN,Jan Shakti Dal,2951,4,2955,0.2,10 - FARIDABAD (Haryana),7,10
7.0,NEERAJ JATAV,Independent,2104,4,2108,0.14,10 - FARIDABAD (Haryana),7,10
8.0,HARI SHANKER RAJVANS,Adim Bhartiya Dal,1584,-,1584,0.11,10 - FARIDABAD (Haryana),7,10
9.0,ATUL,Independent,1456,2,1458,0.1,10 - FARIDABAD (Haryana),7,10
10.0,PANDIT SUMIT KUMAR SHARMA,AARAKSHAN VIRODHI PARTY,1439,5,1444,0.1,10 - FARIDABAD (Haryana),7,10
11.0,BRIJABALA,Peoples Party of India (Democratic),1370,10,1380,0.09,10 - FARIDABAD (Haryana),7,10
12.0,SHYAM SUNDER SINGH,Bhartiya Shakti Chetna Party,1247,-,1247,0.08,10 - FARIDABAD (Haryana),7,10
13.0,MAHESH PRATAP SHARMA,Rashtriya Vikas Party,1237,3,1240,0.08,10 - FARIDABAD (Haryana),7,10
14.0,SATAY DEO YADAV,Buland Bharat Party,953,2,955,0.06,10 - FARIDABAD (Haryana),7,10
15.0,RANDHEER SINGH ALIAS DHEERU KHATANA,Akhil Bhartiya Kisan Majdoor Party,919,5,924,0.06,10 - FARIDABAD (Haryana),7,10
16.0,SUNIL KUMAR,Independent,888,1,889,0.06,10 - FARIDABAD (Haryana),7,10
17.0,BHARAT BHUSHAN KOLI,Rashtra Nirman Party,807,1,808,0.05,10 - FARIDABAD (Haryana),7,10
18.0,SHIV NARAYAN BABA DUBEY,Kisan Mazdoor Sangharsh Party,769,2,771,0.05,10 - FARIDABAD (Haryana),7,10
19.0,GYAN CHAND BAINSLA,Samrat Mihir Bhoj Samaj Party,751,5,756,0.05,10 - FARIDABAD (Haryana),7,10
20.0,RAJESH GAUTAM,Independent,662,1,663,0.05,10 - FARIDABAD (Haryana),7,10
21.0,SWAMI RAJENDRA DEV JI,Independent,660,3,663,0.05,10 - FARIDABAD (Haryana),7,10
22.0,GIRRAJ,Independent,612,2,614,0.04,10 - FARIDABAD (Haryana),7,10
23.0,LEKHRAM DABANG,Independent,610,5,615,0.04,10 - FARIDABAD (Haryana),7,10
24.0,SHAKILA HUSSAIN,Loktantrik Janshakti Party,547,4,551,0.04,10 - FARIDABAD (Haryana),7,10
25.0,NOTA,None of the Above,6808,13,6821,0.46,10 - FARIDABAD (Haryana),7,10
,Total,,1469170,2152,1471322,,10 - FARIDABAD (Haryana),7,10
1.0,DR RAJEEV BHARDWAJ,Bharatiya Janata Party,622482,10311,632793,61.03,1 - KANGRA (Himachal Pradesh),8,1
2.0,ANAND SHARMA,Indian National Congress,374346,6552,380898,36.74,1 - KANGRA (Himachal Pradesh),8,1
3.0,REKHA CHAUDHARY,Bahujan Samaj Party,7478,275,7753,0.75,1 - KANGRA (Himachal Pradesh),8,1
4.0,ADVOCATE SANJAY SHARMA,Independent,2304,15,2319,0.22,1 - KANGRA (Himachal Pradesh),8,1
5.0,DR KEHAR SINGH,Independent,2129,49,2178,0.21,1 - KANGRA (Himachal Pradesh),8,1
6.0,JEEVAN KUMAR,Akhil Bhartiya Parivar Party,1441,35,1476,0.14,1 - KANGRA (Himachal Pradesh),8,1
7.0,NARAIN SINGH DOGRA,Himachal Janta Party,1125,46,1171,0.11,1 - KANGRA (Himachal Pradesh),8,1
8.0,BHUVNESH KUMAR,Rashtriya Devbhumi Party,701,55,756,0.07,1 - KANGRA (Himachal Pradesh),8,1
9.0,DEV RAJ BHARDWAJ,Rashtriya Samaj Dal (R),588,19,607,0.06,1 - KANGRA (Himachal Pradesh),8,1
10.0,ACHAL SINGH,Independent,491,54,545,0.05,1 - KANGRA (Himachal Pradesh),8,1
11.0,NOTA,None of the Above,6260,112,6372,0.61,1 - KANGRA (Himachal Pradesh),8,1
,Total,,1019345,17523,1036868,,1 - KANGRA (Himachal Pradesh),8,1
1.0,KANGNA RANAUT,Bharatiya Janata Party,527463,9559,537022,52.87,2 - MANDI (Himachal Pradesh),8,2
2.0,VIKRAMADITYA SINGH,Indian National Congress,453760,8507,462267,45.51,2 - MANDI (Himachal Pradesh),8,2
3.0,DR. PRAKASH CHAND BHARDWAJ,Bahujan Samaj Party,4320,73,4393,0.43,2 - MANDI (Himachal Pradesh),8,2
4.0,NARENDER KUMAR,Rashtriya Devbhumi Party,2422,25,2447,0.24,2 - MANDI (Himachal Pradesh),8,2
5.0,RAKHEE GUPTA,Independent,1014,37,1051,0.1,2 - MANDI (Himachal Pradesh),8,2
6.0,SUBHASH MOHAN SNEHI,Independent,963,11,974,0.1,2 - MANDI (Himachal Pradesh),8,2
7.0,VINAY KUMAR,Akhil Bhartiya Parivar Party,674,16,690,0.07,2 - MANDI (Himachal Pradesh),8,2
8.0,MAHESH SAINI,Himachal Janta Party,641,13,654,0.06,2 - MANDI (Himachal Pradesh),8,2
9.0,DINESH KUMAR BHATI,Independent,375,6,381,0.04,2 - MANDI (Himachal Pradesh),8,2
10.0,ASHUTOSH MAHANT,Independent,260,26,286,0.03,2 - MANDI (Himachal Pradesh),8,2
11.0,NOTA,None of the Above,5586,59,5645,0.56,2 - MANDI (Himachal Pradesh),8,2
,Total,,997478,18332,1015810,,2 - MANDI (Himachal Pradesh),8,2
1.0,ANURAG SINGH THAKUR,Bharatiya Janata Party,593055,14013,607068,57.97,3 - HAMIRPUR (Himachal Pradesh),8,3
2.0,SATPAL RAIZADA,Indian National Congress,414828,9883,424711,40.55,3 - HAMIRPUR (Himachal Pradesh),8,3
3.0,HEM RAJ,Bahujan Samaj Party,2694,64,2758,0.26,3 - HAMIRPUR (Himachal Pradesh),8,3
4.0,JAGDEEP KUMAR,Rashtriya Devbhumi Party,1738,26,1764,0.17,3 - HAMIRPUR (Himachal Pradesh),8,3
5.0,SURENDER KUMAR GAUTAM,Independent,1401,9,1410,0.13,3 - HAMIRPUR (Himachal Pradesh),8,3
6.0,SUBEDAR MAJOR KULWANT SINGH PATIAL,Bharatheeya Jawan Kisan Party,1176,63,1239,0.12,3 - HAMIRPUR (Himachal Pradesh),8,3
7.0,NAND LAL,Independent,978,41,1019,0.1,3 - HAMIRPUR (Himachal Pradesh),8,3
8.0,SUMIT RANA,Akhil Bhartiya Parivar Party,666,9,675,0.06,3 - HAMIRPUR (Himachal Pradesh),8,3
9.0,RAMESH CHAND SARTHI,Independent,544,16,560,0.05,3 - HAMIRPUR (Himachal Pradesh),8,3
10.0,ARUN ANKESH SYAL,Ekam Sanatan Bharat Dal,412,21,433,0.04,3 - HAMIRPUR (Himachal Pradesh),8,3
11.0,GARIB DASS KATOCH,Independent,210,36,246,0.02,3 - HAMIRPUR (Himachal Pradesh),8,3
12.0,GOPI CHAND ATTARI,Independent,168,34,202,0.02,3 - HAMIRPUR (Himachal Pradesh),8,3
13.0,NOTA,None of the Above,5100,78,5178,0.49,3 - HAMIRPUR (Himachal Pradesh),8,3
,Total,,1022970,24293,1047263,,3 - HAMIRPUR (Himachal Pradesh),8,3
1.0,Suresh Kumar Kashyap,Bharatiya Janata Party,513936,5812,519748,53.58,4 - SHIMLA (Himachal Pradesh),8,4
2.0,Vinod Sultanpuri,Indian National Congress,423388,4909,428297,44.16,4 - SHIMLA (Himachal Pradesh),8,4
3.0,Anil Kumar Manget,Bahujan Samaj Party,6379,121,6500,0.67,4 - SHIMLA (Himachal Pradesh),8,4
4.0,Suresh Kumar,Rashtriya Devbhumi Party,4766,48,4814,0.5,4 - SHIMLA (Himachal Pradesh),8,4
5.0,Madan Lal,Akhil Bhartiya Parivar Party,4633,43,4676,0.48,4 - SHIMLA (Himachal Pradesh),8,4
6.0,NOTA,None of the Above,5876,54,5930,0.61,4 - SHIMLA (Himachal Pradesh),8,4
,Total,,958978,10987,969965,,4 - SHIMLA (Himachal Pradesh),8,4
1.0,PRIYANKA SATISH JARKIHOLI,Indian National Congress,710823,2638,713461,51.21,1 - Chikkodi (Karnataka),10,1
2.0,ANNASAHEB SHANKAR JOLLE,Bharatiya Janata Party,618168,4459,622627,44.69,1 - Chikkodi (Karnataka),10,1
3.0,KALLOLIKAR SHAMBHU KRISHNA,Independent,25351,115,25466,1.83,1 - Chikkodi (Karnataka),10,1
4.0,SAMMED SARADAR VARDHAMANE,Independent,5351,2,5353,0.38,1 - Chikkodi (Karnataka),10,1
5.0,SHRENIK ANNASAHEB JANGATE,Independent,5179,2,5181,0.37,1 - Chikkodi (Karnataka),10,1
6.0,APPASAHEB SHRIPATI KURANE,Sarva Janata Party,4635,19,4654,0.33,1 - Chikkodi (Karnataka),10,1
7.0,VILAS MANNUR,Independent,4143,7,4150,0.3,1 - Chikkodi (Karnataka),10,1
8.0,SATTEPPA DASHARATH KALELI,Bharatheeya Jawan Kisan Party,1304,15,1319,0.09,1 - Chikkodi (Karnataka),10,1
9.0,YASIN SHIRAJUDDIN PATAKI,Independent,1279,2,1281,0.09,1 - Chikkodi (Karnataka),10,1
10.0,KASHINATH KALLAPPA KURANI,Independent,1097,11,1108,0.08,1 - Chikkodi (Karnataka),10,1
11.0,MAHESH ASHOK KASAR,Independent,1002,7,1009,0.07,1 - Chikkodi (Karnataka),10,1
12.0,MOHAN GURAPPA MOTANNAVAR,Independent,938,8,946,0.07,1 - Chikkodi (Karnataka),10,1
13.0,KUMAR SAMBHAJI DONGARE,Karnataka Rashtra Samithi,930,11,941,0.07,1 - Chikkodi (Karnataka),10,1
14.0,PAVANKUMAR BABURAV MALAGE,Bahujan Bharat Party,655,11,666,0.05,1 - Chikkodi (Karnataka),10,1
15.0,DR|| KADAYYA HIREMATH (SWAMIJI),Independent,642,5,647,0.05,1 - Chikkodi (Karnataka),10,1
16.0,BHIMASEN DATTU SANADI,Independent,614,5,619,0.04,1 - Chikkodi (Karnataka),10,1
17.0,GAJANAN L. PUJARI,Independent,591,9,600,0.04,1 - Chikkodi (Karnataka),10,1
18.0,JITENDRA SUBHASH NERLE,Independent,452,5,457,0.03,1 - Chikkodi (Karnataka),10,1
19.0,NOTA,None of the Above,2571,37,2608,0.19,1 - Chikkodi (Karnataka),10,1
,Total,,1385725,7368,1393093,,1 - Chikkodi (Karnataka),10,1
1.0,JAGADISH SHETTAR,Bharatiya Janata Party,756471,5558,762029,55.06,2 - Belgaum (Karnataka),10,2
2.0,MRINAL R HEBBALKAR,Indian National Congress,580897,2695,583592,42.17,2 - Belgaum (Karnataka),10,2
3.0,MAHADEV PATIL,Independent,9425,78,9503,0.69,2 - Belgaum (Karnataka),10,2
4.0,BASAPPA GURUSIDDAPPA KUMBAR,Karnataka Rashtra Samithi,5406,35,5441,0.39,2 - Belgaum (Karnataka),10,2
5.0,ASHOK APPAYA APPUGOL,Bahujan Samaj Party,4350,57,4407,0.32,2 - Belgaum (Karnataka),10,2
6.0,RAVI SHIVAPPA PADASALAGI,Independent,3911,15,3926,0.28,2 - Belgaum (Karnataka),10,2
7.0,VIJAY S METHRANI,Independent,2804,4,2808,0.2,2 - Belgaum (Karnataka),10,2
8.0,PRAJAAKEEYA MALLAPPA CHOGALA (PREM),Uttama Prajaakeeya Party,1413,20,1433,0.1,2 - Belgaum (Karnataka),10,2
9.0,LAXMAN JADAGANNAVAR,Socialist Unity Centre Of India (COMMUNIST),1287,15,1302,0.09,2 - Belgaum (Karnataka),10,2
10.0,NITIN ASHOK MHADAGUT,Independent,1286,24,1310,0.09,2 - Belgaum (Karnataka),10,2
11.0,PUNDALIK ITNAL,Independent,1062,37,1099,0.08,2 - Belgaum (Karnataka),10,2
12.0,ASHOK P HANAJI,Independent,668,11,679,0.05,2 - Belgaum (Karnataka),10,2
13.0,ASHPAKAHMAD USTAD,Independent,622,12,634,0.05,2 - Belgaum (Karnataka),10,2
14.0,NOTA,None of the Above,5683,43,5726,0.41,2 - Belgaum (Karnataka),10,2
,Total,,1375285,8604,1383889,,2 - Belgaum (Karnataka),10,2
1.0,GADDIGOUDAR. PARVATAGOUDA. CHANDANAGOUDA.,Bharatiya Janata Party,667441,3598,671039,50.93,3 - Bagalkot (Karnataka),10,3
2.0,SAMYUKTA SHIVANAND PATIL,Indian National Congress,600741,1899,602640,45.74,3 - Bagalkot (Karnataka),10,3
3.0,NAGARAJ. S. KALKUTAGAR,Independent,5628,1,5629,0.43,3 - Bagalkot (Karnataka),10,3
4.0,PARASHURAM. LAXMAN. NEELANAIK,Independent,5084,6,5090,0.39,3 - Bagalkot (Karnataka),10,3
5.0,ANTHOSH SAVVASE,Uttama Prajaakeeya Party,4909,14,4923,0.37,3 - Bagalkot (Karnataka),10,3
6.0,JYOTI GULEDGUDDA,Independent,4636,9,4645,0.35,3 - Bagalkot (Karnataka),10,3
7.0,M. B. SIDAGONI,Bahujan Samaj Party,4453,26,4479,0.34,3 - Bagalkot (Karnataka),10,3
8.0,DR. MUTTU. S. SURAKOD. (MADAR),Independent,3131,4,3135,0.24,3 - Bagalkot (Karnataka),10,3
9.0,PRASHANT RAO,Independent,1909,5,1914,0.15,3 - Bagalkot (Karnataka),10,3
10.0,DATTATREYA DASHARATHA TAVARE,Independent,1607,13,1620,0.12,3 - Bagalkot (Karnataka),10,3
11.0,AMBROSE D' MELLO,Independent,1203,2,1205,0.09,3 - Bagalkot (Karnataka),10,3
12.0,KENGANAL. MALLIKARJUN. BHIMAPPA,Independent,1189,18,1207,0.09,3 - Bagalkot (Karnataka),10,3
13.0,MALLIKARJUN H. T.,Socialist Unity Centre Of India (COMMUNIST),1137,7,1144,0.09,3 - Bagalkot (Karnataka),10,3
14.0,RAJESAB BURANSAB. MASALI,Independent,988,4,992,0.08,3 - Bagalkot (Karnataka),10,3
15.0,SHARANAPPA MALLAPPA KOTLANNAVAR,Independent,830,2,832,0.06,3 - Bagalkot (Karnataka),10,3
16.0,RAVI SHIVAPPA PADASALAGI,Independent,654,2,656,0.05,3 - Bagalkot (Karnataka),10,3
17.0,SAIYYAD IMAMSAB JAKALI,Tipu Sultan Party,546,4,550,0.04,3 - Bagalkot (Karnataka),10,3
18.0,ABDULAZIZ KALADAGI PENDARI,Independent,524,5,529,0.04,3 - Bagalkot (Karnataka),10,3
19.0,MUTTAPPA MUDAKAPPA HIREKUMBI,Raita Bharat Party,509,9,518,0.04,3 - Bagalkot (Karnataka),10,3
20.0,SAGAR. BASAPPA. KUMBAR,Karnataka Rashtra Samithi,494,5,499,0.04,3 - Bagalkot (Karnataka),10,3
21.0,S. M. MARIGOUDAR,Desh Prem Party,451,3,454,0.03,3 - Bagalkot (Karnataka),10,3
22.0,SHANKAR. VENKAPPA. NAIKAR.,Republican Party of India (A),431,10,441,0.03,3 - Bagalkot (Karnataka),10,3
23.0,NOTA,None of the Above,3398,22,3420,0.26,3 - Bagalkot (Karnataka),10,3
,Total,,1311893,5668,1317561,,3 - Bagalkot (Karnataka),10,3
1.0,RAMESH JIGAJINAGI,Bharatiya Janata Party,669055,3726,672781,51.91,4 - Bijapur (Karnataka),10,4
2.0,RAJU ALAGUR.,Indian National Congress,593277,2275,595552,45.95,4 - Bijapur (Karnataka),10,4
3.0,GANAPATI RATHOD (HANJAGI),Karnataka Rashtra Samithi,7652,39,7691,0.59,4 - Bijapur (Karnataka),10,4
4.0,BHOVI TARABAI,Independent,4342,11,4353,0.34,4 - Bijapur (Karnataka),10,4
5.0,RAMJI YAMANAPPA BUDDHAPRIYA,Naki Bharatiya Ekta Party,2414,12,2426,0.19,4 - Bijapur (Karnataka),10,4
6.0,NAGAJYOTI.B.N.,Socialist Unity Centre Of India (COMMUNIST),2375,17,2392,0.18,4 - Bijapur (Karnataka),10,4
7.0,RAJAKUMAR APPANNA HONNAKATTI,Rashtriya Samaj Paksha,1784,10,1794,0.14,4 - Bijapur (Karnataka),10,4
8.0,JITENDRA.ASHOK. KAMBLE,Republican Party of India (A),1605,18,1623,0.13,4 - Bijapur (Karnataka),10,4
9.0,NOTA,None of the Above,7482,20,7502,0.58,4 - Bijapur (Karnataka),10,4
,Total,,1289986,6128,1296114,,4 - Bijapur (Karnataka),10,4
1.0,RADHAKRISHNA,Indian National Congress,650623,1698,652321,49.78,5 - Gulbarga (Karnataka),10,5
2.0,DR. UMESH G JADHAV,Bharatiya Janata Party,622615,2501,625116,47.7,5 - Gulbarga (Karnataka),10,5
3.0,HUCHESHWARA WATHAR GOUR,Bahujan Samaj Party,7871,17,7888,0.6,5 - Gulbarga (Karnataka),10,5
4.0,SUNDAR,Independent,3675,2,3677,0.28,5 - Gulbarga (Karnataka),10,5
5.0,JYOTI RAMESH CHAVAN,Independent,2787,18,2805,0.21,5 - Gulbarga (Karnataka),10,5
6.0,SHARANAPPA (PINTU),Independent,1879,5,1884,0.14,5 - Gulbarga (Karnataka),10,5
7.0,TARABAI BHOVI,Independent,1546,4,1550,0.12,5 - Gulbarga (Karnataka),10,5
8.0,RAMESH BHIMSING CHAVAN,Independent,1332,2,1334,0.1,5 - Gulbarga (Karnataka),10,5
9.0,ANAND SINNUR,Independent,1271,9,1280,0.1,5 - Gulbarga (Karnataka),10,5
10.0,NAGENDRA RAO,Uttama Prajaakeeya Party,1211,15,1226,0.09,5 - Gulbarga (Karnataka),10,5
11.0,S.M.SHARMA,Socialist Unity Centre Of India (COMMUNIST),1136,8,1144,0.09,5 - Gulbarga (Karnataka),10,5
12.0,RAJKUMAR,BhartiyaBahujanKranti Dal,702,7,709,0.05,5 - Gulbarga (Karnataka),10,5
13.0,VIJAY JADHAV,Karnataka Rashtra Samithi,555,5,560,0.04,5 - Gulbarga (Karnataka),10,5
14.0,B. VIJAYKUMAR CHINCHANSOORKAR,Prahar Janshakti Party,548,6,554,0.04,5 - Gulbarga (Karnataka),10,5
15.0,NOTA,None of the Above,8416,13,8429,0.64,5 - Gulbarga (Karnataka),10,5
,Total,,1306167,4310,1310477,,5 - Gulbarga (Karnataka),10,5
1.0,G. KUMAR NAIK.,Indian National Congress,669413,1553,670966,51.63,6 - Raichur (Karnataka),10,6
2.0,RAJA AMARESHWARA NAIK.,Bharatiya Janata Party,588833,2352,591185,45.49,6 - Raichur (Karnataka),10,6
3.0,S. NARASANNA GOUDA NAYAKA,Bahujan Samaj Party,9275,14,9289,0.71,6 - Raichur (Karnataka),10,6
4.0,BASAVA PRABHU. MEDA,Karnataka Rashtra Samithi,5173,8,5181,0.4,6 - Raichur (Karnataka),10,6
5.0,AMARESH,Independent,4459,6,4465,0.34,6 - Raichur (Karnataka),10,6
6.0,YALLAMMA DALAPATHI,Independent,3629,5,3634,0.28,6 - Raichur (Karnataka),10,6
7.0,MEDHAR SHAMRAO,Bhartiya Jan Samrat Party,2625,15,2640,0.2,6 - Raichur (Karnataka),10,6
8.0,RAMALINGAPPA,Socialist Unity Centre Of India (COMMUNIST),2404,5,2409,0.19,6 - Raichur (Karnataka),10,6
9.0,NOTA,None of the Above,9825,25,9850,0.76,6 - Raichur (Karnataka),10,6
,Total,,1295636,3983,1299619,,6 - Raichur (Karnataka),10,6
1.0,SAGAR ESHWAR KHANDRE,Indian National Congress,665162,1155,666317,53.63,7 - Bidar (Karnataka),10,7
2.0,BHAGWANTH KHUBA,Bharatiya Janata Party,535766,1676,537442,43.26,7 - Bidar (Karnataka),10,7
3.0,AMBADAS SOPANRAO HULSURE,Bahujan Bharat Party,5300,2,5302,0.43,7 - Bidar (Karnataka),10,7
4.0,PUTARAJ,Bahujan Samaj Party,4541,13,4554,0.37,7 - Bidar (Karnataka),10,7
5.0,DR. DINKAR MORE,Independent,4105,11,4116,0.33,7 - Bidar (Karnataka),10,7
6.0,SRI ROPH ABDUL GANI,Independent,3101,3,3104,0.25,7 - Bidar (Karnataka),10,7
7.0,SHIVRAJ ADIVEPPA SATWAR,Independent,3076,3,3079,0.25,7 - Bidar (Karnataka),10,7
8.0,RAMVILAS RAMULALJI NAVANDAR,Independent,2694,-,2694,0.22,7 - Bidar (Karnataka),10,7
9.0,RIYAZ AHMED,Independent,1710,1,1711,0.14,7 - Bidar (Karnataka),10,7
10.0,MOHD. SHAFEEQ UR RAHAMAN,All India Ulama Congress,1684,10,1694,0.14,7 - Bidar (Karnataka),10,7
11.0,JAIRAJ KASHAPPA BUKKA ADVOCATE,Independent,1493,-,1493,0.12,7 - Bidar (Karnataka),10,7
12.0,BALBHEEM UNNE,Independent,1462,8,1470,0.12,7 - Bidar (Karnataka),10,7
13.0,WASEEMUDDIN,Independent,1169,1,1170,0.09,7 - Bidar (Karnataka),10,7
14.0,MAHESH GORNALKAR,Republican Party of India (A),974,7,981,0.08,7 - Bidar (Karnataka),10,7
15.0,DILIP KADWAD,Independent,791,7,798,0.06,7 - Bidar (Karnataka),10,7
16.0,GOPAL M.P. GARAMPALLI,Independent,765,2,767,0.06,7 - Bidar (Karnataka),10,7
17.0,RAMESH J CHAVAN,Karnataka Rashtra Samithi,471,1,472,0.04,7 - Bidar (Karnataka),10,7
18.0,RAMCHANDRA NARAYAN KACHAVE,Kranti Kari Jai Hind Sena,468,4,472,0.04,7 - Bidar (Karnataka),10,7
19.0,NOTA,None of the Above,4674,12,4686,0.38,7 - Bidar (Karnataka),10,7
,Total,,1239406,2916,1242322,,7 - Bidar (Karnataka),10,7
1.0,K. RAJASHEKAR BASAVARAJ HITNAL,Indian National Congress,661921,1590,663511,49.93,8 - Koppal (Karnataka),10,8
2.0,DR . BASAVARAJ. K. SHARANAPPA,Bharatiya Janata Party,614866,2288,617154,46.44,8 - Koppal (Karnataka),10,8
3.0,MALLIKARJUN HADAPAD,Independent,7310,4,7314,0.55,8 - Koppal (Karnataka),10,8
4.0,SHANKARA,Bahujan Samaj Party,7031,12,7043,0.53,8 - Koppal (Karnataka),10,8
5.0,KARADI BASAVARAJ,Independent,5868,9,5877,0.44,8 - Koppal (Karnataka),10,8
6.0,RUKMINI,Independent,5279,3,5282,0.4,8 - Koppal (Karnataka),10,8
7.0,SURESH. GOUDA MUNDINAMANE,Independent,4641,1,4642,0.35,8 - Koppal (Karnataka),10,8
8.0,NAGARAJ KALAL,Independent,1992,2,1994,0.15,8 - Koppal (Karnataka),10,8
9.0,KALAPPA YACHRAPPA BADIGER VISHWAKARMA,Independent,1967,15,1982,0.15,8 - Koppal (Karnataka),10,8
10.0,PA.YA. GANESH,Independent,1892,3,1895,0.14,8 - Koppal (Karnataka),10,8
11.0,HANAMESH . S . H. SHAKHAPUR,Independent,1247,1,1248,0.09,8 - Koppal (Karnataka),10,8
12.0,KAREEMPASHA GACHCHINMANI.,Independent,1233,5,1238,0.09,8 - Koppal (Karnataka),10,8
13.0,ANNOJI RAO. G,Sarva Janata Party,1113,4,1117,0.08,8 - Koppal (Karnataka),10,8
14.0,SHARANAPPA,Socialist Unity Centre Of India (COMMUNIST),1097,9,1106,0.08,8 - Koppal (Karnataka),10,8
15.0,NIRUPADI K GOMARSI,Karnataka Rashtra Samithi,891,9,900,0.07,8 - Koppal (Karnataka),10,8
16.0,RAMZANBEE,All India Ulama Congress,800,6,806,0.06,8 - Koppal (Karnataka),10,8
17.0,D DURGA PRASAD BYATARAYANAJI,Challengers Party,798,1,799,0.06,8 - Koppal (Karnataka),10,8
18.0,C. SHARANA BASAPPA,Republican Party of India (Karnataka),770,6,776,0.06,8 - Koppal (Karnataka),10,8
19.0,IMAMSAB JANGLISAB MULLA,Independent,728,5,733,0.06,8 - Koppal (Karnataka),10,8
20.0,NOTA,None of the Above,3496,23,3519,0.26,8 - Koppal (Karnataka),10,8
,Total,,1324940,3996,1328936,,8 - Koppal (Karnataka),10,8
1.0,E. TUKARAM,Indian National Congress,729581,1264,730845,52.58,9 - Bellary (Karnataka),10,9
2.0,B. SREERAMULU,Bharatiya Janata Party,629813,2040,631853,45.46,9 - Bellary (Karnataka),10,9
3.0,VALMIKI KRISHNAPPA,Bahujan Samaj Party,5901,10,5911,0.43,9 - Bellary (Karnataka),10,9
4.0,C. CHANNAVEERA,Karnataka Rashtra Samithi,3794,3,3797,0.27,9 - Bellary (Karnataka),10,9
5.0,CONDUCTOR PAMPAPATHI,Independent,2458,2,2460,0.18,9 - Bellary (Karnataka),10,9
6.0,VEERESH,Independent,1862,8,1870,0.13,9 - Bellary (Karnataka),10,9
7.0,A. DEVADAS,Socialist Unity Centre Of India (COMMUNIST),1739,2,1741,0.13,9 - Bellary (Karnataka),10,9
8.0,MANJUNATHA GOSAL,Prahar Janshakti Party,1319,3,1322,0.1,9 - Bellary (Karnataka),10,9
9.0,ARUN.S.HIREHAL,Independent,1281,1,1282,0.09,9 - Bellary (Karnataka),10,9
10.0,G. SWAMY,Navabharath Sena,940,4,944,0.07,9 - Bellary (Karnataka),10,9
11.0,NOTA,None of the Above,7871,18,7889,0.57,9 - Bellary (Karnataka),10,9
,Total,,1386559,3355,1389914,,9 - Bellary (Karnataka),10,9
1.0,BASAVARAJ BOMMAI,Bharatiya Janata Party,702189,3349,705538,50.55,10 - Haveri (Karnataka),10,10
2.0,ANANDSWAMY GADDADEVARMATH,Indian National Congress,660191,1834,662025,47.43,10 - Haveri (Karnataka),10,10
3.0,SUNANDA KARIYAPPA SHIRHATTI,Independent,4705,2,4707,0.34,10 - Haveri (Karnataka),10,10
4.0,KHAJAMOHIDDIN GUDAGERI,Socialist Party (India),3398,3,3401,0.24,10 - Haveri (Karnataka),10,10
5.0,GANGADHAR BADIGER,Socialist Unity Centre Of India (COMMUNIST),2264,6,2270,0.16,10 - Haveri (Karnataka),10,10
6.0,RUDRAPPA BASAPPA KUMBAR,Independent,1352,4,1356,0.1,10 - Haveri (Karnataka),10,10
7.0,BASAVARAJ B HADI,Independent,1065,6,1071,0.08,10 - Haveri (Karnataka),10,10
8.0,PRAJAKEEYA SACHINKUMAR KARJEKANNAVAR,Uttama Prajaakeeya Party,1058,14,1072,0.08,10 - Haveri (Karnataka),10,10
9.0,DR. G H IMRAPUR,Independent,930,23,953,0.07,10 - Haveri (Karnataka),10,10
10.0,JAGADISH YALLAPPA BANKAPURA,Independent,660,14,674,0.05,10 - Haveri (Karnataka),10,10
11.0,TANU CHIKKANNA YADAV,Karnataka Rashtra Samithi,628,8,636,0.05,10 - Haveri (Karnataka),10,10
12.0,H K NARASIMHAPPA,Samajwadi Janata Party(Karnataka),445,1,446,0.03,10 - Haveri (Karnataka),10,10
13.0,VISHWANATH SHEERI,Ekam Sanatan Bharat Dal,401,-,401,0.03,10 - Haveri (Karnataka),10,10
14.0,RASHEEDA BEGUM,Indian Movement Party,396,1,397,0.03,10 - Haveri (Karnataka),10,10
15.0,NOTA,None of the Above,10831,34,10865,0.78,10 - Haveri (Karnataka),10,10
,Total,,1390513,5299,1395812,,10 - Haveri (Karnataka),10,10
1.0,PRALHAD JOSHI,Bharatiya Janata Party,713649,2582,716231,52.41,11 - Dharwad (Karnataka),10,11
2.0,VINOD ASOOTI,Indian National Congress,617616,1291,618907,45.29,11 - Dharwad (Karnataka),10,11
3.0,SHAKEELAHMAD.D.MULLA,Independent,5866,6,5872,0.43,11 - Dharwad (Karnataka),10,11
4.0,S. S. PATIL,Independent,5153,8,5161,0.38,11 - Dharwad (Karnataka),10,11
5.0,RAJU ANANTSA NAIKWADI,Independent,3601,-,3601,0.26,11 - Dharwad (Karnataka),10,11
6.0,JAVEED AHAMED BELGAUMKAR.,Naki Bharatiya Ekta Party,3551,7,3558,0.26,11 - Dharwad (Karnataka),10,11
7.0,SHARANABASAV GONAVAR,Socialist Unity Centre Of India (COMMUNIST),1148,19,1167,0.09,11 - Dharwad (Karnataka),10,11
8.0,BALANAGOUDRA MALLIKARJUNAGOUDA,Independent,986,1,987,0.07,11 - Dharwad (Karnataka),10,11
9.0,TAKAPPA YALLAPPA KALAL,Prahar Janshakti Party,901,4,905,0.07,11 - Dharwad (Karnataka),10,11
10.0,BUGADI BASAVALINGAPPA IRAPPA,Uttama Prajaakeeya Party,796,4,800,0.06,11 - Dharwad (Karnataka),10,11
11.0,NAGARAJ. KARENNAVAR.,Karnataka Rashtra Samithi,553,2,555,0.04,11 - Dharwad (Karnataka),10,11
12.0,PRAVEEN H. H.,Independent,545,3,548,0.04,11 - Dharwad (Karnataka),10,11
13.0,DR. GURAPPA H IMRAPUR,Independent,510,4,514,0.04,11 - Dharwad (Karnataka),10,11
14.0,BANKAPUR SHOUKATALI,Tipu Sultan Party,464,9,473,0.03,11 - Dharwad (Karnataka),10,11
15.0,VINOD DASHARATH GHODKE,"Proutist Bloc, India",409,2,411,0.03,11 - Dharwad (Karnataka),10,11
16.0,VENKATESH PRASAD. H,Indian Labour Party (Ambedkar Phule),334,3,337,0.02,11 - Dharwad (Karnataka),10,11
17.0,MOHAMMED ISMAIL MUKTI,Bharatiya Prajagala Kalyana Paksha,313,4,317,0.02,11 - Dharwad (Karnataka),10,11
18.0,NOTA,None of the Above,6126,21,6147,0.45,11 - Dharwad (Karnataka),10,11
,Total,,1362521,3970,1366491,,11 - Dharwad (Karnataka),10,11
1.0,VISHWESHWAR HEGDE KAGERI,Bharatiya Janata Party,777887,4608,782495,61.97,12 - Uttara Kannada (Karnataka),10,12
2.0,DR. ANJALI NIMBALKAR,Indian National Congress,443296,1771,445067,35.25,12 - Uttara Kannada (Karnataka),10,12
3.0,RAJSHEKHAR. SHANKAR. HINDALAGI.,Independent,5384,13,5397,0.43,12 - Uttara Kannada (Karnataka),10,12
4.0,GANAPATI HEGDE,Socialist Unity Centre Of India (COMMUNIST),4427,45,4472,0.35,12 - Uttara Kannada (Karnataka),10,12
5.0,NIRANJAN UDAYSINH SIRDESAI,Independent,4116,53,4169,0.33,12 - Uttara Kannada (Karnataka),10,12
6.0,NAGARAJ. ANANT. SHIRALI.,Independent,2860,22,2882,0.23,12 - Uttara Kannada (Karnataka),10,12
7.0,CHIDANAND HANUMANTHAPPA HARIJAN,Independent,1707,14,1721,0.14,12 - Uttara Kannada (Karnataka),10,12
8.0,PRAJAAKEEYA SUNIL,Uttama Prajaakeeya Party,1523,43,1566,0.12,12 - Uttara Kannada (Karnataka),10,12
9.0,VINAYAK NAIK,Karnataka Rashtra Samithi,1230,33,1263,0.1,12 - Uttara Kannada (Karnataka),10,12
10.0,K. P. PATIL,Independent,901,55,956,0.08,12 - Uttara Kannada (Karnataka),10,12
11.0,KRISHNA BALEGAR,Independent,897,23,920,0.07,12 - Uttara Kannada (Karnataka),10,12
12.0,ARAVIND GOWDA,Independent,872,32,904,0.07,12 - Uttara Kannada (Karnataka),10,12
13.0,AVINASH. NARAYAN. PATIL.,Independent,761,12,773,0.06,12 - Uttara Kannada (Karnataka),10,12
14.0,NOTA,None of the Above,10151,25,10176,0.81,12 - Uttara Kannada (Karnataka),10,12
,Total,,1256012,6749,1262761,,12 - Uttara Kannada (Karnataka),10,12
1.0,DR. PRABHA MALLIKARJUN,Indian National Congress,631453,1606,633059,47.95,13 - Davanagere (Karnataka),10,13
2.0,GAYITHRI SIDDESHWARA,Bharatiya Janata Party,604531,2434,606965,45.97,13 - Davanagere (Karnataka),10,13
3.0,G.B.VINAY KUMAR,Independent,42624,283,42907,3.25,13 - Davanagere (Karnataka),10,13
4.0,T.JABEENA AAPA,Independent,5127,1,5128,0.39,13 - Davanagere (Karnataka),10,13
5.0,D. HANUMANTHAPPA,Bahujan Samaj Party,4462,13,4475,0.34,13 - Davanagere (Karnataka),10,13
6.0,TASLIM BANU,Independent,4140,1,4141,0.31,13 - Davanagere (Karnataka),10,13
7.0,T.CHANDRU,Independent,3043,-,3043,0.23,13 - Davanagere (Karnataka),10,13
8.0,G.M.GAYITRI SIDDESHI,Independent,2453,11,2464,0.19,13 - Davanagere (Karnataka),10,13
9.0,PARAVEEJ.H,Independent,1867,2,1869,0.14,13 - Davanagere (Karnataka),10,13
10.0,ESHWARA SHENGA,Uttama Prajaakeeya Party,1424,6,1430,0.11,13 - Davanagere (Karnataka),10,13
11.0,A.K.GANESH,Independent,1054,1,1055,0.08,13 - Davanagere (Karnataka),10,13
12.0,M.C.SREENIVAS,Bharatiya Prajagala Kalyana Paksha,968,5,973,0.07,13 - Davanagere (Karnataka),10,13
13.0,SYED ZABIULLA.K,Independent,843,1,844,0.06,13 - Davanagere (Karnataka),10,13
14.0,ANABERU THIPPESWAMY,Socialist Unity Centre Of India (COMMUNIST),842,7,849,0.06,13 - Davanagere (Karnataka),10,13
15.0,SALEEM S,Independent,799,-,799,0.06,13 - Davanagere (Karnataka),10,13
16.0,MOHAMED HAYATH.M,Independent,721,1,722,0.05,13 - Davanagere (Karnataka),10,13
17.0,ABDUL NAZEER AHAMMED,Independent,651,1,652,0.05,13 - Davanagere (Karnataka),10,13
18.0,RASHEED KHAN,Independent,599,1,600,0.05,13 - Davanagere (Karnataka),10,13
19.0,M.G.SRIKANTH,Navabharath Sena,555,6,561,0.04,13 - Davanagere (Karnataka),10,13
20.0,M.P. KHALANDAR,Country Citizen Party,536,3,539,0.04,13 - Davanagere (Karnataka),10,13
21.0,PEDDAPPA S,Independent,506,2,508,0.04,13 - Davanagere (Karnataka),10,13
22.0,G.M.BARKATH ALI BASHA,Independent,470,1,471,0.04,13 - Davanagere (Karnataka),10,13
23.0,K.S. VEERBHADRAPPA,Karnataka Rashtra Samithi,466,9,475,0.04,13 - Davanagere (Karnataka),10,13
24.0,VEERESH.S (LION VEERESH),Rani Chennamma Party,457,1,458,0.03,13 - Davanagere (Karnataka),10,13
25.0,DODDESH.H.S,Janahitha Paksha,439,1,440,0.03,13 - Davanagere (Karnataka),10,13
26.0,BARKATH ALI,Independent,409,2,411,0.03,13 - Davanagere (Karnataka),10,13
27.0,MANJU. MARIKOPPA,Independent,376,2,378,0.03,13 - Davanagere (Karnataka),10,13
28.0,RUDRESHA.K.H,Samaj Vikas Kranti Party,346,2,348,0.03,13 - Davanagere (Karnataka),10,13
29.0,RAVINAIK. B,Independent,317,3,320,0.02,13 - Davanagere (Karnataka),10,13
30.0,MAHABUB BASHA,Independent,308,-,308,0.02,13 - Davanagere (Karnataka),10,13
31.0,NOTA,None of the Above,3165,11,3176,0.24,13 - Davanagere (Karnataka),10,13
,Total,,1315951,4417,1320368,,13 - Davanagere (Karnataka),10,13
1.0,B.Y.RAGHAVENDRA,Bharatiya Janata Party,775731,2990,778721,56.54,14 - Shimoga (Karnataka),10,14
2.0,GEETHA SHIVARAJKUMAR,Indian National Congress,533622,1384,535006,38.85,14 - Shimoga (Karnataka),10,14
3.0,K. S. ESHWARAPPA,Independent,29959,91,30050,2.18,14 - Shimoga (Karnataka),10,14
4.0,BANDI,Independent,7265,1,7266,0.53,14 - Shimoga (Karnataka),10,14
5.0,RAVIKUMARA N.,Independent,4551,1,4552,0.33,14 - Shimoga (Karnataka),10,14
6.0,POOJA N. ANNAIAH,Independent,3454,3,3457,0.25,14 - Shimoga (Karnataka),10,14
7.0,A.D. SHIVAPPA,Bahujan Samaj Party,2772,7,2779,0.2,14 - Shimoga (Karnataka),10,14
8.0,N. V. NAVEEN KUMAR,Independent,1992,1,1993,0.14,14 - Shimoga (Karnataka),10,14
9.0,ARUNA KANAHALLI,Uttama Prajaakeeya Party,1475,3,1478,0.11,14 - Shimoga (Karnataka),10,14
10.0,E.H. NAYAK,Independent,953,1,954,0.07,14 - Shimoga (Karnataka),10,14
11.0,JOHN BENNY,Independent,863,4,867,0.06,14 - Shimoga (Karnataka),10,14
12.0,GANESH. B (BELLI),Independent,736,11,747,0.05,14 - Shimoga (Karnataka),10,14
13.0,D.S. ESHWARAPPA,Independent,687,8,695,0.05,14 - Shimoga (Karnataka),10,14
14.0,KUNAJE MANJUNATHA GOWDA,Independent,671,12,683,0.05,14 - Shimoga (Karnataka),10,14
15.0,S.K PRABHU,Karnataka Rashtra Samithi,611,6,617,0.04,14 - Shimoga (Karnataka),10,14
16.0,SHIVARUDRAIAH SWAMY,Independent,599,-,599,0.04,14 - Shimoga (Karnataka),10,14
17.0,IMTIYAZ A. ATTAR,Independent,440,2,442,0.03,14 - Shimoga (Karnataka),10,14
18.0,MOHAMMED YUSUF KHAN,Young Star Empowerment Party,403,1,404,0.03,14 - Shimoga (Karnataka),10,14
19.0,G. JAYADEVA,Independent,367,1,368,0.03,14 - Shimoga (Karnataka),10,14
20.0,CHANDRASHEKAR. H C,Independent,352,5,357,0.03,14 - Shimoga (Karnataka),10,14
21.0,P. SRIPATHI. BHAT,Independent,343,1,344,0.02,14 - Shimoga (Karnataka),10,14
22.0,SANDESH SHETTY. A,Independent,292,1,293,0.02,14 - Shimoga (Karnataka),10,14
23.0,H SURESH POOJARI,Independent,219,1,220,0.02,14 - Shimoga (Karnataka),10,14
24.0,NOTA,None of the Above,4311,21,4332,0.31,14 - Shimoga (Karnataka),10,14
,Total,,1372668,4556,1377224,,14 - Shimoga (Karnataka),10,14
1.0,KOTA SRINIVAS POOJARY,Bharatiya Janata Party,728219,4015,732234,59.56,15 - Udupi Chikmagalur (Karnataka),10,15
2.0,K. JAYAPRAKASH HEGDE,Indian National Congress,470769,2290,473059,38.48,15 - Udupi Chikmagalur (Karnataka),10,15
3.0,K.T. RADHAKRISHNA,Bahujan Samaj Party,5378,39,5417,0.44,15 - Udupi Chikmagalur (Karnataka),10,15
4.0,SUDHEER KANCHAN MARAKALA,Independent,2281,5,2286,0.19,15 - Udupi Chikmagalur (Karnataka),10,15
5.0,SACHIN B.K,Uttama Prajaakeeya Party,1299,34,1333,0.11,15 - Udupi Chikmagalur (Karnataka),10,15
6.0,M. K. DAYANANDA,Proutist Sarva Samaj,1049,20,1069,0.09,15 - Udupi Chikmagalur (Karnataka),10,15
7.0,VIJAY KUMAR M. G,Independent,943,13,956,0.08,15 - Udupi Chikmagalur (Karnataka),10,15
8.0,SUPREETH KUMAR POOJARY KATEEL,Janahitha Paksha,670,20,690,0.06,15 - Udupi Chikmagalur (Karnataka),10,15
9.0,SHABAREESH,Karunada Sevakara Party,560,5,565,0.05,15 - Udupi Chikmagalur (Karnataka),10,15
10.0,L. RANGANATH GOWDA,Karnataka Rashtra Samithi,536,4,540,0.04,15 - Udupi Chikmagalur (Karnataka),10,15
11.0,NOTA,None of the Above,11235,34,11269,0.92,15 - Udupi Chikmagalur (Karnataka),10,15
,Total,,1222939,6479,1229418,,15 - Udupi Chikmagalur (Karnataka),10,15
1.0,SHREYAS. M. PATEL,Indian National Congress,670274,2714,672988,49.67,16 - Hassan (Karnataka),10,16
2.0,PRAJWAL REVANNA,Janata Dal (Secular),626536,3803,630339,46.52,16 - Hassan (Karnataka),10,16
3.0,GANGADHAR BAHUJAN,Bahujan Samaj Party,12068,105,12173,0.9,16 - Hassan (Karnataka),10,16
4.0,DEVARAJ M.Y,Karnataka Rashtra Samithi,6033,24,6057,0.45,16 - Hassan (Karnataka),10,16
5.0,H D REVANNA,Purvanchal Mahapanchayat,4256,16,4272,0.32,16 - Hassan (Karnataka),10,16
6.0,BASAVARAJU J.D (EX-ARMY),Independent,3983,80,4063,0.3,16 - Hassan (Karnataka),10,16
7.0,SANTHOSH B.N,Independent,3444,5,3449,0.25,16 - Hassan (Karnataka),10,16
8.0,HEMANTH GAVEESH,Independent,3277,4,3281,0.24,16 - Hassan (Karnataka),10,16
9.0,PRATHAPA K.A,Uttama Prajaakeeya Party,3213,37,3250,0.24,16 - Hassan (Karnataka),10,16
10.0,S.K. NINGARAJA,Bahujan Bharat Party,1710,20,1730,0.13,16 - Hassan (Karnataka),10,16
11.0,B.N. SURESHA (SURESHGOWDA),Independent,1409,9,1418,0.1,16 - Hassan (Karnataka),10,16
12.0,SIDDABHOVI,Independent,940,47,987,0.07,16 - Hassan (Karnataka),10,16
13.0,SHIVARAJ. B,Republican Party of India Bharatha,843,5,848,0.06,16 - Hassan (Karnataka),10,16
14.0,R.G. SATHISHA RAMEDEVARAPURA,Independent,823,46,869,0.06,16 - Hassan (Karnataka),10,16
15.0,K.R. GANGADHARAPPA,Independent,734,8,742,0.05,16 - Hassan (Karnataka),10,16
16.0,NOTA,None of the Above,8470,71,8541,0.63,16 - Hassan (Karnataka),10,16
,Total,,1348013,6994,1355007,,16 - Hassan (Karnataka),10,16
1.0,CAPTAIN BRIJESH CHOWTA,Bharatiya Janata Party,760130,4002,764132,53.97,17 - Dakshina Kannada (Karnataka),10,17
2.0,PADMARAJ.R.POOJARY,Indian National Congress,612103,2821,614924,43.43,17 - Dakshina Kannada (Karnataka),10,17
3.0,KANTHAPPA ALANGAR,Bahujan Samaj Party,4202,30,4232,0.3,17 - Dakshina Kannada (Karnataka),10,17
4.0,DURGA PRASAD,Karunada Sevakara Party,2578,14,2592,0.18,17 - Dakshina Kannada (Karnataka),10,17
5.0,SUPREETH KUMAR POOJARY KATEEL,Independent,1884,17,1901,0.13,17 - Dakshina Kannada (Karnataka),10,17
6.0,MAXIM PINTO,Independent,1654,36,1690,0.12,17 - Dakshina Kannada (Karnataka),10,17
7.0,PRAJAAKEEYA MANOHARA,Uttama Prajaakeeya Party,964,7,971,0.07,17 - Dakshina Kannada (Karnataka),10,17
8.0,DEEPAK RAJESH COELHO,Independent,950,26,976,0.07,17 - Dakshina Kannada (Karnataka),10,17
9.0,RANJINI. M,Karnataka Rashtra Samithi,758,18,776,0.05,17 - Dakshina Kannada (Karnataka),10,17
10.0,NOTA,None of the Above,23515,61,23576,1.67,17 - Dakshina Kannada (Karnataka),10,17
,Total,,1408738,7032,1415770,,17 - Dakshina Kannada (Karnataka),10,17
1.0,GOVIND MAKTHAPPA KARJOL,Bharatiya Janata Party,681217,3673,684890,50.11,18 - Chitradurga (Karnataka),10,18
2.0,B.N.CHANDRAPPA,Indian National Congress,634152,2617,636769,46.58,18 - Chitradurga (Karnataka),10,18
3.0,ASHOKA CHAKRAVARTHI,Bahujan Samaj Party,7679,26,7705,0.56,18 - Chitradurga (Karnataka),10,18
4.0,NARASIMHARAJU. C.N.,Karnataka Rashtra Samithi,4932,18,4950,0.36,18 - Chitradurga (Karnataka),10,18
5.0,SRINIVASAPURADA SRINIVASABABU PAVAGADA,Independent,4539,9,4548,0.33,18 - Chitradurga (Karnataka),10,18
6.0,"B. VENKATESHA, SHILPI",Independent,4196,5,4201,0.31,18 - Chitradurga (Karnataka),10,18
7.0,MANJUNATHA SWAMY T,Independent,2652,24,2676,0.2,18 - Chitradurga (Karnataka),10,18
8.0,BHUTHARAJA. V.S.,Independent,2386,11,2397,0.18,18 - Chitradurga (Karnataka),10,18
9.0,RAGHU KUMAR .S,Independent,2318,19,2337,0.17,18 - Chitradurga (Karnataka),10,18
10.0,RAMESH NAIK .T.,Uttama Prajaakeeya Party,2187,19,2206,0.16,18 - Chitradurga (Karnataka),10,18
11.0,NAGARAJAPPA,Independent,1674,5,1679,0.12,18 - Chitradurga (Karnataka),10,18
12.0,K NARASHIMAMURTHY,Independent,1385,12,1397,0.1,18 - Chitradurga (Karnataka),10,18
13.0,SUDHAKARA .R,Independent,1201,10,1211,0.09,18 - Chitradurga (Karnataka),10,18
14.0,TULASI.H,Independent,1065,17,1082,0.08,18 - Chitradurga (Karnataka),10,18
15.0,GANESH.,Independent,1048,45,1093,0.08,18 - Chitradurga (Karnataka),10,18
16.0,SHABAREESH.,Karunada Sevakara Party,1014,4,1018,0.07,18 - Chitradurga (Karnataka),10,18
17.0,SUJATHA .D.,Socialist Unity Centre Of India (COMMUNIST),996,18,1014,0.07,18 - Chitradurga (Karnataka),10,18
18.0,DR M.P. DARAKESWARAIAH,Independent,982,10,992,0.07,18 - Chitradurga (Karnataka),10,18
19.0,AMRUTH RAJA.,Independent,804,30,834,0.06,18 - Chitradurga (Karnataka),10,18
20.0,B.T. RAMASUBBAIAH,Indian Movement Party,718,2,720,0.05,18 - Chitradurga (Karnataka),10,18
21.0,NOTA,None of the Above,3156,34,3190,0.23,18 - Chitradurga (Karnataka),10,18
,Total,,1360301,6608,1366909,,18 - Chitradurga (Karnataka),10,18
1.0,V. SOMANNA,Bharatiya Janata Party,716709,4237,720946,55.31,19 - Tumkur (Karnataka),10,19
2.0,S.P. MUDDAHANUMEGOWDA,Indian National Congress,543064,2288,545352,41.84,19 - Tumkur (Karnataka),10,19
3.0,J.K. SAMI,Independent,6761,14,6775,0.52,19 - Tumkur (Karnataka),10,19
4.0,RAJASIMHA J. N.,Bahujan Samaj Party,5521,33,5554,0.43,19 - Tumkur (Karnataka),10,19
5.0,S.N. SWAMY,Socialist Unity Centre Of India (COMMUNIST),4582,9,4591,0.35,19 - Tumkur (Karnataka),10,19
6.0,RANGANATHA. R.S,Independent,3129,3,3132,0.24,19 - Tumkur (Karnataka),10,19
7.0,MALLIKARJUNAIAH,Independent,1872,8,1880,0.14,19 - Tumkur (Karnataka),10,19
8.0,SIDDARAMEGOWDA T. B,Independent,1644,2,1646,0.13,19 - Tumkur (Karnataka),10,19
9.0,PRADEEP KUMAR DODDAMUDDEGOWDA,Karnataka Rashtra Samithi,1606,12,1618,0.12,19 - Tumkur (Karnataka),10,19
10.0,H.L. MOHAN KUMAR,Independent,890,3,893,0.07,19 - Tumkur (Karnataka),10,19
11.0,PRAKASH. R.A. JAIN,Independent,859,4,863,0.07,19 - Tumkur (Karnataka),10,19
12.0,NEELAKANTESHA. H S,Independent,710,9,719,0.06,19 - Tumkur (Karnataka),10,19
13.0,R. PUSHPA,Independent,622,7,629,0.05,19 - Tumkur (Karnataka),10,19
14.0,B. DEVARAJ,Independent,491,8,499,0.04,19 - Tumkur (Karnataka),10,19
15.0,R. NARAYANAPPA,Independent,483,24,507,0.04,19 - Tumkur (Karnataka),10,19
16.0,DR. H.B.M. HIREMATH,Kannada Paksha,477,-,477,0.04,19 - Tumkur (Karnataka),10,19
17.0,KAPANIGOWDA.,Independent,451,20,471,0.04,19 - Tumkur (Karnataka),10,19
18.0,BASAVARAJU. H.R,National Maha Sabha Party,433,6,439,0.03,19 - Tumkur (Karnataka),10,19
19.0,NOTA,None of the Above,6426,34,6460,0.5,19 - Tumkur (Karnataka),10,19
,Total,,1296730,6721,1303451,,19 - Tumkur (Karnataka),10,19
1.0,H.D. KUMARASWAMY,Janata Dal (Secular),847482,4399,851881,58.34,20 - Mandya (Karnataka),10,20
2.0,VENKATARAMANE GOWDA (STAR CHANDRU),Indian National Congress,564778,2483,567261,38.85,20 - Mandya (Karnataka),10,20
3.0,CHANDAN GOWDA. K,Independent,12310,84,12394,0.85,20 - Mandya (Karnataka),10,20
4.0,SHIVASHANKARA. S,Bahujan Samaj Party,6903,61,6964,0.48,20 - Mandya (Karnataka),10,20
5.0,RAMAIAH. D,Independent,3796,14,3810,0.26,20 - Mandya (Karnataka),10,20
6.0,RANJITHA. N,Independent,2897,12,2909,0.2,20 - Mandya (Karnataka),10,20
7.0,CHANDRASHEKARA. K.R (CHANDRU KEELARA),Karnataka Rashtra Samithi,1465,11,1476,0.1,20 - Mandya (Karnataka),10,20
8.0,BUDAYYA. B.P,Karunaadu Party,1358,12,1370,0.09,20 - Mandya (Karnataka),10,20
9.0,LOKESHA. S (AARYA LOKESH),Uttama Prajaakeeya Party,1151,12,1163,0.08,20 - Mandya (Karnataka),10,20
10.0,BEERESH. C.T (SAINIKA BEERESH),Independent,919,12,931,0.06,20 - Mandya (Karnataka),10,20
11.0,N.BASAVARAJU,Independent,802,41,843,0.06,20 - Mandya (Karnataka),10,20
12.0,H.D. REVANNA,Purvanchal Mahapanchayat,584,6,590,0.04,20 - Mandya (Karnataka),10,20
13.0,CHANNAMAYIGOWDA,Independent,496,1,497,0.03,20 - Mandya (Karnataka),10,20
14.0,S.ARVIND,Independent,440,2,442,0.03,20 - Mandya (Karnataka),10,20
15.0,NOTA,None of the Above,7706,30,7736,0.53,20 - Mandya (Karnataka),10,20
,Total,,1453087,7180,1460267,,20 - Mandya (Karnataka),10,20
1.0,YADUVEER KRISHNADATTA CHAMARAJA WADIYAR,Bharatiya Janata Party,790391,5112,795503,53.59,21 - Mysore (Karnataka),10,21
2.0,M. LAKSHMANA,Indian National Congress,653739,2502,656241,44.21,21 - Mysore (Karnataka),10,21
3.0,RANGASWAMY. M,Independent,4301,5,4306,0.29,21 - Mysore (Karnataka),10,21
4.0,KADAMBA NAA AMBARISH,Karnataka Jantha Paksha,4069,11,4080,0.27,21 - Mysore (Karnataka),10,21
5.0,A. S. SATHISH,Independent,3736,10,3746,0.25,21 - Mysore (Karnataka),10,21
6.0,RAMAMURTHY. M,Independent,3601,4,3605,0.24,21 - Mysore (Karnataka),10,21
7.0,RAJU,Independent,1940,9,1949,0.13,21 - Mysore (Karnataka),10,21
8.0,PRAJAKEEYA LEELA SHIVAKUMAR,Uttama Prajaakeeya Party,1724,30,1754,0.12,21 - Mysore (Karnataka),10,21
9.0,COMRADE SUNIL T. R,Socialist Unity Centre Of India (COMMUNIST),1538,22,1560,0.11,21 - Mysore (Karnataka),10,21
10.0,H. K. KRISHNA,Karunaadu Party,1479,10,1489,0.1,21 - Mysore (Karnataka),10,21
11.0,HARISH GOWDA,Socialist Party (India),967,9,976,0.07,21 - Mysore (Karnataka),10,21
12.0,P. S. YADURAPPA,Independent,874,4,878,0.06,21 - Mysore (Karnataka),10,21
13.0,AMBEDKAR. C. J,Independent,821,14,835,0.06,21 - Mysore (Karnataka),10,21
14.0,DARSHAN K PONNETI,Independent,761,3,764,0.05,21 - Mysore (Karnataka),10,21
15.0,M. S. PRAVEEN,Karnataka Rashtra Samithi,735,5,740,0.05,21 - Mysore (Karnataka),10,21
16.0,CHRISTOPHER RAJ KUMAR,Independent,533,11,544,0.04,21 - Mysore (Karnataka),10,21
17.0,DR. H. M. NANJUNDASWAMY,Samajwadi Janata Party(Karnataka),519,4,523,0.04,21 - Mysore (Karnataka),10,21
18.0,A. G. RAMACHANDRA RAO,Secular Democratic Congress,487,3,490,0.03,21 - Mysore (Karnataka),10,21
19.0,NOTA,None of the Above,4446,44,4490,0.3,21 - Mysore (Karnataka),10,21
,Total,,1476661,7812,1484473,,21 - Mysore (Karnataka),10,21
1.0,SUNIL BOSE,Indian National Congress,749926,1745,751671,54.87,22 - Chamarajanagar (Karnataka),10,22
2.0,BALARAJ.S,Bharatiya Janata Party,561056,1909,562965,41.1,22 - Chamarajanagar (Karnataka),10,22
3.0,M.KRISHNA MURTHY,Bahujan Samaj Party,15819,84,15903,1.16,22 - Chamarajanagar (Karnataka),10,22
4.0,C.M.KRISHNA,Dr. Ambedkar People's Party,8074,15,8089,0.59,22 - Chamarajanagar (Karnataka),10,22
5.0,G.D.RAJAGOPAL (H.D.KOTE),Independent,3949,5,3954,0.29,22 - Chamarajanagar (Karnataka),10,22
6.0,SUMA.S,Socialist Unity Centre Of India (COMMUNIST),3821,5,3826,0.28,22 - Chamarajanagar (Karnataka),10,22
7.0,MAHADEVASWAMY B M (PAMPI),Independent,3414,7,3421,0.25,22 - Chamarajanagar (Karnataka),10,22
8.0,H.K.SWAMY HARADANAHALLI,Independent,3206,2,3208,0.23,22 - Chamarajanagar (Karnataka),10,22
9.0,PATAS PRADEEP KUMAR.M,Independent,1969,17,1986,0.14,22 - Chamarajanagar (Karnataka),10,22
10.0,KADAMBA. NAA. AMBARISH,Independent,1738,5,1743,0.13,22 - Chamarajanagar (Karnataka),10,22
11.0,NINGARAJU.S,Karnataka Jantha Paksha,1406,5,1411,0.1,22 - Chamarajanagar (Karnataka),10,22
12.0,KANDALLI MAHESH,Karnataka Rashtra Samithi,1249,3,1252,0.09,22 - Chamarajanagar (Karnataka),10,22
13.0,NINGARAJ.G,Independent,1236,11,1247,0.09,22 - Chamarajanagar (Karnataka),10,22
14.0,PRASANNA KUMAR.B,Karnataka Praja Party (RaithaParva),972,6,978,0.07,22 - Chamarajanagar (Karnataka),10,22
15.0,NOTA,None of the Above,8094,49,8143,0.59,22 - Chamarajanagar (Karnataka),10,22
,Total,,1365929,3868,1369797,,22 - Chamarajanagar (Karnataka),10,22
1.0,DR C N MANJUNATH,Bharatiya Janata Party,1075553,3449,1079002,56.21,23 - Bangalore Rural (Karnataka),10,23
2.0,D K SURESH,Indian National Congress,807459,1896,809355,42.16,23 - Bangalore Rural (Karnataka),10,23
3.0,ABHISHEK K,Uttama Prajaakeeya Party,6191,11,6202,0.32,23 - Bangalore Rural (Karnataka),10,23
4.0,SURESH M N,Independent,3231,5,3236,0.17,23 - Bangalore Rural (Karnataka),10,23
5.0,HEMAVATHI K,Socialist Unity Centre Of India (COMMUNIST),1768,6,1774,0.09,23 - Bangalore Rural (Karnataka),10,23
6.0,J T PRAKASH,Independent,1468,4,1472,0.08,23 - Bangalore Rural (Karnataka),10,23
7.0,N KRISHNAPPA,Pyramid Party of India,1396,6,1402,0.07,23 - Bangalore Rural (Karnataka),10,23
8.0,C N MANJUNATHA,Bahujan Bharat Party,1350,50,1400,0.07,23 - Bangalore Rural (Karnataka),10,23
9.0,KUMAR L,Bharatiya Prajagala Kalyana Paksha,1052,14,1066,0.06,23 - Bangalore Rural (Karnataka),10,23
10.0,MAHAMAD MUSADIK PASHA,Karnataka Rashtra Samithi,817,4,821,0.04,23 - Bangalore Rural (Karnataka),10,23
11.0,NARASIMHAMURTHY J P,Independent,809,4,813,0.04,23 - Bangalore Rural (Karnataka),10,23
12.0,SURESH S,Karunaadu Party,792,6,798,0.04,23 - Bangalore Rural (Karnataka),10,23
13.0,VASIST J,Country Citizen Party,546,38,584,0.03,23 - Bangalore Rural (Karnataka),10,23
14.0,MOHAMMAD DASTAGEER,Young Star Empowerment Party,486,-,486,0.03,23 - Bangalore Rural (Karnataka),10,23
15.0,H V CHANDRASHEKAR,Viduthalai Chiruthaigal Katchi,473,7,480,0.03,23 - Bangalore Rural (Karnataka),10,23
16.0,NOTA,None of the Above,10633,16,10649,0.55,23 - Bangalore Rural (Karnataka),10,23
,Total,,1914024,5516,1919540,,23 - Bangalore Rural (Karnataka),10,23
1.0,SHOBHA KARANDLAJE,Bharatiya Janata Party,982805,3244,986049,56.27,24 - Bangalore North (Karnataka),10,24
2.0,PROFESSOR M.V RAJEEV GOWDA,Indian National Congress,725190,1383,726573,41.46,24 - Bangalore North (Karnataka),10,24
3.0,GOVINDAIAH,Bahujan Samaj Party,4614,17,4631,0.26,24 - Bangalore North (Karnataka),10,24
4.0,SANTHOSH M,Uttama Prajaakeeya Party,3450,11,3461,0.2,24 - Bangalore North (Karnataka),10,24
5.0,UDAYA SHANKAR.G,Prahar Janshakti Party,2676,2,2678,0.15,24 - Bangalore North (Karnataka),10,24
6.0,LAKSHMI SRIHARI.J.N.,Independent,2091,3,2094,0.12,24 - Bangalore North (Karnataka),10,24
7.0,DILIP KUMAR I.S.,Independent,1896,7,1903,0.11,24 - Bangalore North (Karnataka),10,24
8.0,K.M.MAHADEVA,Independent,1716,4,1720,0.1,24 - Bangalore North (Karnataka),10,24
9.0,K.V.NANJUNDASWAMY,Independent,1363,2,1365,0.08,24 - Bangalore North (Karnataka),10,24
10.0,SHOBHA,Independent,1272,8,1280,0.07,24 - Bangalore North (Karnataka),10,24
11.0,Y.R.KALLESHWARI,Samajwadi Janata Party(Karnataka),1072,5,1077,0.06,24 - Bangalore North (Karnataka),10,24
12.0,NIRMALA H.L,Socialist Unity Centre Of India (COMMUNIST),972,5,977,0.06,24 - Bangalore North (Karnataka),10,24
13.0,H.R.NATARAJ,Independent,857,4,861,0.05,24 - Bangalore North (Karnataka),10,24
14.0,BHASKAR ANKALAMADUGU SHIVAREDDY,Independent,831,-,831,0.05,24 - Bangalore North (Karnataka),10,24
15.0,SHIVAKUMAR. B,Karnataka Rashtra Samithi,813,4,817,0.05,24 - Bangalore North (Karnataka),10,24
16.0,SUDHA. V,Independent,650,7,657,0.04,24 - Bangalore North (Karnataka),10,24
17.0,KRISHNAIAH,Rashtriya Samaj Dal (R),556,3,559,0.03,24 - Bangalore North (Karnataka),10,24
18.0,HEBBAL VENKATESH.J,Republican Party of India (A),422,3,425,0.02,24 - Bangalore North (Karnataka),10,24
19.0,"GLOBE STAR J. JAI SIMHA VARMA, B E.",Gareeb Aadmi Party,356,3,359,0.02,24 - Bangalore North (Karnataka),10,24
20.0,SHOBAN BABU V,Indian Labour Party (Ambedkar Phule),315,5,320,0.02,24 - Bangalore North (Karnataka),10,24
21.0,PARASAPPA BHEEMAPPA GAJJERI,Rani Chennamma Party,313,-,313,0.02,24 - Bangalore North (Karnataka),10,24
22.0,NOTA,None of the Above,13499,55,13554,0.77,24 - Bangalore North (Karnataka),10,24
,Total,,1747729,4775,1752504,,24 - Bangalore North (Karnataka),10,24
1.0,P C MOHAN,Bharatiya Janata Party,657236,1679,658915,50.05,25 - Bangalore central (Karnataka),10,25
2.0,MANSOOR ALI KHAN,Indian National Congress,625368,840,626208,47.57,25 - Bangalore central (Karnataka),10,25
3.0,SATISH CHANDRA. M.,Bahujan Samaj Party,3071,16,3087,0.23,25 - Bangalore central (Karnataka),10,25
4.0,JAYALAKSHMI SUNDARA RAJAN,Independent,2755,6,2761,0.21,25 - Bangalore central (Karnataka),10,25
5.0,SURESH BABU. M. C,Uttama Prajaakeeya Party,1735,4,1739,0.13,25 - Bangalore central (Karnataka),10,25
6.0,K. MANJUNATHA,Independent,1552,4,1556,0.12,25 - Bangalore central (Karnataka),10,25
7.0,S. M. KRISHNA,Independent,1466,8,1474,0.11,25 - Bangalore central (Karnataka),10,25
8.0,MURUGESH. R,Independent,1162,-,1162,0.09,25 - Bangalore central (Karnataka),10,25
9.0,UMA. V.,Independent,820,7,827,0.06,25 - Bangalore central (Karnataka),10,25
10.0,PRAKASH. K,Karnataka Rashtra Samithi,766,13,779,0.06,25 - Bangalore central (Karnataka),10,25
11.0,H. P. SHIVAPRAKASH,Socialist Unity Centre Of India (COMMUNIST),700,7,707,0.05,25 - Bangalore central (Karnataka),10,25
12.0,MODI SAIFULLA,Independent,688,7,695,0.05,25 - Bangalore central (Karnataka),10,25
13.0,ABHAYA SHEELA.,Rashtriya Samaj Dal (R),625,10,635,0.05,25 - Bangalore central (Karnataka),10,25
14.0,KARTHIK. K,Voters Independent Party,594,7,601,0.05,25 - Bangalore central (Karnataka),10,25
15.0,T.R. JAGANNATHA RAO,Bharatiya Prajagala Kalyana Paksha,456,4,460,0.03,25 - Bangalore central (Karnataka),10,25
16.0,VASANTH KUMAR ERAPPA,Independent,439,-,439,0.03,25 - Bangalore central (Karnataka),10,25
17.0,C.M. SHABAZ KHAN,Young Star Empowerment Party,428,1,429,0.03,25 - Bangalore central (Karnataka),10,25
18.0,WHITEFIELD MURUGESH .C,Republican Party of India (Karnataka),376,2,378,0.03,25 - Bangalore central (Karnataka),10,25
19.0,B. KRISHNA PRASAD,"Proutist Bloc, India",324,3,327,0.02,25 - Bangalore central (Karnataka),10,25
20.0,MUKTHAR ALI KHAN,Karnataka Karmikara Paksha,314,-,314,0.02,25 - Bangalore central (Karnataka),10,25
21.0,SYED ASIF BUKHARI,Independent,286,-,286,0.02,25 - Bangalore central (Karnataka),10,25
22.0,RANJITH VISHWA,Samajwadi Janata Party(Karnataka),270,4,274,0.02,25 - Bangalore central (Karnataka),10,25
23.0,RUMAN SHARIFFE,Independent,170,1,171,0.01,25 - Bangalore central (Karnataka),10,25
24.0,YALLAPPA.,Independent,158,2,160,0.01,25 - Bangalore central (Karnataka),10,25
25.0,NOTA,None of the Above,12103,23,12126,0.92,25 - Bangalore central (Karnataka),10,25
,Total,,1313862,2648,1316510,,25 - Bangalore central (Karnataka),10,25
1.0,TEJASVI SURYA,Bharatiya Janata Party,747780,3050,750830,60.1,26 - Bangalore South (Karnataka),10,26
2.0,SOWMYA REDDY,Indian National Congress,472754,993,473747,37.92,26 - Bangalore South (Karnataka),10,26
3.0,ARUN PRASAD.A,Bahujan Samaj Party,2416,9,2425,0.19,26 - Bangalore South (Karnataka),10,26
4.0,TINTISHA HEMACHANDRA SAGAR,Independent,1962,6,1968,0.16,26 - Bangalore South (Karnataka),10,26
5.0,VATAL NAGARAJ,Kannada Chalavali Vatal Paksha,1857,10,1867,0.15,26 - Bangalore South (Karnataka),10,26
6.0,KEMPEGOWDA,Navabharath Sena,1390,3,1393,0.11,26 - Bangalore South (Karnataka),10,26
7.0,TEJASWINI DHANANJAY,Independent,1147,3,1150,0.09,26 - Bangalore South (Karnataka),10,26
8.0,BALAKRISHNA.M.,Uttama Prajaakeeya Party,1106,4,1110,0.09,26 - Bangalore South (Karnataka),10,26
9.0,JAYAPAL.D,Independent,940,2,942,0.08,26 - Bangalore South (Karnataka),10,26
10.0,RANJITH GOWDA,Independent,859,1,860,0.07,26 - Bangalore South (Karnataka),10,26
11.0,V.RAJKUMAR VCK,Independent,738,2,740,0.06,26 - Bangalore South (Karnataka),10,26
12.0,RAGHUPATHI BHAT,Karnataka Rashtra Samithi,737,1,738,0.06,26 - Bangalore South (Karnataka),10,26
13.0,DR HARISH GOWDA,Independent,555,8,563,0.05,26 - Bangalore South (Karnataka),10,26
14.0,CHETAN CHAMAN,Country Citizen Party,490,2,492,0.04,26 - Bangalore South (Karnataka),10,26
15.0,A . RAJ.,Independent,473,4,477,0.04,26 - Bangalore South (Karnataka),10,26
16.0,K. C. JANARDHAN,Independent,444,8,452,0.04,26 - Bangalore South (Karnataka),10,26
17.0,KANTHAKUMAR.R.,Independent,393,10,403,0.03,26 - Bangalore South (Karnataka),10,26
18.0,KARAVALI MANJUNATH. BE,Rashtriya Samaj Dal (R),308,2,310,0.02,26 - Bangalore South (Karnataka),10,26
19.0,C M. SHABAZ KHAN,Young Star Empowerment Party,295,2,297,0.02,26 - Bangalore South (Karnataka),10,26
20.0,ASGAR A MOHIN.S.M.,Independent,266,3,269,0.02,26 - Bangalore South (Karnataka),10,26
21.0,SUBRAHMANYA KUMAR KUNTIKANAMATA,Independent,234,3,237,0.02,26 - Bangalore South (Karnataka),10,26
22.0,DR.R.SHEKAR THIRUMAVALVAN,Independent,214,1,215,0.02,26 - Bangalore South (Karnataka),10,26
23.0,NOTA,None of the Above,7830,27,7857,0.63,26 - Bangalore South (Karnataka),10,26
,Total,,1245188,4154,1249342,,26 - Bangalore South (Karnataka),10,26
1.0,DR.K.SUDHAKAR,Bharatiya Janata Party,819588,3031,822619,53.74,27 - Chikkballapur (Karnataka),10,27
2.0,M.S. RAKSHA RAMAIAH,Indian National Congress,657489,1670,659159,43.06,27 - Chikkballapur (Karnataka),10,27
3.0,MUNIVENKATAPPA M.P,Communist Party of India (Marxist),4546,11,4557,0.3,27 - Chikkballapur (Karnataka),10,27
4.0,MAHADEV. P,Bahujan Samaj Party,4428,12,4440,0.29,27 - Chikkballapur (Karnataka),10,27
5.0,RAJANNA,Independent,3759,5,3764,0.25,27 - Chikkballapur (Karnataka),10,27
6.0,RAJA REDDY,Independent,3377,4,3381,0.22,27 - Chikkballapur (Karnataka),10,27
7.0,KALAVATHI. N,Socialist Unity Centre Of India (COMMUNIST),2736,8,2744,0.18,27 - Chikkballapur (Karnataka),10,27
8.0,VALASAPALLI UTAPPA,Independent,2152,10,2162,0.14,27 - Chikkballapur (Karnataka),10,27
9.0,VENKATESHMURTHY.V,Uttama Prajaakeeya Party,2015,5,2020,0.13,27 - Chikkballapur (Karnataka),10,27
10.0,D. SUDHAKARA,Independent,1678,11,1689,0.11,27 - Chikkballapur (Karnataka),10,27
11.0,SUDHAKAR. N,Independent,1581,10,1591,0.1,27 - Chikkballapur (Karnataka),10,27
12.0,G N RAVI,Independent,1462,3,1465,0.1,27 - Chikkballapur (Karnataka),10,27
13.0,BHASKAR ANKALAMADUGU SHIVAREDDY,Independent,1363,4,1367,0.09,27 - Chikkballapur (Karnataka),10,27
14.0,CHANDRASHEKAR. H.C,Independent,1270,12,1282,0.08,27 - Chikkballapur (Karnataka),10,27
15.0,MOHITH NARASIMHAMURTHY,Independent,1222,7,1229,0.08,27 - Chikkballapur (Karnataka),10,27
16.0,V.N. NARASIMHAMURTHY VADIGERE,Independent,1212,6,1218,0.08,27 - Chikkballapur (Karnataka),10,27
17.0,G.N. VENKATESH B.A.L.L.B,Independent,1199,8,1207,0.08,27 - Chikkballapur (Karnataka),10,27
18.0,DEVARAJ CORONA WARRIOR,Independent,1168,9,1177,0.08,27 - Chikkballapur (Karnataka),10,27
19.0,G SUBRAMANI SHETTY,Karnataka Rashtra Samithi,869,3,872,0.06,27 - Chikkballapur (Karnataka),10,27
20.0,DR. M.R. RANGANATHA,Independent,850,7,857,0.06,27 - Chikkballapur (Karnataka),10,27
21.0,NAGESH. S,Digvijaya Bharatha Party,843,7,850,0.06,27 - Chikkballapur (Karnataka),10,27
22.0,T.R. NARAYANA RAO,Indian Labour Party (Ambedkar Phule),757,5,762,0.05,27 - Chikkballapur (Karnataka),10,27
23.0,"C.V. LOKESH GOWDA, B.E",Independent,691,10,701,0.05,27 - Chikkballapur (Karnataka),10,27
24.0,D. CHINNAPPA,Independent,616,3,619,0.04,27 - Chikkballapur (Karnataka),10,27
25.0,SANDESH.G,Independent,588,6,594,0.04,27 - Chikkballapur (Karnataka),10,27
26.0,NASURULLA,Independent,579,4,583,0.04,27 - Chikkballapur (Karnataka),10,27
27.0,K. VENKATESH,Independent,469,5,474,0.03,27 - Chikkballapur (Karnataka),10,27
28.0,T VENKATA SIVUDU,Independent,434,6,440,0.03,27 - Chikkballapur (Karnataka),10,27
29.0,G N. KODANDAREDDY,Independent,399,2,401,0.03,27 - Chikkballapur (Karnataka),10,27
30.0,NOTA,None of the Above,6545,51,6596,0.43,27 - Chikkballapur (Karnataka),10,27
,Total,,1525885,4935,1530820,,27 - Chikkballapur (Karnataka),10,27
1.0,M. MALLESH BABU,Janata Dal (Secular),689185,2296,691481,51.02,28 - Kolar (Karnataka),10,28
2.0,K V GOWTHAM,Indian National Congress,618700,1393,620093,45.76,28 - Kolar (Karnataka),10,28
3.0,SUMAN H N,Independent,6484,3,6487,0.48,28 - Kolar (Karnataka),10,28
4.0,HOLUR SRINIVASA,Independent,6159,4,6163,0.45,28 - Kolar (Karnataka),10,28
5.0,S B SURESHA,Bahujan Samaj Party,4688,44,4732,0.35,28 - Kolar (Karnataka),10,28
6.0,K R DEVARAJA,Delhi Janta Party,4588,9,4597,0.34,28 - Kolar (Karnataka),10,28
7.0,DR M. VENKATASWAMY,Independent,3336,18,3354,0.25,28 - Kolar (Karnataka),10,28
8.0,R RANJITHKUMAR,Independent,2116,2,2118,0.16,28 - Kolar (Karnataka),10,28
9.0,S N NARAYANASWAMY V,Independent,1971,14,1985,0.15,28 - Kolar (Karnataka),10,28
10.0,D GOPALAKRISHNA,Socialist Party (India),1661,8,1669,0.12,28 - Kolar (Karnataka),10,28
11.0,DEVARAJA A ALUSURUDINNE,Uttama Prajaakeeya Party,1343,11,1354,0.1,28 - Kolar (Karnataka),10,28
12.0,M S BADARINARAYANA,Independent,1104,12,1116,0.08,28 - Kolar (Karnataka),10,28
13.0,MAHESH A V,Karnataka Rashtra Samithi,1035,30,1065,0.08,28 - Kolar (Karnataka),10,28
14.0,THIMMARAYAPPA,Republican Party of India (Karnataka),856,8,864,0.06,28 - Kolar (Karnataka),10,28
15.0,R RAJENDRA,Independent,750,1,751,0.06,28 - Kolar (Karnataka),10,28
16.0,M MUNIGANGAPPA,Independent,595,9,604,0.04,28 - Kolar (Karnataka),10,28
17.0,M C HALLI VENU,Viduthalai Chiruthaigal Katchi,514,7,521,0.04,28 - Kolar (Karnataka),10,28
18.0,KRISHNAIAH N,Independent,438,5,443,0.03,28 - Kolar (Karnataka),10,28
19.0,NOTA,None of the Above,5798,33,5831,0.43,28 - Kolar (Karnataka),10,28
,Total,,1351321,3907,1355228,,28 - Kolar (Karnataka),10,28
1.0,RAJMOHAN UNNITHAN,Indian National Congress,487637,3022,490659,44.1,1 - Kasaragod (Kerala),11,1
2.0,M.V BALAKRISHNAN MASTER,Communist Party of India (Marxist),385969,4041,390010,35.06,1 - Kasaragod (Kerala),11,1
3.0,M.L ASHWINI,Bharatiya Janata Party,217996,1562,219558,19.73,1 - Kasaragod (Kerala),11,1
4.0,SUKUMARI M,Bahujan Samaj Party,1599,13,1612,0.14,1 - Kasaragod (Kerala),11,1
5.0,RAJESWARI K.R,Independent,886,11,897,0.08,1 - Kasaragod (Kerala),11,1
6.0,MANOHARAN K,Independent,777,27,804,0.07,1 - Kasaragod (Kerala),11,1
7.0,ANEESH PAYYANNUR,Independent,744,15,759,0.07,1 - Kasaragod (Kerala),11,1
8.0,BALAKRISHNAN N,Independent,594,34,628,0.06,1 - Kasaragod (Kerala),11,1
9.0,N KESHAVA NAYAK,Independent,480,27,507,0.05,1 - Kasaragod (Kerala),11,1
10.0,NOTA,None of the Above,7037,75,7112,0.64,1 - Kasaragod (Kerala),11,1
,Total,,1103719,8827,1112546,,1 - Kasaragod (Kerala),11,1
1.0,K. SUDHAKARAN,Indian National Congress,512266,6258,518524,48.74,2 - Kannur (Kerala),11,2
2.0,M.V. JAYARAJAN,Communist Party of India (Marxist),402614,6928,409542,38.5,2 - Kannur (Kerala),11,2
3.0,C. RAGHUNATH,Bharatiya Janata Party,118352,1524,119876,11.27,2 - Kannur (Kerala),11,2
4.0,RAMACHANDRAN BAVILEERI,Bharatheeya Jawan Kisan Party,2606,43,2649,0.25,2 - Kannur (Kerala),11,2
5.0,K. SUDHAKARAN S/O. KRISHNAN,Independent,990,19,1009,0.09,2 - Kannur (Kerala),11,2
6.0,SUDHAKARAN. K S/O. P GOPALAN,Independent,893,3,896,0.08,2 - Kannur (Kerala),11,2
7.0,JOY JOHN PATTAR MADATHIL,Independent,616,2,618,0.06,2 - Kannur (Kerala),11,2
8.0,JAYARAJ,Independent,478,10,488,0.05,2 - Kannur (Kerala),11,2
9.0,JAYARAJAN S/O. VELAYUDHAN,Independent,421,4,425,0.04,2 - Kannur (Kerala),11,2
10.0,VADI HAREENDRAN,Independent,289,54,343,0.03,2 - Kannur (Kerala),11,2
11.0,C. BALAKRISHNAN YADAV,Independent,279,25,304,0.03,2 - Kannur (Kerala),11,2
12.0,NARAYANA KUMAR,Independent,263,45,308,0.03,2 - Kannur (Kerala),11,2
13.0,NOTA,None of the Above,8718,155,8873,0.83,2 - Kannur (Kerala),11,2
,Total,,1048785,15070,1063855,,2 - Kannur (Kerala),11,2
1.0,SHAFI PARAMBIL,Indian National Congress,552490,5038,557528,49.65,3 - Vadakara (Kerala),11,3
2.0,K K SHAILAJA TEACHER,Communist Party of India (Marxist),437333,5689,443022,39.45,3 - Vadakara (Kerala),11,3
3.0,PRAPHUL KRISHNAN,Bharatiya Janata Party,110701,1278,111979,9.97,3 - Vadakara (Kerala),11,3
4.0,SHAFI T P,Independent,3715,49,3764,0.34,3 - Vadakara (Kerala),11,3
5.0,K K SHYLAJA,Independent,1164,15,1179,0.1,3 - Vadakara (Kerala),11,3
6.0,KUNHIKANNAN PAYYOLI,Independent,867,2,869,0.08,3 - Vadakara (Kerala),11,3
7.0,SHYLAJA,Independent,661,19,680,0.06,3 - Vadakara (Kerala),11,3
8.0,SHAFI,Independent,399,23,422,0.04,3 - Vadakara (Kerala),11,3
9.0,SYLAJA P,Independent,319,7,326,0.03,3 - Vadakara (Kerala),11,3
10.0,MURALIDHARAN,Independent,261,8,269,0.02,3 - Vadakara (Kerala),11,3
11.0,NOTA,None of the Above,2855,54,2909,0.26,3 - Vadakara (Kerala),11,3
,Total,,1110765,12182,1122947,,3 - Vadakara (Kerala),11,3
1.0,RAHUL GANDHI,Indian National Congress,642299,5146,647445,59.69,4 - Wayanad (Kerala),11,4
2.0,ANNIE RAJA,Communist Party of India,280594,2429,283023,26.09,4 - Wayanad (Kerala),11,4
3.0,K SURENDRAN,Bharatiya Janata Party,139868,1177,141045,13.0,4 - Wayanad (Kerala),11,4
4.0,P.R KRISHNANKUTTY,Bahujan Samaj Party,1946,27,1973,0.18,4 - Wayanad (Kerala),11,4
5.0,SATHYAN K.P,Independent,1017,42,1059,0.1,4 - Wayanad (Kerala),11,4
6.0,SINOJ A.C,Independent,885,18,903,0.08,4 - Wayanad (Kerala),11,4
7.0,PRASEETHA AZHIKODE,Independent,814,26,840,0.08,4 - Wayanad (Kerala),11,4
8.0,AJEEB MUHAMMED,Independent,796,8,804,0.07,4 - Wayanad (Kerala),11,4
9.0,P RADHAKRISHNAN,Independent,555,7,562,0.05,4 - Wayanad (Kerala),11,4
10.0,NOTA,None of the Above,6932,67,6999,0.65,4 - Wayanad (Kerala),11,4
,Total,,1075706,8947,1084653,,4 - Wayanad (Kerala),11,4
1.0,M. K. RAGHAVAN,Indian National Congress,515608,4813,520421,47.74,5 - Kozhikode (Kerala),11,5
2.0,ELAMARAM KAREEM,Communist Party of India (Marxist),369884,4361,374245,34.33,5 - Kozhikode (Kerala),11,5
3.0,M. T. RAMESH,Bharatiya Janata Party,178692,1974,180666,16.57,5 - Kozhikode (Kerala),11,5
4.0,ARAMUKHAN,Bahujan Samaj Party,1684,31,1715,0.16,5 - Kozhikode (Kerala),11,5
5.0,ARAVINDAKSHAN NAIR M. K.,Bharatheeya Jawan Kisan Party,1290,15,1305,0.12,5 - Kozhikode (Kerala),11,5
6.0,RAGHAVAN S/O NARAYANAN NAIR,Independent,1057,39,1096,0.1,5 - Kozhikode (Kerala),11,5
7.0,T. RAGHAVAN S/O VELLANKUTTY,Independent,1009,9,1018,0.09,5 - Kozhikode (Kerala),11,5
8.0,N. RAGHAVAN S/O DAMU,Independent,753,29,782,0.07,5 - Kozhikode (Kerala),11,5
9.0,SUBHA,Independent,705,7,712,0.07,5 - Kozhikode (Kerala),11,5
10.0,DR. M. JYOTHIRAJ,Socialist Unity Centre Of India (COMMUNIST),641,12,653,0.06,5 - Kozhikode (Kerala),11,5
11.0,ABDUL KAREEM S/O MAHAMMOOD,Independent,536,5,541,0.05,5 - Kozhikode (Kerala),11,5
12.0,ABDUL KAREEM S/O AYAMMATH KUTTY,Independent,285,2,287,0.03,5 - Kozhikode (Kerala),11,5
13.0,ABDUL KAREEM K. S/O ASSAIN,Independent,257,36,293,0.03,5 - Kozhikode (Kerala),11,5
14.0,NOTA,None of the Above,6236,80,6316,0.58,5 - Kozhikode (Kerala),11,5
,Total,,1078637,11413,1090050,,5 - Kozhikode (Kerala),11,5
1.0,E.T. MOHAMMED BASHEER,Indian Union Muslim League,640269,3737,644006,59.35,6 - Malappuram (Kerala),11,6
2.0,V. VASEEF,Communist Party of India (Marxist),341510,2378,343888,31.69,6 - Malappuram (Kerala),11,6
3.0,DR. ABDUL SALAM,Bharatiya Janata Party,84529,832,85361,7.87,6 - Malappuram (Kerala),11,6
4.0,T. KRISHNAN,Bahujan Samaj Party,1392,25,1417,0.13,6 - Malappuram (Kerala),11,6
5.0,P.C. NARAYANAN,Bahujan Dravida Party,1304,5,1309,0.12,6 - Malappuram (Kerala),11,6
6.0,NASEEF ALI MULLAPPALLI,Independent,1154,14,1168,0.11,6 - Malappuram (Kerala),11,6
7.0,ABDULSALAM S/O MUHAMMED HAJI,Independent,771,12,783,0.07,6 - Malappuram (Kerala),11,6
8.0,THRISSUR NAZEER,Independent,459,25,484,0.04,6 - Malappuram (Kerala),11,6
9.0,NOTA,None of the Above,6650,116,6766,0.62,6 - Malappuram (Kerala),11,6
,Total,,1078038,7144,1085182,,6 - Malappuram (Kerala),11,6
1.0,DR. M.P ABDUSSAMAD SAMADANI,Indian Union Muslim League,559570,2946,562516,54.81,7 - Ponnani (Kerala),11,7
2.0,K.S HAMZA,Communist Party of India (Marxist),324562,2194,326756,31.84,7 - Ponnani (Kerala),11,7
3.0,ADV. NIVEDIDA,Bharatiya Janata Party,123733,1065,124798,12.16,7 - Ponnani (Kerala),11,7
4.0,ABDUSSAMED MALAYAMPALLI,Independent,1634,19,1653,0.16,7 - Ponnani (Kerala),11,7
5.0,VINOD,Bahujan Samaj Party,1449,28,1477,0.14,7 - Ponnani (Kerala),11,7
6.0,HAMSA S/O MOIDUTTY,Independent,952,26,978,0.1,7 - Ponnani (Kerala),11,7
7.0,BINDHU W/O DEVARAJAN,Independent,826,21,847,0.08,7 - Ponnani (Kerala),11,7
8.0,HAMZA KADAVANDI,Independent,707,3,710,0.07,7 - Ponnani (Kerala),11,7
9.0,NOTA,None of the Above,6499,62,6561,0.64,7 - Ponnani (Kerala),11,7
,Total,,1019932,6364,1026296,,7 - Ponnani (Kerala),11,7
1.0,V K SREEKANDAN,Indian National Congress,418072,3097,421169,40.66,8 - Palakkad (Kerala),11,8
2.0,A VIJAYARAGHAVAN,Communist Party of India (Marxist),342798,3088,345886,33.39,8 - Palakkad (Kerala),11,8
3.0,C KRISHNAKUMAR,Bharatiya Janata Party,249568,2210,251778,24.31,8 - Palakkad (Kerala),11,8
4.0,K T PADMINI,Bahujan Samaj Party,2102,30,2132,0.21,8 - Palakkad (Kerala),11,8
5.0,ANNA KURIAKOSE,Independent,1416,17,1433,0.14,8 - Palakkad (Kerala),11,8
6.0,N S K PURAM SASIKUMAR,Independent,1151,26,1177,0.11,8 - Palakkad (Kerala),11,8
7.0,RAJESH K SON OF VELANKUTTY,Independent,1033,23,1056,0.1,8 - Palakkad (Kerala),11,8
8.0,RAJESH M SON OF MANI C,Independent,947,6,953,0.09,8 - Palakkad (Kerala),11,8
9.0,SIDHEEK IRUPPASSERY,Independent,913,26,939,0.09,8 - Palakkad (Kerala),11,8
10.0,C RAJAMANICKAM,Independent,516,4,520,0.05,8 - Palakkad (Kerala),11,8
11.0,NOTA,None of the Above,8724,69,8793,0.85,8 - Palakkad (Kerala),11,8
,Total,,1027240,8596,1035836,,8 - Palakkad (Kerala),11,8
1.0,K.RADHAKRISHNAN,Communist Party of India (Marxist),398818,4629,403447,40.66,9 - Alathur (Kerala),11,9
2.0,RAMYA HARIDAS,Indian National Congress,379231,4105,383336,38.63,9 - Alathur (Kerala),11,9
3.0,DR T N SARASU,Bharatiya Janata Party,186441,1789,188230,18.97,9 - Alathur (Kerala),11,9
4.0,HARI ARUMBIL,Bahujan Samaj Party,2835,36,2871,0.29,9 - Alathur (Kerala),11,9
5.0,KRISHNANKUTTY KUNISSERY,Independent,2323,28,2351,0.24,9 - Alathur (Kerala),11,9
6.0,NOTA,None of the Above,11918,115,12033,1.21,9 - Alathur (Kerala),11,9
,Total,,981566,10702,992268,,9 - Alathur (Kerala),11,9
1.0,SURESH GOPI,Bharatiya Janata Party,409302,3036,412338,37.8,10 - Thrissur (Kerala),11,10
2.0,ADV V S SUNILKUMAR,Communist Party of India,334462,3190,337652,30.95,10 - Thrissur (Kerala),11,10
3.0,K MURALEEDHARAN,Indian National Congress,324810,3314,328124,30.08,10 - Thrissur (Kerala),11,10
4.0,ADV P K NARAYANAN,Bahujan Samaj Party,1985,34,2019,0.19,10 - Thrissur (Kerala),11,10
5.0,SUNILKUMAR SON OF PRABHAKARAN,Independent,1930,22,1952,0.18,10 - Thrissur (Kerala),11,10
6.0,DIVAKARAN PALLATH,New Labour Party,812,7,819,0.08,10 - Thrissur (Kerala),11,10
7.0,M S JAFARGHAN,Independent,689,9,698,0.06,10 - Thrissur (Kerala),11,10
8.0,PRATHAPAN,Independent,685,24,709,0.06,10 - Thrissur (Kerala),11,10
9.0,JOSHI VILLADOM,Independent,460,33,493,0.05,10 - Thrissur (Kerala),11,10
10.0,NOTA,None of the Above,6046,26,6072,0.56,10 - Thrissur (Kerala),11,10
,Total,,1081181,9695,1090876,,10 - Thrissur (Kerala),11,10
1.0,BENNY BEHANAN,Indian National Congress,390216,3955,394171,41.44,11 - Chalakudy (Kerala),11,11
2.0,PROF C RAVEENDRANATH,Communist Party of India (Marxist),327382,3035,330417,34.73,11 - Chalakudy (Kerala),11,11
3.0,K A UNNIKRISHNAN,Bharath Dharma Jana Sena,105706,694,106400,11.18,11 - Chalakudy (Kerala),11,11
4.0,ADV CHARLY PAUL,Twenty 20 Party,105020,622,105642,11.11,11 - Chalakudy (Kerala),11,11
5.0,ROSILIN CHACKO,Bahujan Samaj Party,2377,33,2410,0.25,11 - Chalakudy (Kerala),11,11
6.0,BOSCO KALAMASSERY,Independent,1071,16,1087,0.11,11 - Chalakudy (Kerala),11,11
7.0,SUBRAN K R,Independent,789,10,799,0.08,11 - Chalakudy (Kerala),11,11
8.0,DR M PRADEEPAN,Socialist Unity Centre Of India (COMMUNIST),688,6,694,0.07,11 - Chalakudy (Kerala),11,11
9.0,ARUN EDATHADAN,Independent,662,24,686,0.07,11 - Chalakudy (Kerala),11,11
10.0,T S CHANDRAN,Independent,481,50,531,0.06,11 - Chalakudy (Kerala),11,11
11.0,JOHNSON K C,Independent,379,8,387,0.04,11 - Chalakudy (Kerala),11,11
12.0,NOTA,None of the Above,8021,42,8063,0.85,11 - Chalakudy (Kerala),11,11
,Total,,942792,8495,951287,,11 - Chalakudy (Kerala),11,11
1.0,HIBI EDEN,Indian National Congress,478989,3328,482317,52.97,12 - Ernakulam (Kerala),11,12
2.0,K. J. SHINE TEACHER,Communist Party of India (Marxist),230059,1873,231932,25.47,12 - Ernakulam (Kerala),11,12
3.0,DR. K. S. RADHAKRISHNAN,Bharatiya Janata Party,143573,927,144500,15.87,12 - Ernakulam (Kerala),11,12
4.0,ADV. ANTONY JUDY,Twenty 20 Party,39658,150,39808,4.37,12 - Ernakulam (Kerala),11,12
5.0,VAYALAR JAYAKUMAR,Bahujan Samaj Party,1480,18,1498,0.16,12 - Ernakulam (Kerala),11,12
6.0,SANDEEP RAJENDRAPRASAD,Independent,734,18,752,0.08,12 - Ernakulam (Kerala),11,12
7.0,CYRILL SKARIA,Independent,663,27,690,0.08,12 - Ernakulam (Kerala),11,12
8.0,PRATHAPAN,Bahujan Dravida Party,414,5,419,0.05,12 - Ernakulam (Kerala),11,12
9.0,BRAHMAKUMAR,Socialist Unity Centre Of India (COMMUNIST),409,3,412,0.05,12 - Ernakulam (Kerala),11,12
10.0,ROHIT KRISHNAN,Independent,408,8,416,0.05,12 - Ernakulam (Kerala),11,12
11.0,NOTA,None of the Above,7715,43,7758,0.85,12 - Ernakulam (Kerala),11,12
,Total,,904102,6400,910502,,12 - Ernakulam (Kerala),11,12
1.0,ADV. DEAN KURIAKOSE,Indian National Congress,427129,5243,432372,51.43,13 - Idukki (Kerala),11,13
2.0,ADV. JOICE GEORGE,Communist Party of India (Marxist),295975,2670,298645,35.53,13 - Idukki (Kerala),11,13
3.0,ADV. SANGEETHA VISWANATHAN,Bharath Dharma Jana Sena,90663,660,91323,10.86,13 - Idukki (Kerala),11,13
4.0,ADV. RUSSEL JOY,Bahujan Samaj Party,4397,40,4437,0.53,13 - Idukki (Kerala),11,13
5.0,JOMON JOHN,Independent,1764,55,1819,0.22,13 - Idukki (Kerala),11,13
6.0,SAJI @ SHAJI,Viduthalai Chiruthaigal Katchi,1493,15,1508,0.18,13 - Idukki (Kerala),11,13
7.0,P.K. SAJEEVAN,Independent,1025,9,1034,0.12,13 - Idukki (Kerala),11,13
8.0,NOTA,None of the Above,9468,51,9519,1.13,13 - Idukki (Kerala),11,13
,Total,,831914,8743,840657,,13 - Idukki (Kerala),11,13
1.0,ADV K FRANCIS GEORGE,Kerala Congress,358369,6262,364631,43.6,14 - Kottayam (Kerala),11,14
2.0,THOMAS CHAZHIKADAN,Kerala Congress (M),272418,4947,277365,33.17,14 - Kottayam (Kerala),11,14
3.0,THUSHAR VELLAPPALLY,Bharath Dharma Jana Sena,163227,1819,165046,19.74,14 - Kottayam (Kerala),11,14
4.0,VIJU CHERIAN,Bahujan Samaj Party,7075,148,7223,0.86,14 - Kottayam (Kerala),11,14
5.0,P O PETER,Samajwadi Jan Parishad,1581,56,1637,0.2,14 - Kottayam (Kerala),11,14
6.0,V P KOCHUMON,Socialist Unity Centre Of India (COMMUNIST),1551,44,1595,0.19,14 - Kottayam (Kerala),11,14
7.0,JOSSIN K JOSEPH,Independent,1397,92,1489,0.18,14 - Kottayam (Kerala),11,14
8.0,CHANDRABOSE P,Independent,1071,16,1087,0.13,14 - Kottayam (Kerala),11,14
9.0,M M SCARIA,Independent,913,14,927,0.11,14 - Kottayam (Kerala),11,14
10.0,JOEMON JOSEPH SRAMPICKAL A P J JUMAN V S,Independent,875,18,893,0.11,14 - Kottayam (Kerala),11,14
11.0,ROBY MATTAPPALLY,Independent,697,42,739,0.09,14 - Kottayam (Kerala),11,14
12.0,SANTHOSH PULICKAL,Independent,686,24,710,0.08,14 - Kottayam (Kerala),11,14
13.0,SUNIL ALANCHERIL,Independent,499,28,527,0.06,14 - Kottayam (Kerala),11,14
14.0,MAN HOUSE MANMADHAN,Independent,403,18,421,0.05,14 - Kottayam (Kerala),11,14
15.0,NOTA,None of the Above,11804,129,11933,1.43,14 - Kottayam (Kerala),11,14
,Total,,822566,13657,836223,,14 - Kottayam (Kerala),11,14
1.0,K. C VENUGOPAL,Indian National Congress,398246,6314,404560,38.21,15 - Alappuzha (Kerala),11,15
2.0,A. M ARIFF,Communist Party of India (Marxist),335596,5451,341047,32.21,15 - Alappuzha (Kerala),11,15
3.0,SOBHA SURENDRAN,Bharatiya Janata Party,295841,3807,299648,28.3,15 - Alappuzha (Kerala),11,15
4.0,MURALEEDHARAN KONCHERILLAM,Bahujan Samaj Party,1578,48,1626,0.15,15 - Alappuzha (Kerala),11,15
5.0,ARJUNAN,Socialist Unity Centre Of India (COMMUNIST),1301,18,1319,0.12,15 - Alappuzha (Kerala),11,15
6.0,VAYALAR RAJEEVAN,Bahujan Dravida Party,674,1,675,0.06,15 - Alappuzha (Kerala),11,15
7.0,ADV.K.M SHAJAHAN,Independent,627,55,682,0.06,15 - Alappuzha (Kerala),11,15
8.0,SHAJAHAN V.A. S/O ABDUL AZEES,Independent,553,23,576,0.05,15 - Alappuzha (Kerala),11,15
9.0,SATHEESH SHENOI,Independent,473,9,482,0.05,15 - Alappuzha (Kerala),11,15
10.0,JAYAKRISHNAN P,Independent,329,56,385,0.04,15 - Alappuzha (Kerala),11,15
11.0,JYOTHI ABRAHAM,Independent,328,10,338,0.03,15 - Alappuzha (Kerala),11,15
12.0,NOTA,None of the Above,7252,113,7365,0.7,15 - Alappuzha (Kerala),11,15
,Total,,1042798,15905,1058703,,15 - Alappuzha (Kerala),11,15
1.0,KODIKUNNIL SURESH,Indian National Congress,362209,7307,369516,41.29,16 - Mavelikkara (Kerala),11,16
2.0,ADV ARUN KUMAR C A,Communist Party of India,352708,5940,358648,40.07,16 - Mavelikkara (Kerala),11,16
3.0,BAIJU KALASALA,Bharath Dharma Jana Sena,140830,2154,142984,15.98,16 - Mavelikkara (Kerala),11,16
4.0,C MONICHEN,Independent,4893,81,4974,0.56,16 - Mavelikkara (Kerala),11,16
5.0,SANTHOSH PALATHUMPADAN,Bahujan Samaj Party,4183,123,4306,0.48,16 - Mavelikkara (Kerala),11,16
6.0,SURESH NOORANAD,Ambedkarite Party of India,1441,64,1505,0.17,16 - Mavelikkara (Kerala),11,16
7.0,K BIMALJI,Socialist Unity Centre Of India (COMMUNIST),1336,34,1370,0.15,16 - Mavelikkara (Kerala),11,16
8.0,MANTHARA VELAYUDHAN,Independent,910,19,929,0.1,16 - Mavelikkara (Kerala),11,16
9.0,KOZHUVASSERIL SURESH,Independent,836,20,856,0.1,16 - Mavelikkara (Kerala),11,16
10.0,NOTA,None of the Above,9640,243,9883,1.1,16 - Mavelikkara (Kerala),11,16
,Total,,878986,15985,894971,,16 - Mavelikkara (Kerala),11,16
1.0,ANTO ANTONY,Indian National Congress,360957,6666,367623,39.98,17 - Pathanamthitta (Kerala),11,17
2.0,DR.T.M.THOMAS ISSAC,Communist Party of India (Marxist),297888,3616,301504,32.79,17 - Pathanamthitta (Kerala),11,17
3.0,ANIL K.ANTONY,Bharatiya Janata Party,231172,3234,234406,25.49,17 - Pathanamthitta (Kerala),11,17
4.0,ADV.P.K.GEETHAKRISHNAN,Bahujan Samaj Party,3918,54,3972,0.43,17 - Pathanamthitta (Kerala),11,17
5.0,JOY P.MATHEW,People's Party of India(secular),1173,8,1181,0.13,17 - Pathanamthitta (Kerala),11,17
6.0,K.C.THOMAS,Independent,1080,21,1101,0.12,17 - Pathanamthitta (Kerala),11,17
7.0,ADV.HARIKUMAR M.K.,Ambedkarite Party of India,735,27,762,0.08,17 - Pathanamthitta (Kerala),11,17
8.0,ANOOP V.,Independent,557,52,609,0.07,17 - Pathanamthitta (Kerala),11,17
9.0,NOTA,None of the Above,8268,143,8411,0.91,17 - Pathanamthitta (Kerala),11,17
,Total,,905748,13821,919569,,17 - Pathanamthitta (Kerala),11,17
1.0,N K PREMACHANDRAN,Revolutionary Socialist Party,437516,6112,443628,48.45,18 - Kollam (Kerala),11,18
2.0,M MUKESH,Communist Party of India (Marxist),288861,4465,293326,32.03,18 - Kollam (Kerala),11,18
3.0,KRISHNAKUMAR G,Bharatiya Janata Party,160956,2254,163210,17.82,18 - Kollam (Kerala),11,18
4.0,VIPINLAL VIDHYADHARAN,Bahujan Samaj Party,2163,31,2194,0.24,18 - Kollam (Kerala),11,18
5.0,PREMACHANDRAN NAIR,Independent,1713,21,1734,0.19,18 - Kollam (Kerala),11,18
6.0,GOKULAM SURESH KUMAR,Independent,1369,5,1374,0.15,18 - Kollam (Kerala),11,18
7.0,PRADEEP KOTTARAKKARA,Bharatheeya Jawan Kisan Party,793,42,835,0.09,18 - Kollam (Kerala),11,18
8.0,TWINKLE PRABHAKARAN,Socialist Unity Centre Of India (COMMUNIST),689,19,708,0.08,18 - Kollam (Kerala),11,18
9.0,JOSE SARANATH,Ambedkarite Party of India,553,6,559,0.06,18 - Kollam (Kerala),11,18
10.0,BRO NOUSHAD SHERIFF J,Independent,545,34,579,0.06,18 - Kollam (Kerala),11,18
11.0,P KRISHNAMMAL,Marxist Communist Party of India (United),537,12,549,0.06,18 - Kollam (Kerala),11,18
12.0,N JAYARAJAN,Independent,407,42,449,0.05,18 - Kollam (Kerala),11,18
13.0,NOTA,None of the Above,6437,109,6546,0.71,18 - Kollam (Kerala),11,18
,Total,,902539,13152,915691,,18 - Kollam (Kerala),11,18
1.0,ADV ADOOR PRAKASH,Indian National Congress,323273,4778,328051,33.29,19 - Attingal (Kerala),11,19
2.0,V JOY,Communist Party of India (Marxist),321715,5652,327367,33.22,19 - Attingal (Kerala),11,19
3.0,V MURALEEDHARAN,Bharatiya Janata Party,307710,4069,311779,31.64,19 - Attingal (Kerala),11,19
4.0,SURABHI S,Bahujan Samaj Party,4485,39,4524,0.46,19 - Attingal (Kerala),11,19
5.0,PRAKASH P L,Independent,1762,52,1814,0.18,19 - Attingal (Kerala),11,19
6.0,SANTHOSH K,Independent,1146,58,1204,0.12,19 - Attingal (Kerala),11,19
7.0,PRAKASH S,Independent,745,66,811,0.08,19 - Attingal (Kerala),11,19
8.0,NOTA,None of the Above,9681,110,9791,0.99,19 - Attingal (Kerala),11,19
,Total,,970517,14824,985341,,19 - Attingal (Kerala),11,19
1.0,SHASHI THAROOR,Indian National Congress,353679,4476,358155,37.19,20 - Thiruvananthapuram (Kerala),11,20
2.0,RAJEEV CHANDRASEKHAR,Bharatiya Janata Party,337920,4158,342078,35.52,20 - Thiruvananthapuram (Kerala),11,20
3.0,PANNIAN RAVINDRAN,Communist Party of India,244433,3215,247648,25.72,20 - Thiruvananthapuram (Kerala),11,20
4.0,ADV RAJENDRAN,Bahujan Samaj Party,2315,37,2352,0.24,20 - Thiruvananthapuram (Kerala),11,20
5.0,ADV SHINE LAL M P,Independent,1446,37,1483,0.15,20 - Thiruvananthapuram (Kerala),11,20
6.0,J J RUSSELL,Independent,1348,17,1365,0.14,20 - Thiruvananthapuram (Kerala),11,20
7.0,S MINI,Socialist Unity Centre Of India (COMMUNIST),1098,11,1109,0.12,20 - Thiruvananthapuram (Kerala),11,20
8.0,M S SUBI,Independent,588,11,599,0.06,20 - Thiruvananthapuram (Kerala),11,20
9.0,CHALAI MOHANAN,Independent,396,4,400,0.04,20 - Thiruvananthapuram (Kerala),11,20
10.0,NANDAVANAM SUSEELAN,Independent,391,29,420,0.04,20 - Thiruvananthapuram (Kerala),11,20
11.0,SHAJU PALIYODU,Independent,348,40,388,0.04,20 - Thiruvananthapuram (Kerala),11,20
12.0,SASI KONGAPALLY,Independent,228,5,233,0.02,20 - Thiruvananthapuram (Kerala),11,20
13.0,NOTA,None of the Above,6684,69,6753,0.7,20 - Thiruvananthapuram (Kerala),11,20
,Total,,950874,12109,962983,,20 - Thiruvananthapuram (Kerala),11,20
1.0,SHIVMANGAL SINGH TOMAR,Bharatiya Janata Party,513136,2341,515477,43.41,1 - MORENA (Madhya Pradesh),12,1
2.0,NEETU SATYAPAL SINGH SIKARWAR,Indian National Congress,461808,1139,462947,38.99,1 - MORENA (Madhya Pradesh),12,1
3.0,RAMESH GARG,Bahujan Samaj Party,179492,177,179669,15.13,1 - MORENA (Madhya Pradesh),12,1
4.0,NEERAJ CHANDSORIYA,Aazad Samaj Party (Kanshi Ram),7534,10,7544,0.64,1 - MORENA (Madhya Pradesh),12,1
5.0,RAJENDRA PRASAD KUSHWAH,Independent,2392,10,2402,0.2,1 - MORENA (Madhya Pradesh),12,1
6.0,ER. SURAJ KUSHWAH,Independent,2279,6,2285,0.19,1 - MORENA (Madhya Pradesh),12,1
7.0,RAMNIWASH,Independent,1970,3,1973,0.17,1 - MORENA (Madhya Pradesh),12,1
8.0,RAM SUNDER SHARMA,Independent,1762,5,1767,0.15,1 - MORENA (Madhya Pradesh),12,1
9.0,RAMSEVAK SAKHWAR,Independent,1630,2,1632,0.14,1 - MORENA (Madhya Pradesh),12,1
10.0,HARIKANTH,Independent,1623,-,1623,0.14,1 - MORENA (Madhya Pradesh),12,1
11.0,RAJKUMARI,Independent,1435,6,1441,0.12,1 - MORENA (Madhya Pradesh),12,1
12.0,ANOOP NAGAR,Independent,1308,9,1317,0.11,1 - MORENA (Madhya Pradesh),12,1
13.0,RAJENDRA SINGH GURJER,Independent,1199,11,1210,0.1,1 - MORENA (Madhya Pradesh),12,1
14.0,PIYUSH BRAJESH RAJORIYA,Independent,572,3,575,0.05,1 - MORENA (Madhya Pradesh),12,1
15.0,PRABHU JATAV,Independent,547,8,555,0.05,1 - MORENA (Madhya Pradesh),12,1
16.0,NOTA,None of the Above,4899,15,4914,0.41,1 - MORENA (Madhya Pradesh),12,1
,Total,,1183586,3745,1187331,,1 - MORENA (Madhya Pradesh),12,1
1.0,SANDHYA RAY,Bharatiya Janata Party,533462,3603,537065,51.2,2 - BHIND (Madhya Pradesh),12,2
2.0,PHOOL SINGH BARAIYA,Indian National Congress,470169,2056,472225,45.02,2 - BHIND (Madhya Pradesh),12,2
3.0,DEVASHISH JARARIYA,Bahujan Samaj Party,20322,143,20465,1.95,2 - BHIND (Madhya Pradesh),12,2
4.0,UMESH GARG,Independent,5057,15,5072,0.48,2 - BHIND (Madhya Pradesh),12,2
5.0,REKHA SHAKYA,Independent,2645,22,2667,0.25,2 - BHIND (Madhya Pradesh),12,2
6.0,HARIMOHAN,Independent,2598,12,2610,0.25,2 - BHIND (Madhya Pradesh),12,2
7.0,RAKESH,Independent,2345,24,2369,0.23,2 - BHIND (Madhya Pradesh),12,2
8.0,NOTA,None of the Above,6486,48,6534,0.62,2 - BHIND (Madhya Pradesh),12,2
,Total,,1043084,5923,1049007,,2 - BHIND (Madhya Pradesh),12,2
1.0,BHARAT SINGH KUSHWAH,Bharatiya Janata Party,668782,2753,671535,49.99,3 - GWALIOR (Madhya Pradesh),12,3
2.0,PRAVEEN PATHAK,Indian National Congress,599077,2248,601325,44.77,3 - GWALIOR (Madhya Pradesh),12,3
3.0,KALYAN SINGH KANSANA,Bahujan Samaj Party,33308,157,33465,2.49,3 - GWALIOR (Madhya Pradesh),12,3
4.0,ARCHANA SINGH RATHORE,Rashtriya Samaj Paksha,5873,19,5892,0.44,3 - GWALIOR (Madhya Pradesh),12,3
5.0,BHARAT PAL,Aazad Samaj Party (Kanshi Ram),4138,25,4163,0.31,3 - GWALIOR (Madhya Pradesh),12,3
6.0,ER. MAHENDRA PRATAP SINGH PAL,Independent,3777,6,3783,0.28,3 - GWALIOR (Madhya Pradesh),12,3
7.0,RAKESH DHAKAD,Independent,3218,2,3220,0.24,3 - GWALIOR (Madhya Pradesh),12,3
8.0,YASHDEV SHARMA,Independent,2568,3,2571,0.19,3 - GWALIOR (Madhya Pradesh),12,3
9.0,DEEPAK KUMAR BANSAL (RANG WALE),Independent,2448,-,2448,0.18,3 - GWALIOR (Madhya Pradesh),12,3
10.0,SHREE NARESH CHANDRA SHARMA,Independent,2215,1,2216,0.16,3 - GWALIOR (Madhya Pradesh),12,3
11.0,GAJENDRA SINGH,Independent,1343,5,1348,0.1,3 - GWALIOR (Madhya Pradesh),12,3
12.0,ANJALI MONU RAWAT,Parivartan Party of India,1272,7,1279,0.1,3 - GWALIOR (Madhya Pradesh),12,3
13.0,ADVOCATE MUKESH KUMAR KORI,Independent,1130,4,1134,0.08,3 - GWALIOR (Madhya Pradesh),12,3
14.0,RAM PRAKASH SINGH PAL,Rashtra Uday Party,1059,12,1071,0.08,3 - GWALIOR (Madhya Pradesh),12,3
15.0,CHANDAN RATHORE,Parivartan Samaj Party,1053,6,1059,0.08,3 - GWALIOR (Madhya Pradesh),12,3
16.0,DR. P. D. AGARWAL SR. MEDICAL CONSULTANT,Independent,1016,5,1021,0.08,3 - GWALIOR (Madhya Pradesh),12,3
17.0,AMIT PARIHAR,Independent,877,6,883,0.07,3 - GWALIOR (Madhya Pradesh),12,3
18.0,COMRADE RACHNA AGRAWAL,Socialist Unity Centre Of India (COMMUNIST),798,5,803,0.06,3 - GWALIOR (Madhya Pradesh),12,3
19.0,MUNESH NAGAR,Vikas India Party,667,5,672,0.05,3 - GWALIOR (Madhya Pradesh),12,3
20.0,NOTA,None of the Above,3309,32,3341,0.25,3 - GWALIOR (Madhya Pradesh),12,3
,Total,,1337928,5301,1343229,,3 - GWALIOR (Madhya Pradesh),12,3
1.0,JYOTIRADITYA M. SCINDIA,Bharatiya Janata Party,919744,3558,923302,67.21,4 - GUNA (Madhya Pradesh),12,4
2.0,YADVENDRA RAO DESHRAJ SINGH,Indian National Congress,380909,1464,382373,27.83,4 - GUNA (Madhya Pradesh),12,4
3.0,DHANIRAM CHAUDHARY,Bahujan Samaj Party,30105,130,30235,2.2,4 - GUNA (Madhya Pradesh),12,4
4.0,KANCHHEDI LAL KUSHWAHA,Mahanwadi Party,5850,6,5856,0.43,4 - GUNA (Madhya Pradesh),12,4
5.0,ADVOCATE KARANSINGH JATAV,Aazad Samaj Party (Kanshi Ram),5474,11,5485,0.4,4 - GUNA (Madhya Pradesh),12,4
6.0,HEMANT SINGH KUSHWAHA,Independent,3450,3,3453,0.25,4 - GUNA (Madhya Pradesh),12,4
7.0,RAKESH,Independent,3051,1,3052,0.22,4 - GUNA (Madhya Pradesh),12,4
8.0,MAHENDRA JAIN BHAIYAN,Independent,1990,9,1999,0.15,4 - GUNA (Madhya Pradesh),12,4
9.0,MOHAN,Independent,1883,3,1886,0.14,4 - GUNA (Madhya Pradesh),12,4
10.0,GAJANAND KUSHWAH,Independent,1595,2,1597,0.12,4 - GUNA (Madhya Pradesh),12,4
11.0,MANISH SHRIVASTAVA,Socialist Unity Centre Of India (COMMUNIST),1342,6,1348,0.1,4 - GUNA (Madhya Pradesh),12,4
12.0,MANMOHAN,Independent,1143,6,1149,0.08,4 - GUNA (Madhya Pradesh),12,4
13.0,KISAN LAL AHIRWAR,Independent,1033,11,1044,0.08,4 - GUNA (Madhya Pradesh),12,4
14.0,MOHAMMAD JAVED ANSARI,Rashtriya Jansena Party,983,-,983,0.07,4 - GUNA (Madhya Pradesh),12,4
15.0,D.S. CHAUHAN (ADVOCATE),Rashtriya Samaj Paksha,913,2,915,0.07,4 - GUNA (Madhya Pradesh),12,4
16.0,NOTA,None of the Above,9055,34,9089,0.66,4 - GUNA (Madhya Pradesh),12,4
,Total,,1368520,5246,1373766,,4 - GUNA (Madhya Pradesh),12,4
1.0,DR. LATA WANKHEDE,Bharatiya Janata Party,786160,1819,787979,68.49,5 - SAGAR (Madhya Pradesh),12,5
2.0,CHANDRA BHUSAN SINGH BUNDELA 'GUDDU RAJA',Indian National Congress,316059,698,316757,27.53,5 - SAGAR (Madhya Pradesh),12,5
3.0,BHAGWATI PRASAD JATAV,Bahujan Samaj Party,16592,44,16636,1.45,5 - SAGAR (Madhya Pradesh),12,5
4.0,BHEEKAM SINGH KUSHWAHA,Mahanwadi Party,5778,6,5784,0.5,5 - SAGAR (Madhya Pradesh),12,5
5.0,RAM BHJAN BANSAL,Samata Party,3149,4,3153,0.27,5 - SAGAR (Madhya Pradesh),12,5
6.0,MOHAMAD AARIF MAKRANI,Independent,2888,-,2888,0.25,5 - SAGAR (Madhya Pradesh),12,5
7.0,SANGRAM SINGH YADAV,Independent,2819,5,2824,0.25,5 - SAGAR (Madhya Pradesh),12,5
8.0,DHARMENDRA BANPURIYA,Independent,1621,3,1624,0.14,5 - SAGAR (Madhya Pradesh),12,5
9.0,TOSHMANI PANTHI (KANNA),Independent,1293,6,1299,0.11,5 - SAGAR (Madhya Pradesh),12,5
10.0,SURESH BANSAL,Bhartiya Shakti Chetna Party,1147,4,1151,0.1,5 - SAGAR (Madhya Pradesh),12,5
11.0,LAXMI KUSHWAHA,Pichhara Samaj Party United,947,5,952,0.08,5 - SAGAR (Madhya Pradesh),12,5
12.0,DR. RAMAVATAR SHARMA,Socialist Unity Centre Of India (COMMUNIST),924,4,928,0.08,5 - SAGAR (Madhya Pradesh),12,5
13.0,AHIRWAR RAJKUMAR THEKEDAAR,Independent,914,3,917,0.08,5 - SAGAR (Madhya Pradesh),12,5
14.0,NOTA,None of the Above,7641,16,7657,0.67,5 - SAGAR (Madhya Pradesh),12,5
,Total,,1147932,2617,1150549,,5 - SAGAR (Madhya Pradesh),12,5
1.0,DR. VIRENDRA KUMAR,Bharatiya Janata Party,713781,1269,715050,65.1,6 - TIKAMGARH (Madhya Pradesh),12,6
2.0,KHUMAN URF PANKAJ AHIRWAR,Indian National Congress,311134,604,311738,28.38,6 - TIKAMGARH (Madhya Pradesh),12,6
3.0,AHIRWAR DALLURAM,Bahujan Samaj Party,32604,69,32673,2.97,6 - TIKAMGARH (Madhya Pradesh),12,6
4.0,AHIRWAR PANKAJ,Rashtriya Samaj Paksha,10147,11,10158,0.92,6 - TIKAMGARH (Madhya Pradesh),12,6
5.0,SARJU PRASAD,Independent,5993,4,5997,0.55,6 - TIKAMGARH (Madhya Pradesh),12,6
6.0,N.R. PRAJAPATI,Adarsh Nyay Rakshak Party,5475,9,5484,0.5,6 - TIKAMGARH (Madhya Pradesh),12,6
7.0,BABULAL KHANGAR,Independent,4452,7,4459,0.41,6 - TIKAMGARH (Madhya Pradesh),12,6
8.0,NOTA,None of the Above,12816,15,12831,1.17,6 - TIKAMGARH (Madhya Pradesh),12,6
,Total,,1096402,1988,1098390,,6 - TIKAMGARH (Madhya Pradesh),12,6
1.0,RAHUL SINGH LODHI,Bharatiya Janata Party,708589,1179,709768,65.18,7 - DAMOH (Madhya Pradesh),12,7
2.0,TARBAR SINGH LODHI (BANTU BHAIYA),Indian National Congress,302828,514,303342,27.86,7 - DAMOH (Madhya Pradesh),12,7
3.0,ENGINEER GOVERDHAN RAJ,Bahujan Samaj Party,21379,25,21404,1.97,7 - DAMOH (Madhya Pradesh),12,7
4.0,BHAIYA VIJAY PATEL (KURMI) TIRGARH BALE,Bhartiya Shakti Chetna Party,12200,17,12217,1.12,7 - DAMOH (Madhya Pradesh),12,7
5.0,MANU SINGH MARAVI,Bharat Adivasi Party,7871,16,7887,0.72,7 - DAMOH (Madhya Pradesh),12,7
6.0,RAHUL BHAIYA S/O RAM PRATAP,Independent,6273,12,6285,0.58,7 - DAMOH (Madhya Pradesh),12,7
7.0,RAHUL BHAIYA S/O JEEVAN LAL,Independent,5556,5,5561,0.51,7 - DAMOH (Madhya Pradesh),12,7
8.0,VEDRAM KURMI,Independent,4054,3,4057,0.37,7 - DAMOH (Madhya Pradesh),12,7
9.0,RAJESH SINGH SOYAM,Gondvana Gantantra Party,3172,18,3190,0.29,7 - DAMOH (Madhya Pradesh),12,7
10.0,RAKESH KUMAR AHIRWAR,Independent,2044,7,2051,0.19,7 - DAMOH (Madhya Pradesh),12,7
11.0,NANDAN KUMAR AHIRWAL,Independent,1848,5,1853,0.17,7 - DAMOH (Madhya Pradesh),12,7
12.0,NEELESH SONI,Independent,1277,1,1278,0.12,7 - DAMOH (Madhya Pradesh),12,7
13.0,DURGA MOUSI,Independent,1120,4,1124,0.1,7 - DAMOH (Madhya Pradesh),12,7
14.0,TARVAR SINGH LODHI,Independent,1092,2,1094,0.1,7 - DAMOH (Madhya Pradesh),12,7
15.0,NOTA,None of the Above,7820,13,7833,0.72,7 - DAMOH (Madhya Pradesh),12,7
,Total,,1087123,1821,1088944,,7 - DAMOH (Madhya Pradesh),12,7
1.0,VISHNU DATT SHARMA (V.D.SHARMA),Bharatiya Janata Party,771014,1760,772774,67.75,8 - KHAJURAHO (Madhya Pradesh),12,8
2.0,KAMLESH KUMAR,Bahujan Samaj Party,231163,382,231545,20.3,8 - KHAJURAHO (Madhya Pradesh),12,8
3.0,R. B. PRAJAPATI (RAJA BHAIYA) EX.I.A.S.,All India Forward Bloc,50033,182,50215,4.4,8 - KHAJURAHO (Madhya Pradesh),12,8
4.0,MOHAMMAD IMRAN,Rashtriya Jansambhavna Party,17853,20,17873,1.57,8 - KHAJURAHO (Madhya Pradesh),12,8
5.0,PENTER SUNMAN SINGH LODHI,Independent,10005,6,10011,0.88,8 - KHAJURAHO (Madhya Pradesh),12,8
6.0,KAPIL GUPTA BHARTIYA,Akhil Bhartiya Parivar Party,7540,24,7564,0.66,8 - KHAJURAHO (Madhya Pradesh),12,8
7.0,LAXMI PRASAD,Independent,6752,12,6764,0.59,8 - KHAJURAHO (Madhya Pradesh),12,8
8.0,NANDKISHOR,Peoples Party of India (Democratic),6019,8,6027,0.53,8 - KHAJURAHO (Madhya Pradesh),12,8
9.0,PANKAJ MAURYA (KUSHWAHA),Gondvana Gantantra Party,4730,10,4740,0.42,8 - KHAJURAHO (Madhya Pradesh),12,8
10.0,BITIAYA AHIRWAR,Independent,4018,8,4026,0.35,8 - KHAJURAHO (Madhya Pradesh),12,8
11.0,FIROJKHAN,Independent,3708,5,3713,0.33,8 - KHAJURAHO (Madhya Pradesh),12,8
12.0,GIRAN SINGH,Bhartiya Shakti Chetna Party,3485,7,3492,0.31,8 - KHAJURAHO (Madhya Pradesh),12,8
13.0,KESHKALI,Rashtriya Jansanchar Dal,2861,11,2872,0.25,8 - KHAJURAHO (Madhya Pradesh),12,8
14.0,PANNA LAL TRIPATHI AD.,Indian Peoples Adhikar Party,2794,3,2797,0.25,8 - KHAJURAHO (Madhya Pradesh),12,8
15.0,NOTA,None of the Above,16134,23,16157,1.42,8 - KHAJURAHO (Madhya Pradesh),12,8
,Total,,1138109,2461,1140570,,8 - KHAJURAHO (Madhya Pradesh),12,8
1.0,GANESH SINGH,Bharatiya Janata Party,458373,1355,459728,43.41,9 - SATNA (Madhya Pradesh),12,9
2.0,DABBU SIDDHARTH SUKHLAL KUSHWAHA,Indian National Congress,373982,797,374779,35.39,9 - SATNA (Madhya Pradesh),12,9
3.0,NARAYAN TRIPATHI,Bahujan Samaj Party,185303,315,185618,17.53,9 - SATNA (Madhya Pradesh),12,9
4.0,DURGESH KUMAR VISHWAKARMA,Independent,5919,2,5921,0.56,9 - SATNA (Madhya Pradesh),12,9
5.0,RAHUL DAHIYA,Independent,4276,1,4277,0.4,9 - SATNA (Madhya Pradesh),12,9
6.0,CHHEDI LAL PRAJAPATI (PANDA BABA),Independent,4060,1,4061,0.38,9 - SATNA (Madhya Pradesh),12,9
7.0,CHANDRABHAN KOL,Independent,3393,5,3398,0.32,9 - SATNA (Madhya Pradesh),12,9
8.0,"SAFI ULLA ""DBBU BHAI""",Independent,2612,2,2614,0.25,9 - SATNA (Madhya Pradesh),12,9
9.0,ADV. ASHOK SAKET,Bahujan Dravida Party,2396,3,2399,0.23,9 - SATNA (Madhya Pradesh),12,9
10.0,AZEEZ AHMED QURAISHY,Manviya Bharat Party,2078,4,2082,0.2,9 - SATNA (Madhya Pradesh),12,9
11.0,MASTER JI AJIT KUMAR JAYSWAL,Peoples Party of India (Democratic),1887,4,1891,0.18,9 - SATNA (Madhya Pradesh),12,9
12.0,KALIM AHMAD BACHCHA,Independent,1622,8,1630,0.15,9 - SATNA (Madhya Pradesh),12,9
13.0,SUKHLAL VERMA RATNESH,Independent,1616,1,1617,0.15,9 - SATNA (Madhya Pradesh),12,9
14.0,ASHOK KUMAR GUPTA,Bhartiya Shakti Chetna Party,1259,6,1265,0.12,9 - SATNA (Madhya Pradesh),12,9
15.0,NANKU YADAV,Akhil Bharatiya Hind Kranti Party,1254,5,1259,0.12,9 - SATNA (Madhya Pradesh),12,9
16.0,RISHABH SINGH,Independent,1068,5,1073,0.1,9 - SATNA (Madhya Pradesh),12,9
17.0,ASHOK BAUDH,Independent,945,2,947,0.09,9 - SATNA (Madhya Pradesh),12,9
18.0,HARI SHANKAR TIWARI (LOHA WALA),Bharatiya Jan Morcha Party,935,10,945,0.09,9 - SATNA (Madhya Pradesh),12,9
19.0,RANJANA MISHRA,Nyaydharmsabha,905,10,915,0.09,9 - SATNA (Madhya Pradesh),12,9
20.0,NOTA,None of the Above,2538,15,2553,0.24,9 - SATNA (Madhya Pradesh),12,9
,Total,,1056421,2551,1058972,,9 - SATNA (Madhya Pradesh),12,9
1.0,JANARDAN MISHRA,Bharatiya Janata Party,475439,2020,477459,52.0,10 - REWA (Madhya Pradesh),12,10
2.0,NEELAM ABHAY MISHRA,Indian National Congress,283187,898,284085,30.94,10 - REWA (Madhya Pradesh),12,10
3.0,ADV. ABHISHEK MASTER BUDDHSEN PATEL,Bahujan Samaj Party,117089,132,117221,12.77,10 - REWA (Madhya Pradesh),12,10
4.0,DAYASHANKAR PANDEY,Independent,4609,1,4610,0.5,10 - REWA (Madhya Pradesh),12,10
5.0,ROSHAN LAL KOL,Independent,4110,12,4122,0.45,10 - REWA (Madhya Pradesh),12,10
6.0,ER. DEVENDRA SINGH,Sapaks Party,4065,11,4076,0.44,10 - REWA (Madhya Pradesh),12,10
7.0,ER. RAM KUMAR SONI,Independent,3868,5,3873,0.42,10 - REWA (Madhya Pradesh),12,10
8.0,RAM GOPAL SINGH,Peoples Party of India (Democratic),3502,7,3509,0.38,10 - REWA (Madhya Pradesh),12,10
9.0,PRASSAN JEET SINGH,Independent,3306,7,3313,0.36,10 - REWA (Madhya Pradesh),12,10
10.0,JANARDAN MISHRA,Independent,2274,21,2295,0.25,10 - REWA (Madhya Pradesh),12,10
11.0,RANJAN GUPTA,Rashtravadi Bharat Party,2151,9,2160,0.24,10 - REWA (Madhya Pradesh),12,10
12.0,VIPIN SINGH PATEL,Rashtriya Hind Ekta Dal,1799,7,1806,0.2,10 - REWA (Madhya Pradesh),12,10
13.0,ARUNENDRA NARAYAN PANDEY,Independent,1550,1,1551,0.17,10 - REWA (Madhya Pradesh),12,10
14.0,ARUN TIWARI 'MINTU',Independent,1113,-,1113,0.12,10 - REWA (Madhya Pradesh),12,10
15.0,NOTA,None of the Above,6916,20,6936,0.76,10 - REWA (Madhya Pradesh),12,10
,Total,,914978,3151,918129,,10 - REWA (Madhya Pradesh),12,10
1.0,DR. RAJESH MISHRA,Bharatiya Janata Party,582664,895,583559,50.87,11 - SIDHI (Madhya Pradesh),12,11
2.0,KAMLESHWAR INDRAJIT KUMAR,Indian National Congress,376336,807,377143,32.87,11 - SIDHI (Madhya Pradesh),12,11
3.0,AJAY PRATAP SINGH,Gondvana Gantantra Party,50897,65,50962,4.44,11 - SIDHI (Madhya Pradesh),12,11
4.0,PUJAN RAM SAKET (BABBU),Bahujan Samaj Party,33617,39,33656,2.93,11 - SIDHI (Madhya Pradesh),12,11
5.0,LAXMAN SINGH BAIS,Independent,30634,28,30662,2.67,11 - SIDHI (Madhya Pradesh),12,11
6.0,SANJAY NAMDEO,Communist Party of India,20284,6,20290,1.77,11 - SIDHI (Madhya Pradesh),12,11
7.0,BHAGWAN PRASAD TIWARI,Independent,7330,1,7331,0.64,11 - SIDHI (Madhya Pradesh),12,11
8.0,SUNIL TIWARI,Independent,5694,5,5699,0.5,11 - SIDHI (Madhya Pradesh),12,11
9.0,SHYAMLAL VAISH,Bhartiya Shakti Chetna Party,5340,3,5343,0.47,11 - SIDHI (Madhya Pradesh),12,11
10.0,KAILASH PRASAD VERMA,Independent,5289,2,5291,0.46,11 - SIDHI (Madhya Pradesh),12,11
11.0,MAHENDRA BHAIYA,Independent,4658,-,4658,0.41,11 - SIDHI (Madhya Pradesh),12,11
12.0,DASHRATH PRASAD BAIS,Independent,4131,-,4131,0.36,11 - SIDHI (Madhya Pradesh),12,11
13.0,"NARAYAN DAS SHAH ""MULNIWASI""",Peoples Party of India (Democratic),3791,1,3792,0.33,11 - SIDHI (Madhya Pradesh),12,11
14.0,DADDI YADAV,Independent,3301,4,3305,0.29,11 - SIDHI (Madhya Pradesh),12,11
15.0,SMT. TARA DEVI SINGH,Rashtriya Jansanchar Dal,2701,6,2707,0.24,11 - SIDHI (Madhya Pradesh),12,11
16.0,RAMSAHAY SAHU,Aapka Gantantra Party,2430,2,2432,0.21,11 - SIDHI (Madhya Pradesh),12,11
17.0,RAMVISHAL KOL,Rashtriya Samaj Paksha,2079,8,2087,0.18,11 - SIDHI (Madhya Pradesh),12,11
18.0,NOTA,None of the Above,4212,4,4216,0.37,11 - SIDHI (Madhya Pradesh),12,11
,Total,,1145388,1876,1147264,,11 - SIDHI (Madhya Pradesh),12,11
1.0,SMT. HIMADRI SINGH,Bharatiya Janata Party,709477,1666,711143,61.73,12 - SHAHDOL (Madhya Pradesh),12,12
2.0,PHUNDE LAL SINGH MARKO,Indian National Congress,312833,970,313803,27.24,12 - SHAHDOL (Madhya Pradesh),12,12
3.0,ANIL SINGH DHURVEY,Gondvana Gantantra Party,35186,92,35278,3.06,12 - SHAHDOL (Madhya Pradesh),12,12
4.0,DHANI RAM KOL,Bahujan Samaj Party,21792,62,21854,1.9,12 - SHAHDOL (Madhya Pradesh),12,12
5.0,SAMAR SHAH SINGH GOND,Communist Party of India,19861,22,19883,1.73,12 - SHAHDOL (Madhya Pradesh),12,12
6.0,KESHKALI BAIGA,Independent,10042,29,10071,0.87,12 - SHAHDOL (Madhya Pradesh),12,12
7.0,GUNJAN SINGH,Independent,7460,19,7479,0.65,12 - SHAHDOL (Madhya Pradesh),12,12
8.0,RAVIKARAN SINGH DHURVE,Bhartiya Shakti Chetna Party,4964,11,4975,0.43,12 - SHAHDOL (Madhya Pradesh),12,12
9.0,AMRIT LAL SINGH UIKEY,Peoples Party of India (Democratic),4701,21,4722,0.41,12 - SHAHDOL (Madhya Pradesh),12,12
10.0,DR. DURGA WATI BHARIA,Chhattisgarh Vikas Ganga Rashtriya Party,3425,19,3444,0.3,12 - SHAHDOL (Madhya Pradesh),12,12
11.0,NOTA,None of the Above,19341,20,19361,1.68,12 - SHAHDOL (Madhya Pradesh),12,12
,Total,,1149082,2931,1152013,,12 - SHAHDOL (Madhya Pradesh),12,12
1.0,ASHISH DUBEY,Bharatiya Janata Party,788721,1412,790133,68.2,13 - JABALPUR (Madhya Pradesh),12,13
2.0,DINESH YADAV,Indian National Congress,302892,567,303459,26.19,13 - JABALPUR (Madhya Pradesh),12,13
3.0,RAKESH CHOUDHARY,Bahujan Samaj Party,21389,27,21416,1.85,13 - JABALPUR (Madhya Pradesh),12,13
4.0,FOJI VIJAY HALDKAR (EX-ARMY),Independent,7028,15,7043,0.61,13 - JABALPUR (Madhya Pradesh),12,13
5.0,MAHAVEER JAIN,Independent,6463,5,6468,0.56,13 - JABALPUR (Madhya Pradesh),12,13
6.0,ADVOCATE UDAY KUMAR SAHU,Gondvana Gantantra Party,4832,16,4848,0.42,13 - JABALPUR (Madhya Pradesh),12,13
7.0,"ER. PRAVIN GAJBHIYE ""DADA""",Independent,3437,3,3440,0.3,13 - JABALPUR (Madhya Pradesh),12,13
8.0,POORNESH KUMAR JAIN,Independent,2822,1,2823,0.24,13 - JABALPUR (Madhya Pradesh),12,13
9.0,SWATANATRA SAMAJ SEVI VINAY CHAKRAVARTI,Independent,2488,3,2491,0.22,13 - JABALPUR (Madhya Pradesh),12,13
10.0,JAGDISH SINGH LODHI,Bhartiya Shakti Chetna Party,1871,4,1875,0.16,13 - JABALPUR (Madhya Pradesh),12,13
11.0,DINESH YADAV,Independent,1480,4,1484,0.13,13 - JABALPUR (Madhya Pradesh),12,13
12.0,DR. DHAI AKSHAR,Independent,1399,1,1400,0.12,13 - JABALPUR (Madhya Pradesh),12,13
13.0,ASHOK RANA,Rashtra Nirman Party,1226,2,1228,0.11,13 - JABALPUR (Madhya Pradesh),12,13
14.0,SANTOSH KUMAR KUSHWAHA,Independent,1202,2,1204,0.1,13 - JABALPUR (Madhya Pradesh),12,13
15.0,DASAI RAM KOL,Aadim Samaj Party,1099,1,1100,0.09,13 - JABALPUR (Madhya Pradesh),12,13
16.0,COMRADE SACHIN JAIN,Socialist Unity Centre Of India (COMMUNIST),868,8,876,0.08,13 - JABALPUR (Madhya Pradesh),12,13
17.0,GULAB SINGH,Independent,821,8,829,0.07,13 - JABALPUR (Madhya Pradesh),12,13
18.0,LAL SINGH,Rashtriya Samaj Dal (R),748,4,752,0.06,13 - JABALPUR (Madhya Pradesh),12,13
19.0,RAMKUMAR PASI,Bahujan Awam Party,684,6,690,0.06,13 - JABALPUR (Madhya Pradesh),12,13
20.0,NOTA,None of the Above,4964,22,4986,0.43,13 - JABALPUR (Madhya Pradesh),12,13
,Total,,1156434,2111,1158545,,13 - JABALPUR (Madhya Pradesh),12,13
1.0,FAGGAN SINGH KULASTE,Bharatiya Janata Party,749761,1614,751375,48.93,14 - MANDLA (Madhya Pradesh),12,14
2.0,OMKAR SINGH MARKAM,Indian National Congress,645759,1770,647529,42.17,14 - MANDLA (Madhya Pradesh),12,14
3.0,MAHESH KUMAR WATTEE,Gondvana Gantantra Party,37686,111,37797,2.46,14 - MANDLA (Madhya Pradesh),12,14
4.0,INDAR SINGH UIKEY,Bahujan Samaj Party,16587,30,16617,1.08,14 - MANDLA (Madhya Pradesh),12,14
5.0,CHANDRA SINGH KUSHRAM,Bhartiya Shakti Chetna Party,15533,25,15558,1.01,14 - MANDLA (Madhya Pradesh),12,14
6.0,SITAR MARKAM,Independent,10365,10,10375,0.68,14 - MANDLA (Madhya Pradesh),12,14
7.0,RAKESH SINGH THAKUR,Independent,10340,6,10346,0.67,14 - MANDLA (Madhya Pradesh),12,14
8.0,DR. BHAW SINGH TEKAM,Independent,6393,8,6401,0.42,14 - MANDLA (Madhya Pradesh),12,14
9.0,CHARAN SINGH DHURWEY,Bharat Adivasi Party,4269,18,4287,0.28,14 - MANDLA (Madhya Pradesh),12,14
10.0,ADVOCATE-DEV SINGH KUMRE,Independent,4205,12,4217,0.27,14 - MANDLA (Madhya Pradesh),12,14
11.0,GHUR SINGH SALLAM,Independent,3959,12,3971,0.26,14 - MANDLA (Madhya Pradesh),12,14
12.0,KALIYA BAI KAKODIA,Independent,2990,11,3001,0.2,14 - MANDLA (Madhya Pradesh),12,14
13.0,ASHOK SARAIYA,Independent,2717,10,2727,0.18,14 - MANDLA (Madhya Pradesh),12,14
14.0,RAMKUMAR INWATI [ADVOCATE],Smart Indians Party,2499,11,2510,0.16,14 - MANDLA (Madhya Pradesh),12,14
15.0,NOTA,None of the Above,18887,34,18921,1.23,14 - MANDLA (Madhya Pradesh),12,14
,Total,,1531950,3682,1535632,,14 - MANDLA (Madhya Pradesh),12,14
1.0,BHARTI PARDHI,Bharatiya Janata Party,709939,2721,712660,51.56,15 - BALAGHAT (Madhya Pradesh),12,15
2.0,SAMRAT ASHOK SINGH SARASWAR,Indian National Congress,536333,1815,538148,38.93,15 - BALAGHAT (Madhya Pradesh),12,15
3.0,KANKAR MUNJARE,Bahujan Samaj Party,52883,251,53134,3.84,15 - BALAGHAT (Madhya Pradesh),12,15
4.0,BHUVAN SINGH KORAM,Independent,13028,46,13074,0.95,15 - BALAGHAT (Madhya Pradesh),12,15
5.0,NANDLAL UIKEY,Gondvana Gantantra Party,12338,84,12422,0.9,15 - BALAGHAT (Madhya Pradesh),12,15
6.0,D.L. MANESHWAR,Peoples Party of India (Democratic),9994,23,10017,0.72,15 - BALAGHAT (Madhya Pradesh),12,15
7.0,DHANENDRA DEV PAWAR BANWARI SETH,Independent,7185,60,7245,0.52,15 - BALAGHAT (Madhya Pradesh),12,15
8.0,MAHADEV NAGDEVE,Independent,7181,11,7192,0.52,15 - BALAGHAT (Madhya Pradesh),12,15
9.0,RAJKUMAR NAGESHWER,Independent,6723,5,6728,0.49,15 - BALAGHAT (Madhya Pradesh),12,15
10.0,MOHAN RAUT,Rashtravadi Bharat Party,3537,5,3542,0.26,15 - BALAGHAT (Madhya Pradesh),12,15
11.0,PRIYANKA SANJAY BHANDARKAR,Bhartiya Shakti Chetna Party,2906,20,2926,0.21,15 - BALAGHAT (Madhya Pradesh),12,15
12.0,ADVOCATE SATYAPRAKASH SHULKE (LODHI),Madhya Pradesh Jan Vikas Party,1929,3,1932,0.14,15 - BALAGHAT (Madhya Pradesh),12,15
13.0,DILEEP CHHABDA,Independent,1733,17,1750,0.13,15 - BALAGHAT (Madhya Pradesh),12,15
14.0,NOTA,None of the Above,11479,31,11510,0.83,15 - BALAGHAT (Madhya Pradesh),12,15
,Total,,1377188,5092,1382280,,15 - BALAGHAT (Madhya Pradesh),12,15
1.0,BUNTY VIVEK SAHU,Bharatiya Janata Party,643489,1249,644738,49.41,16 - CHHINDWARA (Madhya Pradesh),12,16
2.0,NAKUL KAMALNATH,Indian National Congress,529931,1189,531120,40.7,16 - CHHINDWARA (Madhya Pradesh),12,16
3.0,DEVIRAM URF DEV RAVEN BHALAVI,Gondvana Gantantra Party,55854,134,55988,4.29,16 - CHHINDWARA (Madhya Pradesh),12,16
4.0,UMAKANT BANDEWAR,Bahujan Samaj Party,11802,21,11823,0.91,16 - CHHINDWARA (Madhya Pradesh),12,16
5.0,KAPIL SONI,Rashtriya Gondvana Party,9634,4,9638,0.74,16 - CHHINDWARA (Madhya Pradesh),12,16
6.0,SIRAJ SHEKH,Independent,9567,1,9568,0.73,16 - CHHINDWARA (Madhya Pradesh),12,16
7.0,PAWANSHAH SARYAM,Independent,6612,9,6621,0.51,16 - CHHINDWARA (Madhya Pradesh),12,16
8.0,SUBHASH SHUKLA,Independent,5768,1,5769,0.44,16 - CHHINDWARA (Madhya Pradesh),12,16
9.0,RAJENDRA DONGRE,Independent,4628,4,4632,0.35,16 - CHHINDWARA (Madhya Pradesh),12,16
10.0,GOVIND BHALAVI,Independent,4022,7,4029,0.31,16 - CHHINDWARA (Madhya Pradesh),12,16
11.0,MOHD. PARVEZ QURESHI,Independent,3818,10,3828,0.29,16 - CHHINDWARA (Madhya Pradesh),12,16
12.0,AJAY BARKADE,Independent,2491,4,2495,0.19,16 - CHHINDWARA (Madhya Pradesh),12,16
13.0,KUSHWAHA RAJESH TANTRIK,Ahinsa Samaj Party,1695,3,1698,0.13,16 - CHHINDWARA (Madhya Pradesh),12,16
14.0,""" PRAKASH ALIAS BANTY "" PARTETI",Rashtra Samarpan Party,1652,2,1654,0.13,16 - CHHINDWARA (Madhya Pradesh),12,16
15.0,FOGAL BANSOD,Republican Party of India (A),1322,1,1323,0.1,16 - CHHINDWARA (Madhya Pradesh),12,16
16.0,NOTA,None of the Above,9887,16,9903,0.76,16 - CHHINDWARA (Madhya Pradesh),12,16
,Total,,1302172,2655,1304827,,16 - CHHINDWARA (Madhya Pradesh),12,16
1.0,DARSHAN SINGH CHOUDHARY,Bharatiya Janata Party,810529,1618,812147,64.99,17 - HOSHANGABAD (Madhya Pradesh),12,17
2.0,SANJAY SHARMA SANJU BHAIYA,Indian National Congress,379868,583,380451,30.44,17 - HOSHANGABAD (Madhya Pradesh),12,17
3.0,RAMGOVIND BARUAA,Bahujan Samaj Party,15344,43,15387,1.23,17 - HOSHANGABAD (Madhya Pradesh),12,17
4.0,PANDIT DIVYENDRA BRIJMOHAN DUBEY ADVOCATE,Bharatiya Yuva Jan Ekta Party,6157,11,6168,0.49,17 - HOSHANGABAD (Madhya Pradesh),12,17
5.0,RAKESH RAMPRASAD RICKY,Independent,5071,8,5079,0.41,17 - HOSHANGABAD (Madhya Pradesh),12,17
6.0,SARJERAO SAHARE,Independent,4487,6,4493,0.36,17 - HOSHANGABAD (Madhya Pradesh),12,17
7.0,PATRAKAR TILAK JATAV,Independent,2257,3,2260,0.18,17 - HOSHANGABAD (Madhya Pradesh),12,17
8.0,YUVRAJ GAVADE,Independent,2205,10,2215,0.18,17 - HOSHANGABAD (Madhya Pradesh),12,17
9.0,JYOTI SURESH JHARIYA,Independent,2033,13,2046,0.16,17 - HOSHANGABAD (Madhya Pradesh),12,17
10.0,MAKHAN SINGH LODHI,Bhartiya Shakti Chetna Party,1651,6,1657,0.13,17 - HOSHANGABAD (Madhya Pradesh),12,17
11.0,MUKESH YADAV,Independent,1578,10,1588,0.13,17 - HOSHANGABAD (Madhya Pradesh),12,17
12.0,PANDIT BRAJESH KHEMARIYA,Independent,1251,9,1260,0.1,17 - HOSHANGABAD (Madhya Pradesh),12,17
13.0,NOTA,None of the Above,14927,14,14941,1.2,17 - HOSHANGABAD (Madhya Pradesh),12,17
,Total,,1247358,2334,1249692,,17 - HOSHANGABAD (Madhya Pradesh),12,17
1.0,SHIVRAJ SINGH CHOUHAN,Bharatiya Janata Party,1111556,4904,1116460,76.7,18 - VIDISHA (Madhya Pradesh),12,18
2.0,PRATAPBHANU SHARMA,Indian National Congress,293537,1515,295052,20.27,18 - VIDISHA (Madhya Pradesh),12,18
3.0,KISHAN LAL LADIYA,Bahujan Samaj Party,10734,82,10816,0.74,18 - VIDISHA (Madhya Pradesh),12,18
4.0,KAMLESH KUMAR GOUR,Jai Prakash Janata Dal,8167,11,8178,0.56,18 - VIDISHA (Madhya Pradesh),12,18
5.0,DHOOLSINGH DHAMMA,Independent,3417,7,3424,0.24,18 - VIDISHA (Madhya Pradesh),12,18
6.0,SATYENDRA SINGH SISODIYA,Independent,2921,4,2925,0.2,18 - VIDISHA (Madhya Pradesh),12,18
7.0,DHARMVIR BHARTI,Akhil Bhartiya Parivar Party,2809,10,2819,0.19,18 - VIDISHA (Madhya Pradesh),12,18
8.0,ABDUL RASHID,Independent,1679,3,1682,0.12,18 - VIDISHA (Madhya Pradesh),12,18
9.0,BHAI MUNSHILAL SILAWAT,Public Political Party,1114,3,1117,0.08,18 - VIDISHA (Madhya Pradesh),12,18
10.0,ABDUL JABBAR,Independent,1076,6,1082,0.07,18 - VIDISHA (Madhya Pradesh),12,18
11.0,SEEMA SHARMA,Sapaks Party,1065,8,1073,0.07,18 - VIDISHA (Madhya Pradesh),12,18
12.0,DHARMENDRA SINGH PANWAR (GOLU BHAIYA),Right to Recall Party,1025,1,1026,0.07,18 - VIDISHA (Madhya Pradesh),12,18
13.0,BHEEKAM SINGH KUSHWAHA,Mahanwadi Party,720,4,724,0.05,18 - VIDISHA (Madhya Pradesh),12,18
14.0,NOTA,None of the Above,9218,62,9280,0.64,18 - VIDISHA (Madhya Pradesh),12,18
,Total,,1449038,6620,1455658,,18 - VIDISHA (Madhya Pradesh),12,18
1.0,ALOK SHARMA,Bharatiya Janata Party,978285,2824,981109,65.48,19 - BHOPAL (Madhya Pradesh),12,19
2.0,ADVOCATE ARUN SHRIVASTAVA,Indian National Congress,478698,912,479610,32.01,19 - BHOPAL (Madhya Pradesh),12,19
3.0,BHANU PRATAP SINGH,Bahujan Samaj Party,13255,50,13305,0.89,19 - BHOPAL (Madhya Pradesh),12,19
4.0,DEENDAYAL AHIRWAR URF DEENU BHAIYA,Independent,3639,2,3641,0.24,19 - BHOPAL (Madhya Pradesh),12,19
5.0,JAY SINGH,Independent,2509,1,2510,0.17,19 - BHOPAL (Madhya Pradesh),12,19
6.0,BHARTI YADAV,Independent,1833,6,1839,0.12,19 - BHOPAL (Madhya Pradesh),12,19
7.0,ANKIT RAI,Independent,1100,1,1101,0.07,19 - BHOPAL (Madhya Pradesh),12,19
8.0,DHANRAJ SHENDE,Republican Party of India (A),788,2,790,0.05,19 - BHOPAL (Madhya Pradesh),12,19
9.0,AJAY KUMAR PATHAK,Chhatrapati Shivaji Bhartiya Garib Party,787,3,790,0.05,19 - BHOPAL (Madhya Pradesh),12,19
10.0,MOHAMMAD ASHRAF,Independent,777,1,778,0.05,19 - BHOPAL (Madhya Pradesh),12,19
11.0,BABULAL SEN,Moulik Adhikar Party,718,2,720,0.05,19 - BHOPAL (Madhya Pradesh),12,19
12.0,SANJAY KUMAR SAROJ,Manav Samadhan Party,621,1,622,0.04,19 - BHOPAL (Madhya Pradesh),12,19
13.0,BALRAM SINGH TAUMAR,Bhartiya Shakti Chetna Party,587,1,588,0.04,19 - BHOPAL (Madhya Pradesh),12,19
14.0,RAMPRASAD PATEL,Kranti Janshakti Party,572,3,575,0.04,19 - BHOPAL (Madhya Pradesh),12,19
15.0,MUDIT CHAURASIA,Akhil Bhartiya Aarakshit Samaj Party,541,3,544,0.04,19 - BHOPAL (Madhya Pradesh),12,19
16.0,MUDIT BHATNAGAR,Socialist Unity Centre Of India (COMMUNIST),537,3,540,0.04,19 - BHOPAL (Madhya Pradesh),12,19
17.0,R.K. MAHAJAN,Independent,527,2,529,0.04,19 - BHOPAL (Madhya Pradesh),12,19
18.0,ABDUL TAHIR ADVOCATE (BABLU RAJNIKANT) S/O SAEED PAHELWAN ANSARI,Bahujan Maha Party,473,-,473,0.03,19 - BHOPAL (Madhya Pradesh),12,19
19.0,MAITHILI SHARAN GUPTA,Independent,447,1,448,0.03,19 - BHOPAL (Madhya Pradesh),12,19
20.0,RAJESH KEER,Independent,427,-,427,0.03,19 - BHOPAL (Madhya Pradesh),12,19
21.0,AKSHAY GOTHI,Parivartan Party of India,403,4,407,0.03,19 - BHOPAL (Madhya Pradesh),12,19
22.0,HITENDRA SHAHARE (BABA),Independent,318,-,318,0.02,19 - BHOPAL (Madhya Pradesh),12,19
23.0,NOTA,None of the Above,6573,48,6621,0.44,19 - BHOPAL (Madhya Pradesh),12,19
,Total,,1494415,3870,1498285,,19 - BHOPAL (Madhya Pradesh),12,19
1.0,RODMAL NAGAR,Bharatiya Janata Party,756139,2604,758743,53.1,20 - RAJGARH (Madhya Pradesh),12,20
2.0,DIGVIJAYA SINGH,Indian National Congress,610602,2052,612654,42.87,20 - RAJGARH (Madhya Pradesh),12,20
3.0,DR. RAJENDRA SURYAVANSHI,Bahujan Samaj Party,13902,40,13942,0.98,20 - RAJGARH (Madhya Pradesh),12,20
4.0,ASHOK PAWAR,Samata Samadhan Party,6597,17,6614,0.46,20 - RAJGARH (Madhya Pradesh),12,20
5.0,JITENDRA SINGH,National World Leader Party,5051,12,5063,0.35,20 - RAJGARH (Madhya Pradesh),12,20
6.0,DINESH RAZAWAT,Aazad Samaj Party (Kanshi Ram),4170,9,4179,0.29,20 - RAJGARH (Madhya Pradesh),12,20
7.0,RODMAL,Independent,3733,11,3744,0.26,20 - RAJGARH (Madhya Pradesh),12,20
8.0,ANIL JAIN,Independent,3069,20,3089,0.22,20 - RAJGARH (Madhya Pradesh),12,20
9.0,RADHESHYAM MALVIYA,Independent,2796,3,2799,0.2,20 - RAJGARH (Madhya Pradesh),12,20
10.0,SUNEEL BHEEL,Independent,2703,10,2713,0.19,20 - RAJGARH (Madhya Pradesh),12,20
11.0,VISHAL SONI (ADVOCATE),Bharatiya Yuva Jan Ekta Party,2544,16,2560,0.18,20 - RAJGARH (Madhya Pradesh),12,20
12.0,JAGDISH KARPENTER,Independent,1730,4,1734,0.12,20 - RAJGARH (Madhya Pradesh),12,20
13.0,ANIL,Independent,1414,4,1418,0.1,20 - RAJGARH (Madhya Pradesh),12,20
14.0,RAMCHARAN PIRJAPATI,Lok Samaj Party,1292,2,1294,0.09,20 - RAJGARH (Madhya Pradesh),12,20
15.0,BABU SINGH,Sajag Samaj Party,1186,5,1191,0.08,20 - RAJGARH (Madhya Pradesh),12,20
16.0,NOTA,None of the Above,7248,12,7260,0.51,20 - RAJGARH (Madhya Pradesh),12,20
,Total,,1424176,4821,1428997,,20 - RAJGARH (Madhya Pradesh),12,20
1.0,MAHENDRA SINGH SOLANKY,Bharatiya Janata Party,925917,3024,928941,63.23,21 - DEWAS (Madhya Pradesh),12,21
2.0,RAJENDRA RADHAKISHAN MALVIYA,Indian National Congress,502548,1168,503716,34.29,21 - DEWAS (Madhya Pradesh),12,21
3.0,RAJENDRASINGH CHOKHUTIYA,Bahujan Samaj Party,11162,41,11203,0.76,21 - DEWAS (Madhya Pradesh),12,21
4.0,RAMPRASAD,Aazad Samaj Party (Kanshi Ram),7201,19,7220,0.49,21 - DEWAS (Madhya Pradesh),12,21
5.0,NITIN VERMA,Independent,2756,5,2761,0.19,21 - DEWAS (Madhya Pradesh),12,21
6.0,ADVOCATE VIDAYARAJ MALAVIY,Social Democratic Party Of India,2026,5,2031,0.14,21 - DEWAS (Madhya Pradesh),12,21
7.0,ENG. DEEPAK RAMESH CHANDRA VICHITRA,Independent,1585,10,1595,0.11,21 - DEWAS (Madhya Pradesh),12,21
8.0,HEMRAJ POONAMCHANDRA BAMNIYA,Public Political Party,1236,12,1248,0.08,21 - DEWAS (Madhya Pradesh),12,21
9.0,NOTA,None of the Above,10365,24,10389,0.71,21 - DEWAS (Madhya Pradesh),12,21
,Total,,1464796,4308,1469104,,21 - DEWAS (Madhya Pradesh),12,21
1.0,ANIL FIROJIYA,Bharatiya Janata Party,834374,1730,836104,62.93,22 - UJJAIN (Madhya Pradesh),12,22
2.0,MAHESH PARMAR,Indian National Congress,459531,713,460244,34.64,22 - UJJAIN (Madhya Pradesh),12,22
3.0,ADVOCATE PRAKASH CHOUHAN,Bahujan Samaj Party,9502,16,9518,0.72,22 - UJJAIN (Madhya Pradesh),12,22
4.0,DR. HEMANT PARMAR,Bhim Sena,4973,3,4976,0.37,22 - UJJAIN (Madhya Pradesh),12,22
5.0,SURESH BAGARI,Independent,2786,5,2791,0.21,22 - UJJAIN (Madhya Pradesh),12,22
6.0,MAHESH PARMAR,Independent,2468,8,2476,0.19,22 - UJJAIN (Madhya Pradesh),12,22
7.0,GANGA MALVIYA,Independent,1288,7,1295,0.1,22 - UJJAIN (Madhya Pradesh),12,22
8.0,ANIL,Independent,979,2,981,0.07,22 - UJJAIN (Madhya Pradesh),12,22
9.0,ISHWARLAL VARSHI,Independent,860,3,863,0.06,22 - UJJAIN (Madhya Pradesh),12,22
10.0,NOTA,None of the Above,9310,22,9332,0.7,22 - UJJAIN (Madhya Pradesh),12,22
,Total,,1326071,2509,1328580,,22 - UJJAIN (Madhya Pradesh),12,22
1.0,SUDHEER GUPTA,Bharatiya Janata Party,942249,3512,945761,65.98,23 - MANDSOUR (Madhya Pradesh),12,23
2.0,DILIP SINGH GURJAR,Indian National Congress,443622,1484,445106,31.05,23 - MANDSOUR (Madhya Pradesh),12,23
3.0,KANHAIYALAL MALVIYA,Bahujan Samaj Party,10456,56,10512,0.73,23 - MANDSOUR (Madhya Pradesh),12,23
4.0,ISMAIL KHAN MAIV,Independent,8810,16,8826,0.62,23 - MANDSOUR (Madhya Pradesh),12,23
5.0,SUSHIL,Independent,3432,7,3439,0.24,23 - MANDSOUR (Madhya Pradesh),12,23
6.0,SAEED AHAMAD,Independent,3165,2,3167,0.22,23 - MANDSOUR (Madhya Pradesh),12,23
7.0,MURALIDHAR,Independent,2682,14,2696,0.19,23 - MANDSOUR (Madhya Pradesh),12,23
8.0,VIJAY RANN,Independent,2314,9,2323,0.16,23 - MANDSOUR (Madhya Pradesh),12,23
9.0,NOTA,None of the Above,11615,47,11662,0.81,23 - MANDSOUR (Madhya Pradesh),12,23
,Total,,1428345,5147,1433492,,23 - MANDSOUR (Madhya Pradesh),12,23
1.0,ANITA NAGARSINGH CHOUHAN,Bharatiya Janata Party,793432,2431,795863,51.93,24 - RATLAM (Madhya Pradesh),12,24
2.0,KANTILAL BHURIA,Indian National Congress,586904,1727,588631,38.41,24 - RATLAM (Madhya Pradesh),12,24
3.0,ENGINEER BALUSINGH GAMAD,Bharat Adivasi Party,52525,234,52759,3.44,24 - RATLAM (Madhya Pradesh),12,24
4.0,RAMCHANDRA SOLANKI,Bahujan Samaj Party,15159,13,15172,0.99,24 - RATLAM (Madhya Pradesh),12,24
5.0,SURAJ BHABHAR,Independent,10060,2,10062,0.66,24 - RATLAM (Madhya Pradesh),12,24
6.0,RANGLA KALESH,Independent,7331,4,7335,0.48,24 - RATLAM (Madhya Pradesh),12,24
7.0,KASNA RANA PARGI,Independent,7311,5,7316,0.48,24 - RATLAM (Madhya Pradesh),12,24
8.0,SUMITRA MEDA,Independent,6927,3,6930,0.45,24 - RATLAM (Madhya Pradesh),12,24
9.0,RAMESHWAR SINGAR,Independent,4603,4,4607,0.3,24 - RATLAM (Madhya Pradesh),12,24
10.0,MOHANSINGH NINGWAL,Bhartiya Samajik Party,4503,4,4507,0.29,24 - RATLAM (Madhya Pradesh),12,24
11.0,SHEETAL BARELA,Akhand Bharat Samrajya Party,3929,1,3930,0.26,24 - RATLAM (Madhya Pradesh),12,24
12.0,UDESINGH MACHAR,Republican Party of India (A),3795,1,3796,0.25,24 - RATLAM (Madhya Pradesh),12,24
13.0,NOTA,None of the Above,31697,38,31735,2.07,24 - RATLAM (Madhya Pradesh),12,24
,Total,,1528176,4467,1532643,,24 - RATLAM (Madhya Pradesh),12,24
1.0,SAVITRI THAKUR,Bharatiya Janata Party,792591,1858,794449,55.75,25 - DHAR (Madhya Pradesh),12,25
2.0,RADHESHYAM MUVEL,Indian National Congress,574756,1028,575784,40.4,25 - DHAR (Madhya Pradesh),12,25
3.0,DHUMSINGH MANDLOI MACHHAR,Bahujan Samaj Party,14926,30,14956,1.05,25 - DHAR (Madhya Pradesh),12,25
4.0,JITENDRA MUNIYA,Bharat Adivasi Party,10586,35,10621,0.75,25 - DHAR (Madhya Pradesh),12,25
5.0,SUNIL AJRAWAT,Independent,5400,8,5408,0.38,25 - DHAR (Madhya Pradesh),12,25
6.0,SHIVAJI PATEL KALMI,Independent,4694,6,4700,0.33,25 - DHAR (Madhya Pradesh),12,25
7.0,VIKRAM VASUNIYA,Janata Congress,3464,11,3475,0.24,25 - DHAR (Madhya Pradesh),12,25
8.0,NOTA,None of the Above,15612,39,15651,1.1,25 - DHAR (Madhya Pradesh),12,25
,Total,,1422029,3015,1425044,,25 - DHAR (Madhya Pradesh),12,25
1.0,SHANKAR LALWANI,Bharatiya Janata Party,1223746,3005,1226751,78.54,26 - INDORE (Madhya Pradesh),12,26
2.0,SANJAY S/O LAKSHMAN SOLANKI,Bahujan Samaj Party,51486,173,51659,3.31,26 - INDORE (Madhya Pradesh),12,26
3.0,PAWAN KUMAR,Akhil Bhartiya Parivar Party,15182,28,15210,0.97,26 - INDORE (Madhya Pradesh),12,26
4.0,ABHAY JAIN,Independent,8379,13,8392,0.54,26 - INDORE (Madhya Pradesh),12,26
5.0,LAVISH DILIP KHANDELWAL,Independent,8231,7,8238,0.53,26 - INDORE (Madhya Pradesh),12,26
6.0,COMRADE AJEET SINGH,Socialist Unity Centre Of India (COMMUNIST),7148,31,7179,0.46,26 - INDORE (Madhya Pradesh),12,26
7.0,AYAZ ALI,Independent,7074,22,7096,0.45,26 - INDORE (Madhya Pradesh),12,26
8.0,ENG. ARJUN PARIHAR,Independent,3823,8,3831,0.25,26 - INDORE (Madhya Pradesh),12,26
9.0,BASANT GEHLOT,Jan Sangh Party,3663,13,3676,0.24,26 - INDORE (Madhya Pradesh),12,26
10.0,RAVI SIRWAIYA,Independent,2615,6,2621,0.17,26 - INDORE (Madhya Pradesh),12,26
11.0,MUDIT CHAURASIA,Independent,2601,8,2609,0.17,26 - INDORE (Madhya Pradesh),12,26
12.0,PARMANAND TOLANI,Independent,2399,4,2403,0.15,26 - INDORE (Madhya Pradesh),12,26
13.0,DESH BHAKT ANKIT GUPTA,Independent,1957,12,1969,0.13,26 - INDORE (Madhya Pradesh),12,26
14.0,ADVOCATE PANKAJ GUPTE,Independent,1652,8,1660,0.11,26 - INDORE (Madhya Pradesh),12,26
15.0,NOTA,None of the Above,218355,319,218674,14.0,26 - INDORE (Madhya Pradesh),12,26
,Total,,1558311,3657,1561968,,26 - INDORE (Madhya Pradesh),12,26
1.0,GAJENDRA SINGH PATEL,Bharatiya Janata Party,818291,1572,819863,52.6,27 - KHARGONE (Madhya Pradesh),12,27
2.0,PORLAL BATHA KHARTE,Indian National Congress,683651,1194,684845,43.93,27 - KHARGONE (Madhya Pradesh),12,27
3.0,DEVISINGH NARGAVE,Communist Party of India,14680,6,14686,0.94,27 - KHARGONE (Madhya Pradesh),12,27
4.0,SHOBHARAM DAWAR,Bahujan Samaj Party,12047,22,12069,0.77,27 - KHARGONE (Madhya Pradesh),12,27
5.0,NARSINGH SOLANKI,Independent,9052,6,9058,0.58,27 - KHARGONE (Madhya Pradesh),12,27
6.0,NOTA,None of the Above,18237,20,18257,1.17,27 - KHARGONE (Madhya Pradesh),12,27
,Total,,1555958,2820,1558778,,27 - KHARGONE (Madhya Pradesh),12,27
1.0,GYANESHWAR PATIL,Bharatiya Janata Party,861188,1491,862679,57.04,28 - KHANDWA (Madhya Pradesh),12,28
2.0,NARENDRA PATEL,Indian National Congress,591540,1168,592708,39.19,28 - KHANDWA (Madhya Pradesh),12,28
3.0,MUNNALAL S/O DHANNALAL TEJI,Bahujan Samaj Party,11796,22,11818,0.78,28 - KHANDWA (Madhya Pradesh),12,28
4.0,ABHINESH SINGH,Rashtriya Jan Awaz Party,9295,4,9299,0.61,28 - KHANDWA (Madhya Pradesh),12,28
5.0,LAXMI NARAYAN KATARE,Independent,4902,3,4905,0.32,28 - KHANDWA (Madhya Pradesh),12,28
6.0,MANOJ KUMAR VISHWAMBHARNATH AGRAWAL,Independent,4346,1,4347,0.29,28 - KHANDWA (Madhya Pradesh),12,28
7.0,MAHESH PAWAR,Peoples Party of India (Democratic),3701,8,3709,0.25,28 - KHANDWA (Madhya Pradesh),12,28
8.0,SHIVAM SEN,Independent,3479,2,3481,0.23,28 - KHANDWA (Madhya Pradesh),12,28
9.0,RAVINDRA SONVANE,Independent,2679,6,2685,0.18,28 - KHANDWA (Madhya Pradesh),12,28
10.0,PRAKASH RATHOR BANJARA,Aam Janta Party (India),2368,2,2370,0.16,28 - KHANDWA (Madhya Pradesh),12,28
11.0,NARAYAN SUKHADEV PAL,Bharatiya Yuva Jan Ekta Party,1699,3,1702,0.11,28 - KHANDWA (Madhya Pradesh),12,28
12.0,NOTA,None of the Above,12817,22,12839,0.85,28 - KHANDWA (Madhya Pradesh),12,28
,Total,,1509810,2732,1512542,,28 - KHANDWA (Madhya Pradesh),12,28
1.0,DURGADAS (D. D.) UIKEY,Bharatiya Janata Party,846696,1540,848236,60.76,29 - BETUL (Madhya Pradesh),12,29
2.0,RAMU TEKAM,Indian National Congress,467810,665,468475,33.56,29 - BETUL (Madhya Pradesh),12,29
3.0,ARJUN ASHOK BHALAVI,Bahujan Samaj Party,26559,38,26597,1.91,29 - BETUL (Madhya Pradesh),12,29
4.0,ANIL UIKEY,Bharat Adivasi Party,10552,24,10576,0.76,29 - BETUL (Madhya Pradesh),12,29
5.0,BHURELAL CHOTELAL BETHEKAR,Independent,7800,11,7811,0.56,29 - BETUL (Madhya Pradesh),12,29
6.0,BHAGCHARAN WARKADE,Independent,5957,11,5968,0.43,29 - BETUL (Madhya Pradesh),12,29
7.0,SUNER UIKEY,Gondvana Gantantra Party,4172,14,4186,0.3,29 - BETUL (Madhya Pradesh),12,29
8.0,BARSKAR SUBHASH KORAKU,Swatantra Kisan Party,3831,18,3849,0.28,29 - BETUL (Madhya Pradesh),12,29
9.0,NOTA,None of the Above,20309,13,20322,1.46,29 - BETUL (Madhya Pradesh),12,29
,Total,,1393686,2334,1396020,,29 - BETUL (Madhya Pradesh),12,29
1.0,ADV GOWAAL KAGADA PADAVI,Indian National Congress,744879,1119,745998,53.53,1 - Nandurbar (Maharashtra),13,1
2.0,DR HEENA VIJAYKUMAR GAVIT,Bharatiya Janata Party,585847,1031,586878,42.11,1 - Nandurbar (Maharashtra),13,1
3.0,ANANDA SUKALAL KOLI,Bahujan Samaj Party,10628,16,10644,0.76,1 - Nandurbar (Maharashtra),13,1
4.0,SUSHILKUMAR JAHANGIR PAWARA,Independent,8878,9,8887,0.64,1 - Nandurbar (Maharashtra),13,1
5.0,NIRMALA VASAVE,Peoples Party of India (Democratic),6923,24,6947,0.5,1 - Nandurbar (Maharashtra),13,1
6.0,ROHIDAS GEMAJI VALVI,Independent,4941,6,4947,0.35,1 - Nandurbar (Maharashtra),13,1
7.0,HEMANT MANSARAM KOLI,Vanchit Bahujan Aaghadi,4062,19,4081,0.29,1 - Nandurbar (Maharashtra),13,1
8.0,DEEPAKKUMAR MADHUKAR SHIRSATH,Independent,3567,4,3571,0.26,1 - Nandurbar (Maharashtra),13,1
9.0,RAVINDRA RANJIT VALVI,Bharat Adivasi Party,2608,17,2625,0.19,1 - Nandurbar (Maharashtra),13,1
10.0,JALAMSING SUTUM PAWAR,Independent,2583,4,2587,0.19,1 - Nandurbar (Maharashtra),13,1
11.0,GITANJALI SHASHIKANT KOLI,Independent,2372,9,2381,0.17,1 - Nandurbar (Maharashtra),13,1
12.0,NOTA,None of the Above,14108,15,14123,1.01,1 - Nandurbar (Maharashtra),13,1
,Total,,1391396,2273,1393669,,1 - Nandurbar (Maharashtra),13,1
1.0,BACHHAV SHOBHA DINESH,Indian National Congress,582492,1374,583866,47.89,2 - Dhule (Maharashtra),13,2
2.0,BHAMRE SUBHASH RAMRAO,Bharatiya Janata Party,577778,2257,580035,47.57,2 - Dhule (Maharashtra),13,2
3.0,BHARAT BABURAO JADHAV,Independent,19695,18,19713,1.62,2 - Dhule (Maharashtra),13,2
4.0,ZAHOOR AHAMAD MOHAMAD YUSUF (JAM JAM),Bahujan Samaj Party,4955,18,4973,0.41,2 - Dhule (Maharashtra),13,2
5.0,SANJAY RAMESHWAR SHARMA,Independent,3741,5,3746,0.31,2 - Dhule (Maharashtra),13,2
6.0,SHAFEEQUE AHEMAD MD. RAFEEQUE,Independent,3706,1,3707,0.3,2 - Dhule (Maharashtra),13,2
7.0,NAMDEO ROHIDAS YELAVE,Bharatheeya Jawan Kisan Party,3659,24,3683,0.3,2 - Dhule (Maharashtra),13,2
8.0,ADV SACHIN UMAJI NIKAM,Independent,3657,3,3660,0.3,2 - Dhule (Maharashtra),13,2
9.0,RAJ CHAVAN,Independent,3443,9,3452,0.28,2 - Dhule (Maharashtra),13,2
10.0,MOHAMMAD ISMAIL JUMMAN,Independent,1084,1,1085,0.09,2 - Dhule (Maharashtra),13,2
11.0,SURESH JAGANNATH BRAHMANKAR (SURESH BAPU),Independent,1035,3,1038,0.09,2 - Dhule (Maharashtra),13,2
12.0,PATIL SHIVAJI NATHU,All India Forward Bloc,994,7,1001,0.08,2 - Dhule (Maharashtra),13,2
13.0,SHAIKH MOHAMMAD ZAID SHAMIM AHMED,Welfare Party Of India,946,5,951,0.08,2 - Dhule (Maharashtra),13,2
14.0,MOHAMMAD AAMEEN MOHAMMAD FARUQUE,Independent,833,2,835,0.07,2 - Dhule (Maharashtra),13,2
15.0,MUQEEM MEENA NAGRI,Bhim Sena,773,8,781,0.06,2 - Dhule (Maharashtra),13,2
16.0,IRFAN. MO. ISHAK (NADIR),Independent,763,-,763,0.06,2 - Dhule (Maharashtra),13,2
17.0,MALAY PRAKASH PATIL,Independent,734,2,736,0.06,2 - Dhule (Maharashtra),13,2
18.0,ABDUL HAFEEZ ABDUL HAQUE,Independent,576,1,577,0.05,2 - Dhule (Maharashtra),13,2
19.0,NOTA,None of the Above,4661,32,4693,0.38,2 - Dhule (Maharashtra),13,2
,Total,,1215525,3770,1219295,,2 - Dhule (Maharashtra),13,2
1.0,SMITA UDAY WAGH,Bharatiya Janata Party,672119,2309,674428,57.67,3 - Jalgaon (Maharashtra),13,3
2.0,KARAN BALASAHEB PATIL - PAWAR,Shiv Sena (Uddhav Balasaheb Thackrey),421213,1621,422834,36.15,3 - Jalgaon (Maharashtra),13,3
3.0,YUVRAJ JADHAV (SAMBHA AAPPA),Vanchit Bahujan Aaghadi,21062,115,21177,1.81,3 - Jalgaon (Maharashtra),13,3
4.0,EX-HAVILDAR ISHWAR DAYARAM MORE,Sainik Samaj Party,7479,69,7548,0.65,3 - Jalgaon (Maharashtra),13,3
5.0,VILAS SHANKAR TAYADE,Bahujan Samaj Party,6310,71,6381,0.55,3 - Jalgaon (Maharashtra),13,3
6.0,LALIT (BANTI) SHARMA,Independent,4189,3,4192,0.36,3 - Jalgaon (Maharashtra),13,3
7.0,KARAN PAWAR,Independent,3954,29,3983,0.34,3 - Jalgaon (Maharashtra),13,3
8.0,ADVOCATE VIJAY BABULAL DANEJ,Independent,3400,4,3404,0.29,3 - Jalgaon (Maharashtra),13,3
9.0,MUKESH MULCHAND KOLI,Independent,3358,12,3370,0.29,3 - Jalgaon (Maharashtra),13,3
10.0,MAHENDRA DEVRAM KOLI,Independent,2462,14,2476,0.21,3 - Jalgaon (Maharashtra),13,3
11.0,AHMAD KHAN,Independent,1889,12,1901,0.16,3 - Jalgaon (Maharashtra),13,3
12.0,ABDUL SHAKUR DESHPANDE,Independent,1593,13,1606,0.14,3 - Jalgaon (Maharashtra),13,3
13.0,ADV. NAMDEO PANDURANG KOLI,Independent,1212,12,1224,0.1,3 - Jalgaon (Maharashtra),13,3
14.0,PATIL SANDIP YUVRAJ,Independent,1098,12,1110,0.09,3 - Jalgaon (Maharashtra),13,3
15.0,NOTA,None of the Above,13878,41,13919,1.19,3 - Jalgaon (Maharashtra),13,3
,Total,,1165216,4337,1169553,,3 - Jalgaon (Maharashtra),13,3
1.0,KHADSE RAKSHA NIKHIL,Bharatiya Janata Party,629558,1321,630879,53.84,4 - Raver (Maharashtra),13,4
2.0,SHRIRAM DAYARAM PATIL,Nationalist Congress Party – Sharadchandra Pawar,358030,666,358696,30.61,4 - Raver (Maharashtra),13,4
3.0,ER. SANJAY PANDIT BRAMHANE,Vanchit Bahujan Aaghadi,59001,119,59120,5.05,4 - Raver (Maharashtra),13,4
4.0,EKNATH NAGO SALUNKE,Independent,43957,25,43982,3.75,4 - Raver (Maharashtra),13,4
5.0,GULAB DAYARAM BHIL,Bharat Adivasi Party,9622,22,9644,0.82,4 - Raver (Maharashtra),13,4
6.0,MAMTA ALIAS MUMTAJ BHIKARI TADVI,Independent,7874,10,7884,0.67,4 - Raver (Maharashtra),13,4
7.0,VIJAY RAMKRUSHNA KALE,Bahujan Samaj Party,7551,26,7577,0.65,4 - Raver (Maharashtra),13,4
8.0,VASANT SHANKAR KOLTE,Independent,6713,5,6718,0.57,4 - Raver (Maharashtra),13,4
9.0,PRAVIN LAXMAN PATIL,Independent,6087,5,6092,0.52,4 - Raver (Maharashtra),13,4
10.0,YUVRAJ DEVSING BARELA,Independent,5131,4,5135,0.44,4 - Raver (Maharashtra),13,4
11.0,ASHOK BABURAO JADHAV,Peoples Party of India (Democratic),4686,4,4690,0.4,4 - Raver (Maharashtra),13,4
12.0,SHRIRAM SITARAM PATIL,Independent,4264,5,4269,0.36,4 - Raver (Maharashtra),13,4
13.0,JITENDRA PANDURANG PATIL,Independent,3582,5,3587,0.31,4 - Raver (Maharashtra),13,4
14.0,SANJAY PRALHAD KANDELKAR,Independent,2954,7,2961,0.25,4 - Raver (Maharashtra),13,4
15.0,SAGAR PRABHAKAR PATIL,Independent,2932,3,2935,0.25,4 - Raver (Maharashtra),13,4
16.0,SANJAYKUMAR LAXMAN WANKHEDE,Republican Party of India (Social),2277,5,2282,0.19,4 - Raver (Maharashtra),13,4
17.0,ANIL PITAMBAR WAGH (SIR),Independent,2265,13,2278,0.19,4 - Raver (Maharashtra),13,4
18.0,PROF. DR. ASHISH SUBHASH JADHAV,Independent,1919,8,1927,0.16,4 - Raver (Maharashtra),13,4
19.0,BHIVRAJ RAMDAS RAYSINGE,Independent,1807,2,1809,0.15,4 - Raver (Maharashtra),13,4
20.0,KOMALBAI BAPURAO PATIL,Independent,1424,5,1429,0.12,4 - Raver (Maharashtra),13,4
21.0,SHAIKH AABID SHAIKH BASHIR,Independent,1035,5,1040,0.09,4 - Raver (Maharashtra),13,4
22.0,AMIT HARIBHAU KOLTE,Independent,980,1,981,0.08,4 - Raver (Maharashtra),13,4
23.0,DR. YOGENDRA VITTHAL KOLTE,Independent,900,2,902,0.08,4 - Raver (Maharashtra),13,4
24.0,SHRIRAM OMKAR PATIL,Independent,743,6,749,0.06,4 - Raver (Maharashtra),13,4
25.0,NOTA,None of the Above,4073,27,4100,0.35,4 - Raver (Maharashtra),13,4
,Total,,1169365,2301,1171666,,4 - Raver (Maharashtra),13,4
1.0,JADHAV PRATAPRAO GANPATRAO,Shiv Sena,348289,1578,349867,31.53,5 - Buldhana (Maharashtra),13,5
2.0,NARENDRA DAGDU KHEDEKAR,Shiv Sena (Uddhav Balasaheb Thackrey),319415,973,320388,28.88,5 - Buldhana (Maharashtra),13,5
3.0,RAVIKANT CHANDRADAS TUPKAR,Independent,249042,921,249963,22.53,5 - Buldhana (Maharashtra),13,5
4.0,VASANTRAO RAJARAM MAGAR,Vanchit Bahujan Aaghadi,98093,348,98441,8.87,5 - Buldhana (Maharashtra),13,5
5.0,ASHOK WAMAN HIWALE,Independent,15414,22,15436,1.39,5 - Buldhana (Maharashtra),13,5
6.0,SANDEEP RAMRAO SHELKE,Independent,12993,57,13050,1.18,5 - Buldhana (Maharashtra),13,5
7.0,GAUTAM KISANRAO MAGHADE,Bahujan Samaj Party,8125,93,8218,0.74,5 - Buldhana (Maharashtra),13,5
8.0,ASLAM SHAH HASAN SHAH,Maharashtra Vikas Aghadi,6117,36,6153,0.55,5 - Buldhana (Maharashtra),13,5
9.0,NANDU JAGANNATH LAWANGE,Independent,5696,17,5713,0.51,5 - Buldhana (Maharashtra),13,5
10.0,MACHHINDRA SHESHRAV MAGHADE,Socialist Party (India),5247,11,5258,0.47,5 - Buldhana (Maharashtra),13,5
11.0,MOHAMMAD HASAN INAMDAR,Minorities Democratic Party,4966,12,4978,0.45,5 - Buldhana (Maharashtra),13,5
12.0,GAJANAN JANARDAN DHANDE,Independent,4841,13,4854,0.44,5 - Buldhana (Maharashtra),13,5
13.0,DINKAR TUKARAM SAMBARE,Independent,4550,14,4564,0.41,5 - Buldhana (Maharashtra),13,5
14.0,BALASAHEB RAMCHANDRA INGLE,Independent,3911,20,3931,0.35,5 - Buldhana (Maharashtra),13,5
15.0,PRATAP PANDHARINATH PATIL,Independent,2547,14,2561,0.23,5 - Buldhana (Maharashtra),13,5
16.0,SANTOSH BHIMRAO INGLE,Republican Party of India (A),2524,6,2530,0.23,5 - Buldhana (Maharashtra),13,5
17.0,MADHAVRAO SAKHARAM BANSODE,Bahujan Republican Socialist Party,2441,14,2455,0.22,5 - Buldhana (Maharashtra),13,5
18.0,VIKAS BHAI NANDAVE,Bhim Sena,2322,9,2331,0.21,5 - Buldhana (Maharashtra),13,5
19.0,UDDHAV ONKAR ATOLE,Independent,1946,22,1968,0.18,5 - Buldhana (Maharashtra),13,5
20.0,REKHA KAILAS POPHALKAR,Independent,1533,7,1540,0.14,5 - Buldhana (Maharashtra),13,5
21.0,PROF SUMANTAI TIRPUDE,Peoples Party of India (Democratic),1505,6,1511,0.14,5 - Buldhana (Maharashtra),13,5
22.0,NOTA,None of the Above,3750,36,3786,0.34,5 - Buldhana (Maharashtra),13,5
,Total,,1105267,4229,1109496,,5 - Buldhana (Maharashtra),13,5
1.0,ANUP SANJAY DHOTRE,Bharatiya Janata Party,454972,2058,457030,38.96,6 - Akola (Maharashtra),13,6
2.0,ABHAY KASHINATH PATIL,Indian National Congress,414557,1847,416404,35.5,6 - Akola (Maharashtra),13,6
3.0,AMBEDKAR PRAKASH YASHWANT,Vanchit Bahujan Aaghadi,275490,1257,276747,23.59,6 - Akola (Maharashtra),13,6
4.0,ADV NAJIB SHAIKH,Indian National League,3288,12,3300,0.28,6 - Akola (Maharashtra),13,6
5.0,KASHINATH VISHWANATH DHAMODE,Bahujan Samaj Party,2737,23,2760,0.24,6 - Akola (Maharashtra),13,6
6.0,MURLIDHAR LALSING PAWAR,Independent,2058,8,2066,0.18,6 - Akola (Maharashtra),13,6
7.0,ADHAU RAVIKANT RAMKRUSHNA,Jay Vidarbha Party,1710,24,1734,0.15,6 - Akola (Maharashtra),13,6
8.0,AACHARYADIP SUBHASHCHANDRA GANOJE,Independent,1610,8,1618,0.14,6 - Akola (Maharashtra),13,6
9.0,UJWALA VINAYAK RAUT,Independent,1298,8,1306,0.11,6 - Akola (Maharashtra),13,6
10.0,DHARMENDRA CHANDRAPRAKASH KOTHARI,Independent,1236,4,1240,0.11,6 - Akola (Maharashtra),13,6
11.0,DILIP SHATRUGHAN MHAISANE,Independent,860,2,862,0.07,6 - Akola (Maharashtra),13,6
12.0,ASHOK KISANRAO THORAT,Independent,573,8,581,0.05,6 - Akola (Maharashtra),13,6
13.0,MOHMMAD AJAZ MOHMMAD TAHER,Azad Adhikar Sena,564,4,568,0.05,6 - Akola (Maharashtra),13,6
14.0,BABAN MAHADEV SAYAM,Janseva Gondwana Party,535,2,537,0.05,6 - Akola (Maharashtra),13,6
15.0,PRITI PRAMOD SADANSHIV,Republican Party of India (Social),528,8,536,0.05,6 - Akola (Maharashtra),13,6
16.0,NOTA,None of the Above,5752,31,5783,0.49,6 - Akola (Maharashtra),13,6
,Total,,1167768,5304,1173072,,6 - Akola (Maharashtra),13,6
1.0,BALWANT BASWANT WANKHADE,Indian National Congress,524136,2135,526271,44.84,7 - Amravati (Maharashtra),13,7
2.0,NAVNEET RAVI RANA,Bharatiya Janata Party,504806,1734,506540,43.16,7 - Amravati (Maharashtra),13,7
3.0,DINESH GANESHDAS BUB,Prahar Janshakti Party,84985,315,85300,7.27,7 - Amravati (Maharashtra),13,7
4.0,ANANDRAJ YASHWANT AMBEDKAR,Republican Sena,18713,80,18793,1.6,7 - Amravati (Maharashtra),13,7
5.0,KISHOR BHIMRAO LABADE,Independent,4522,2,4524,0.39,7 - Amravati (Maharashtra),13,7
6.0,SANJAYKUMAR FATTESINGH GADGE,Bahujan Samaj Party,4485,28,4513,0.38,7 - Amravati (Maharashtra),13,7
7.0,SUMITRA SAHEBRAO GAIKWAD,Independent,2686,4,2690,0.23,7 - Amravati (Maharashtra),13,7
8.0,ARUN YASHWANTRAO BHAGAT,Independent,2086,2,2088,0.18,7 - Amravati (Maharashtra),13,7
9.0,KISHOR DNYANESHWAR TAYDE,Independent,2070,2,2072,0.18,7 - Amravati (Maharashtra),13,7
10.0,SURAJ DHANRAJ NAGDVANE,Independent,1815,3,1818,0.15,7 - Amravati (Maharashtra),13,7
11.0,GAUTAM ALIAS ANANTA RAMDAS INGALE,Independent,1570,-,1570,0.13,7 - Amravati (Maharashtra),13,7
12.0,PRAMOD RAMKRUSHNA CHOURPAGAR,Independent,1306,1,1307,0.11,7 - Amravati (Maharashtra),13,7
13.0,ANIL THAWARE ALIAS DR. ANILKUMAR NAGBUDDHA,Independent,1206,-,1206,0.1,7 - Amravati (Maharashtra),13,7
14.0,SURESH PUNDLIK MESHRAM,Independent,1051,1,1052,0.09,7 - Amravati (Maharashtra),13,7
15.0,SATISH YASHWANTRAO GEDAM,Independent,942,1,943,0.08,7 - Amravati (Maharashtra),13,7
16.0,MANOHAR KRUSHNAJI KURHADE,Independent,871,-,871,0.07,7 - Amravati (Maharashtra),13,7
17.0,DIGAMBAR WAMAN BHAGAT,Naki Bharatiya Ekta Party,760,2,762,0.06,7 - Amravati (Maharashtra),13,7
18.0,ENGI. AVINASH HARISHCHANDRA DHANAWATE,Peoples Party of India (Democratic),725,5,730,0.06,7 - Amravati (Maharashtra),13,7
19.0,HIMMAT BHIMRAO DHOLE,Independent,668,2,670,0.06,7 - Amravati (Maharashtra),13,7
20.0,SUSHAMA GAJANAN AWACHAR,Jay Vidarbha Party,656,3,659,0.06,7 - Amravati (Maharashtra),13,7
21.0,GANESH NANAJI RAMTEKE,Akhil Bhartiya Parivar Party,624,5,629,0.05,7 - Amravati (Maharashtra),13,7
22.0,MANKAR DNYANESHWAR KASHIRAO,Independent,538,1,539,0.05,7 - Amravati (Maharashtra),13,7
23.0,TARA SURESH WANKHADE,Independent,526,1,527,0.04,7 - Amravati (Maharashtra),13,7
24.0,SHRIKRUSHNA SAKHARAMJI KSHIRSAGAR,Independent,508,2,510,0.04,7 - Amravati (Maharashtra),13,7
25.0,ADV. RAJU MADHUKARRAO KALANE,Bahujan Bharat Party,495,-,495,0.04,7 - Amravati (Maharashtra),13,7
26.0,BHARAT CHAMPATRAO YANGAD,Independent,441,-,441,0.04,7 - Amravati (Maharashtra),13,7
27.0,VARSHA BHAGAWANTRAO BHAGAT,Independent,440,3,443,0.04,7 - Amravati (Maharashtra),13,7
28.0,NARENDRA BABULAL KATHANE,Desh Janhit Party,422,-,422,0.04,7 - Amravati (Maharashtra),13,7
29.0,PRABHAKAR PANDURANG BHATKAR,Independent,365,-,365,0.03,7 - Amravati (Maharashtra),13,7
30.0,ADV. PRUTHVISAMRAT MUKINDRAO DIPWANSH,Independent,335,2,337,0.03,7 - Amravati (Maharashtra),13,7
31.0,BHAURAO SAMPATRAO WANKHADE,All India Forward Bloc,328,1,329,0.03,7 - Amravati (Maharashtra),13,7
32.0,GHAZI SAADUDDIN ZAHEER AHMED,Rashtriya Ulama Council,325,6,331,0.03,7 - Amravati (Maharashtra),13,7
33.0,RAVI GUNWANTRAO WANKHADE,Independent,286,2,288,0.02,7 - Amravati (Maharashtra),13,7
34.0,SONALI SANJAY MESHRAM,Independent,270,2,272,0.02,7 - Amravati (Maharashtra),13,7
35.0,SANDEEP BABULAL MESHRAM,Independent,257,-,257,0.02,7 - Amravati (Maharashtra),13,7
36.0,RAJESH TULSHIRAM KHADE,Independent,239,-,239,0.02,7 - Amravati (Maharashtra),13,7
37.0,RAJU MAHADEVRAO SONONE,Independent,230,2,232,0.02,7 - Amravati (Maharashtra),13,7
38.0,NOTA,None of the Above,2517,27,2544,0.22,7 - Amravati (Maharashtra),13,7
,Total,,1169205,4374,1173579,,7 - Amravati (Maharashtra),13,7
1.0,AMAR SHARADRAO KALE,Nationalist Congress Party – Sharadchandra Pawar,530761,2345,533106,48.68,8 - Wardha (Maharashtra),13,8
2.0,RAMDAS CHANDRABHAN TADAS,Bharatiya Janata Party,449599,1859,451458,41.23,8 - Wardha (Maharashtra),13,8
3.0,DR. MOHAN RAMRAOJI RAIKWAR,Bahujan Samaj Party,20653,142,20795,1.9,8 - Wardha (Maharashtra),13,8
4.0,PROF. RAJENDRA GULABRAO SALUNKHE,Vanchit Bahujan Aaghadi,15408,84,15492,1.41,8 - Wardha (Maharashtra),13,8
5.0,ASIF,Independent,15176,6,15182,1.39,8 - Wardha (Maharashtra),13,8
6.0,KISHOR BABA PAVAR,Independent,12917,3,12920,1.18,8 - Wardha (Maharashtra),13,8
7.0,SUHAS V. THAKARE,Independent,7639,9,7648,0.7,8 - Wardha (Maharashtra),13,8
8.0,AKSHAY MEHARE BHARTIYA,Akhil Bhartiya Parivar Party,5446,21,5467,0.5,8 - Wardha (Maharashtra),13,8
9.0,MAROTI GULABRAO UIKE,Gondvana Gantantra Party,4651,21,4672,0.43,8 - Wardha (Maharashtra),13,8
10.0,ADV. BHASKAR MAROTRAO NEWARE,Independent,4021,11,4032,0.37,8 - Wardha (Maharashtra),13,8
11.0,JAGADISH UDDVRAO WANKHADE,Independent,2338,11,2349,0.21,8 - Wardha (Maharashtra),13,8
12.0,POOJA PANKAJ TADAS,Independent,2121,14,2135,0.19,8 - Wardha (Maharashtra),13,8
13.0,ANIL K. GHUSHE,Independent,1967,4,1971,0.18,8 - Wardha (Maharashtra),13,8
14.0,ASHISH LEKHIRAM IZANKAR,Vidarbha Rajya Aghadi,1819,9,1828,0.17,8 - Wardha (Maharashtra),13,8
15.0,VIJAY DNYANESHWARRAO SHRIRAO,Independent,1723,15,1738,0.16,8 - Wardha (Maharashtra),13,8
16.0,ARVIND SHAMRAO LILLORE,Independent,1475,1,1476,0.13,8 - Wardha (Maharashtra),13,8
17.0,RAMRAO BAJIRAO GHODASKAR,All India Forward Bloc,1418,20,1438,0.13,8 - Wardha (Maharashtra),13,8
18.0,KRUSHNA SUBHASHRAO FULKARI,Lok Swarajya Party,1342,1,1343,0.12,8 - Wardha (Maharashtra),13,8
19.0,UMESH SOMAJI WAWARE,Maharashtra Vikas Aghadi,1231,15,1246,0.11,8 - Wardha (Maharashtra),13,8
20.0,KRUSHNA ANNAJI KALODE,Hindrashtra Sangh,1052,9,1061,0.1,8 - Wardha (Maharashtra),13,8
21.0,RAMESH SINHA,Independent,799,-,799,0.07,8 - Wardha (Maharashtra),13,8
22.0,DR. MORESHWAR RAMJI NAGRALE,Republican Party of India,792,5,797,0.07,8 - Wardha (Maharashtra),13,8
23.0,DIXITA ANAND,Desh Janhit Party,731,5,736,0.07,8 - Wardha (Maharashtra),13,8
24.0,RAHUL T. BHOYAR,Independent,685,4,689,0.06,8 - Wardha (Maharashtra),13,8
25.0,NOTA,None of the Above,4583,51,4634,0.42,8 - Wardha (Maharashtra),13,8
,Total,,1090347,4665,1095012,,8 - Wardha (Maharashtra),13,8
1.0,Shyamkumar (Babalu) Daulat Barve,Indian National Congress,611894,1131,613025,48.94,9 - Ramtek (Maharashtra),13,9
2.0,RAJU DEONATH PARVE,Shiv Sena,535234,1023,536257,42.81,9 - Ramtek (Maharashtra),13,9
3.0,SANDIP SAHADEO MESHRAM,Bahujan Samaj Party,26003,95,26098,2.08,9 - Ramtek (Maharashtra),13,9
4.0,KISHORE UTTAMRAO GAJBHIYE,Independent,24324,59,24383,1.95,9 - Ramtek (Maharashtra),13,9
5.0,AJAY BAKARAM CHAVAN,Independent,6021,5,6026,0.48,9 - Ramtek (Maharashtra),13,9
6.0,SANVIDHAN G LOKHANDE,Baliraja Party,5810,4,5814,0.46,9 - Ramtek (Maharashtra),13,9
7.0,ROSHANI ATUL GAJBHIYE,Gondvana Gantantra Party,5108,29,5137,0.41,9 - Ramtek (Maharashtra),13,9
8.0,GOWARDHAN DEORAO KUMBHARE,Viro Ke Vir Indian Party,3750,16,3766,0.3,9 - Ramtek (Maharashtra),13,9
9.0,ARVIND SHIVAJI TANDEKAR,Independent,3208,7,3215,0.26,9 - Ramtek (Maharashtra),13,9
10.0,SANJAY VASANTRAO BORKAR,Maharashtra Vikas Aghadi,1983,9,1992,0.16,9 - Ramtek (Maharashtra),13,9
11.0,SHANKAR CHINTAMAN CHAHANDE,Vanchit Bahujan Aaghadi,1858,26,1884,0.15,9 - Ramtek (Maharashtra),13,9
12.0,ADV BHIMRAO SHENDE,Bahujan Republican Socialist Party,1811,7,1818,0.15,9 - Ramtek (Maharashtra),13,9
13.0,GAIKWAD MANJUSHA SACHIN,Akhil Bhartiya Parivar Party,1760,13,1773,0.14,9 - Ramtek (Maharashtra),13,9
14.0,ASHISH BHAURAO SARODE,Bhim Sena,1600,20,1620,0.13,9 - Ramtek (Maharashtra),13,9
15.0,PRAMOD SHRIPAT KHOBRAGADE,Ambedkarite Party of India,1337,3,1340,0.11,9 - Ramtek (Maharashtra),13,9
16.0,UMESH RAJU KHADSE,Rashtra Samarpan Party,1223,6,1229,0.1,9 - Ramtek (Maharashtra),13,9
17.0,SIDDHARTH GADIJI PATIL,Peoples Party of India (Democratic),975,2,977,0.08,9 - Ramtek (Maharashtra),13,9
18.0,PREMKUMAR DASHRATH GAJBHARE,Independent,921,4,925,0.07,9 - Ramtek (Maharashtra),13,9
19.0,RIDDHESHWAR ANANDRAO BELEY,Republican Party of India (A),908,5,913,0.07,9 - Ramtek (Maharashtra),13,9
20.0,BHOJRAJ TUKARAM SARODE,Jay Vidarbha Party,881,7,888,0.07,9 - Ramtek (Maharashtra),13,9
21.0,VILAS SHRIPAT KHADSE,Independent,857,3,860,0.07,9 - Ramtek (Maharashtra),13,9
22.0,SUBHASH LOKHANDE,Independent,849,1,850,0.07,9 - Ramtek (Maharashtra),13,9
23.0,KARTIK GENDLALJI DOKE,Independent,844,3,847,0.07,9 - Ramtek (Maharashtra),13,9
24.0,ADV ULHAS SHALIKRAM DUPARE,Independent,780,1,781,0.06,9 - Ramtek (Maharashtra),13,9
25.0,LAROKAR SURESH PUNDLIK,Independent,693,5,698,0.06,9 - Ramtek (Maharashtra),13,9
26.0,SUNIL UTTAMRAO SALVE,Independent,649,2,651,0.05,9 - Ramtek (Maharashtra),13,9
27.0,GOWARDHAN NAMDEO SOMDEVE,Independent,509,2,511,0.04,9 - Ramtek (Maharashtra),13,9
28.0,VILAS GANESH ZODAPE,Independent,402,5,407,0.03,9 - Ramtek (Maharashtra),13,9
29.0,NOTA,None of the Above,7769,58,7827,0.62,9 - Ramtek (Maharashtra),13,9
,Total,,1249961,2551,1252512,,9 - Ramtek (Maharashtra),13,9
1.0,NITIN JAIRAM GADKARI,Bharatiya Janata Party,652809,2218,655027,54.08,10 - Nagpur (Maharashtra),13,10
2.0,VIKAS THAKRE,Indian National Congress,515941,1483,517424,42.72,10 - Nagpur (Maharashtra),13,10
3.0,YOGIRAJ ALIAS YOGESH PATIRAM LANJEWAR,Bahujan Samaj Party,19164,78,19242,1.59,10 - Nagpur (Maharashtra),13,10
4.0,KIVINSUKA VIRENDRA SURYAVANSHI,Desh Janhit Party,2055,4,2059,0.17,10 - Nagpur (Maharashtra),13,10
5.0,ADARSH RAVISHANKAR THAKUR,Independent,1749,1,1750,0.14,10 - Nagpur (Maharashtra),13,10
6.0,ADV ULHAS SHALIKRAM DUPARE,Independent,1346,2,1348,0.11,10 - Nagpur (Maharashtra),13,10
7.0,FAHIM SHAMIM KHAN,Minorities Democratic Party,1072,1,1073,0.09,10 - Nagpur (Maharashtra),13,10
8.0,SURAJ BALRAM MISHRA,Kunbi Bahujan Sawrajya Party,814,3,817,0.07,10 - Nagpur (Maharashtra),13,10
9.0,TEKRAJ BELKHODE,Independent,803,5,808,0.07,10 - Nagpur (Maharashtra),13,10
10.0,GARUDADRI ANAND KUMAR,Akhil Bhartiya Parivar Party,719,1,720,0.06,10 - Nagpur (Maharashtra),13,10
11.0,DHANU WALTHARE,Independent,690,2,692,0.06,10 - Nagpur (Maharashtra),13,10
12.0,VIJAY MANKAR,Ambedkarite Party of India,606,4,610,0.05,10 - Nagpur (Maharashtra),13,10
13.0,ADV. SANTOSH RAMKRISHNA LANJEWAR,All India Forward Bloc,565,2,567,0.05,10 - Nagpur (Maharashtra),13,10
14.0,VISHESH VASANTA FUTANE,Bahujan Republican Socialist Party,559,3,562,0.05,10 - Nagpur (Maharashtra),13,10
15.0,GUNWANT HARICHANDRA SOMKUWAR,Bharatheeya Jawan Kisan Party,465,6,471,0.04,10 - Nagpur (Maharashtra),13,10
16.0,SHRIDHAR NARAYAN SALVE,Bhim Sena,447,4,451,0.04,10 - Nagpur (Maharashtra),13,10
17.0,SUNIL WANKHEDE,Rashtra Samarpan Party,320,2,322,0.03,10 - Nagpur (Maharashtra),13,10
18.0,DIPAK LAXMANRAO MASKE,Bahujan Maha Party,267,3,270,0.02,10 - Nagpur (Maharashtra),13,10
19.0,NARAYAN TUKARAM CHOUDHARI,Socialist Unity Centre Of India (COMMUNIST),251,-,251,0.02,10 - Nagpur (Maharashtra),13,10
20.0,SANTOSH TULSHIRAM CHAVHAN,Independent,242,-,242,0.02,10 - Nagpur (Maharashtra),13,10
21.0,SUSHIL PATIL,Independent,236,1,237,0.02,10 - Nagpur (Maharashtra),13,10
22.0,SACHIN RAMKRUSHNARAO WAGHADE,Independent,202,-,202,0.02,10 - Nagpur (Maharashtra),13,10
23.0,PRAFUL MANIKCHAND BHANGE,Independent,201,-,201,0.02,10 - Nagpur (Maharashtra),13,10
24.0,VINAYAK BHAURAO AWCHAT,Independent,190,-,190,0.02,10 - Nagpur (Maharashtra),13,10
25.0,BABITA RAJU AWASTHI,Independent,179,3,182,0.02,10 - Nagpur (Maharashtra),13,10
26.0,SAHIL BALCHAND TURKAR,Independent,129,-,129,0.01,10 - Nagpur (Maharashtra),13,10
27.0,NOTA,None of the Above,5434,40,5474,0.45,10 - Nagpur (Maharashtra),13,10
,Total,,1207455,3866,1211321,,10 - Nagpur (Maharashtra),13,10
1.0,DR. PRASHANT YADAORAO PADOLE,Indian National Congress,581678,5735,587413,47.56,11 - Bhandara Gondiya (Maharashtra),13,11
2.0,SUNIL BABURAO MENDHE,Bharatiya Janata Party,546222,3811,550033,44.53,11 - Bhandara Gondiya (Maharashtra),13,11
3.0,KUMBHALKAR SANJAY BHAIYY,Bahujan Samaj Party,25104,358,25462,2.06,11 - Bhandara Gondiya (Maharashtra),13,11
4.0,SANJAY GAJANAN KEWAT,Vanchit Bahujan Aaghadi,24528,330,24858,2.01,11 - Bhandara Gondiya (Maharashtra),13,11
5.0,SEWAKBHAU NIRDHAN WAGHAYE,Independent,12899,204,13103,1.06,11 - Bhandara Gondiya (Maharashtra),13,11
6.0,AJAYKUMAR BHARTIYA,Akhil Bhartiya Parivar Party,3998,59,4057,0.33,11 - Bhandara Gondiya (Maharashtra),13,11
7.0,SUMIT VIJAY PANDE,Independent,3719,-,3719,0.3,11 - Bhandara Gondiya (Maharashtra),13,11
8.0,VIRENDRAKUMAR KASTURCHAND JAISWAL,Independent,2382,7,2389,0.19,11 - Bhandara Gondiya (Maharashtra),13,11
9.0,DEVILAL SUKHRAM NEPALE,Peoples Party of India (Democratic),2000,9,2009,0.16,11 - Bhandara Gondiya (Maharashtra),13,11
10.0,DR. AKASH MADHUKAR JIBHAKATE,Independent,1972,9,1981,0.16,11 - Bhandara Gondiya (Maharashtra),13,11
11.0,VILAS BABURAO LENDE,Lok Swarajya Party,1624,25,1649,0.13,11 - Bhandara Gondiya (Maharashtra),13,11
12.0,VILAS JIYALAL RAUT,Independent,1611,5,1616,0.13,11 - Bhandara Gondiya (Maharashtra),13,11
13.0,BENIRAM RAMCHAND FULBANDHE,Independent,1482,15,1497,0.12,11 - Bhandara Gondiya (Maharashtra),13,11
14.0,PRADEEP DHOBALE,Independent,1163,33,1196,0.1,11 - Bhandara Gondiya (Maharashtra),13,11
15.0,SURYAKIRAN ISHWAR NANDAGAWALI,Independent,1132,30,1162,0.09,11 - Bhandara Gondiya (Maharashtra),13,11
16.0,ITWALE SHARAD MARTAND,Independent,1020,8,1028,0.08,11 - Bhandara Gondiya (Maharashtra),13,11
17.0,TULSIRAM URKUDA GEDAM,Independent,831,11,842,0.07,11 - Bhandara Gondiya (Maharashtra),13,11
18.0,CHAITRAM DASHARATH KOKASE,Independent,780,11,791,0.06,11 - Bhandara Gondiya (Maharashtra),13,11
19.0,NOTA,None of the Above,10106,162,10268,0.83,11 - Bhandara Gondiya (Maharashtra),13,11
,Total,,1224251,10822,1235073,,11 - Bhandara Gondiya (Maharashtra),13,11
1.0,DR. KIRSAN NAMDEO,Indian National Congress,614610,3182,617792,52.97,12 - Gadchiroli - Chimur (Maharashtra),13,12
2.0,ASHOK MAHADEORAO NETE,Bharatiya Janata Party,474376,1720,476096,40.82,12 - Gadchiroli - Chimur (Maharashtra),13,12
3.0,GONNADE YOGESH NAMDEORAO,Bahujan Samaj Party,18930,125,19055,1.63,12 - Gadchiroli - Chimur (Maharashtra),13,12
4.0,HITESH PANDURANG MADAVI,Vanchit Bahujan Aaghadi,15824,98,15922,1.37,12 - Gadchiroli - Chimur (Maharashtra),13,12
5.0,VINOD GURUDAS MADAVI,Independent,6107,19,6126,0.53,12 - Gadchiroli - Chimur (Maharashtra),13,12
6.0,KODAPE VILAS SHAMARAO,Independent,4396,6,4402,0.38,12 - Gadchiroli - Chimur (Maharashtra),13,12
7.0,SUHAS UMESH KUMRE,Bhim Sena,2851,21,2872,0.25,12 - Gadchiroli - Chimur (Maharashtra),13,12
8.0,KARAN SURESH SAYAM,Independent,2772,17,2789,0.24,12 - Gadchiroli - Chimur (Maharashtra),13,12
9.0,BARIKRAO DHARMAJI MADAVI,Bahujan Republican Socialist Party,2527,28,2555,0.22,12 - Gadchiroli - Chimur (Maharashtra),13,12
10.0,DHIRAJ PURUSHOTTAM SHEDMAKE,Janseva Gondwana Party,2141,33,2174,0.19,12 - Gadchiroli - Chimur (Maharashtra),13,12
11.0,NOTA,None of the Above,16507,70,16577,1.42,12 - Gadchiroli - Chimur (Maharashtra),13,12
,Total,,1161041,5319,1166360,,12 - Gadchiroli - Chimur (Maharashtra),13,12
1.0,DHANORKAR PRATIBHA SURESH ALIAS BALUBHAU,Indian National Congress,716635,1775,718410,57.88,13 - Chandrapur (Maharashtra),13,13
2.0,MUNGANTIWAR SUDHIR SACCHIDANAND,Bharatiya Janata Party,456943,1061,458004,36.9,13 - Chandrapur (Maharashtra),13,13
3.0,BELE RAJESH WARLUJI,Vanchit Bahujan Aaghadi,21934,46,21980,1.77,13 - Chandrapur (Maharashtra),13,13
4.0,RAJENDRA HARISHCHANDRA RAMTEKE,Bahujan Samaj Party,9145,43,9188,0.74,13 - Chandrapur (Maharashtra),13,13
5.0,SANJAY NILKANTH GAWANDE,Independent,5087,1,5088,0.41,13 - Chandrapur (Maharashtra),13,13
6.0,DIWAKAR HARIJI URADE,Independent,3221,3,3224,0.26,13 - Chandrapur (Maharashtra),13,13
7.0,NAMDEO MANIKRAO SHEDMAKE,Gondvana Gantantra Party,2238,18,2256,0.18,13 - Chandrapur (Maharashtra),13,13
8.0,SEWAKDAS KAWDUJI BARKE,Peoples Party of India (Democratic),1997,1,1998,0.16,13 - Chandrapur (Maharashtra),13,13
9.0,AWACHIT SHAMRAO SAYAM,Janseva Gondwana Party,1886,20,1906,0.15,13 - Chandrapur (Maharashtra),13,13
10.0,MILIND PRALHAD DAHIWALE,Independent,1759,2,1761,0.14,13 - Chandrapur (Maharashtra),13,13
11.0,ASHOK RANAJI RATHOD,Jay Vidarbha Party,1660,10,1670,0.13,13 - Chandrapur (Maharashtra),13,13
12.0,VIKAS UTTAMRAO LASANTE,Sanman Rajkiya Paksha,1518,2,1520,0.12,13 - Chandrapur (Maharashtra),13,13
13.0,VIDYASAGAR KALIDAS KASARLAWAR,Bhim Sena,1426,-,1426,0.11,13 - Chandrapur (Maharashtra),13,13
14.0,VANITA JITENDRA RAUT,Akhil Bharatiya Manavata Paksha,1054,3,1057,0.09,13 - Chandrapur (Maharashtra),13,13
15.0,PURNIMA DILIP GHONMODE,Bahujan Republican Socialist Party,967,6,973,0.08,13 - Chandrapur (Maharashtra),13,13
16.0,NOTA,None of the Above,10821,22,10843,0.87,13 - Chandrapur (Maharashtra),13,13
,Total,,1238291,3013,1241304,,13 - Chandrapur (Maharashtra),13,13
1.0,SANJAY UTTAMRAO DESHMUKH,Shiv Sena (Uddhav Balasaheb Thackrey),591899,2908,594807,48.53,14 - Yavatmal- Washim (Maharashtra),13,14
2.0,RAJSHRITAI HEMANT PATIL (MAHALLE),Shiv Sena,498514,1820,500334,40.83,14 - Yavatmal- Washim (Maharashtra),13,14
3.0,ANIL JAYRAM RATHOD,Samnak Janta Party,56175,215,56390,4.6,14 - Yavatmal- Washim (Maharashtra),13,14
4.0,HARISING (HARIBHAU) NASARU RATHOD,Bahujan Samaj Party,17256,140,17396,1.42,14 - Yavatmal- Washim (Maharashtra),13,14
5.0,SANGITA DINESH CHAVHAN,Independent,7169,11,7180,0.59,14 - Yavatmal- Washim (Maharashtra),13,14
6.0,RAMDAS BAJIRAO GHODAM,Independent,6776,5,6781,0.55,14 - Yavatmal- Washim (Maharashtra),13,14
7.0,VINOD PANJABRAO NANDAGAVALI,Independent,6291,7,6298,0.51,14 - Yavatmal- Washim (Maharashtra),13,14
8.0,SANDIP SAMPAT SHINDE,Independent,5511,3,5514,0.45,14 - Yavatmal- Washim (Maharashtra),13,14
9.0,DHARAM DILIPSING THAKUR,Sanman Rajkiya Paksha,4539,16,4555,0.37,14 - Yavatmal- Washim (Maharashtra),13,14
10.0,AMOL KOMAWAR,Hindrashtra Sangh,3364,13,3377,0.28,14 - Yavatmal- Washim (Maharashtra),13,14
11.0,UTTAM ONKAR INGOLE,Peoples Party of India (Democratic),2958,17,2975,0.24,14 - Yavatmal- Washim (Maharashtra),13,14
12.0,MANOJ MAHADEORAO GEDAM,Independent,2783,11,2794,0.23,14 - Yavatmal- Washim (Maharashtra),13,14
13.0,NUR ALI MAHEBUB ALI SHAH,Independent,1951,7,1958,0.16,14 - Yavatmal- Washim (Maharashtra),13,14
14.0,DR ARJUNKUMAR SITARAM RATHOD,Independent,1857,6,1863,0.15,14 - Yavatmal- Washim (Maharashtra),13,14
15.0,PRO KISAN RAMRAO AMBURE,Independent,1705,15,1720,0.14,14 - Yavatmal- Washim (Maharashtra),13,14
16.0,DIKSHANT NAMDEVRAO SAWAIKAR,Independent,1095,8,1103,0.09,14 - Yavatmal- Washim (Maharashtra),13,14
17.0,GOKUL PREMDAS CHAVHAN,Independent,1091,3,1094,0.09,14 - Yavatmal- Washim (Maharashtra),13,14
18.0,NOTA,None of the Above,9316,75,9391,0.77,14 - Yavatmal- Washim (Maharashtra),13,14
,Total,,1220250,5280,1225530,,14 - Yavatmal- Washim (Maharashtra),13,14
1.0,AASHTIKAR PATIL NAGESH BAPURAO,Shiv Sena (Uddhav Balasaheb Thackrey),490432,2103,492535,42.49,15 - Hingoli (Maharashtra),13,15
2.0,BABURAO KADAM KOHALIKAR,Shiv Sena,382599,1334,383933,33.12,15 - Hingoli (Maharashtra),13,15
3.0,DR. B. D. CHAVHAN,Vanchit Bahujan Aaghadi,161324,490,161814,13.96,15 - Hingoli (Maharashtra),13,15
4.0,AMBADAS SUKAJI GADE,Independent,14729,13,14742,1.27,15 - Hingoli (Maharashtra),13,15
5.0,VIJAY RAMJI GABHANE,Communist Party of India (Marxist),14617,27,14644,1.26,15 - Hingoli (Maharashtra),13,15
6.0,ANAND RAJARAM DHULE,Independent,9807,10,9817,0.85,15 - Hingoli (Maharashtra),13,15
7.0,GAJANAN DHONDBA DAL,Bahujan Samaj Party,7410,55,7465,0.64,15 - Hingoli (Maharashtra),13,15
8.0,DATTA SHRIKRISHNA SURYAWANSHI,Independent,7233,6,7239,0.62,15 - Hingoli (Maharashtra),13,15
9.0,SARJERAO NIVRUTTI KHANDARE,Independent,5010,4,5014,0.43,15 - Hingoli (Maharashtra),13,15
10.0,RAMPRASAD NARAYAN BANGAR,Independent,4518,7,4525,0.39,15 - Hingoli (Maharashtra),13,15
11.0,BABURAO ANANDRAO KADAM,Independent,4469,13,4482,0.39,15 - Hingoli (Maharashtra),13,15
12.0,DEVSARKAR VARSHA SHIVAJIRAO,Bahujan Mukti Party,4081,18,4099,0.35,15 - Hingoli (Maharashtra),13,15
13.0,A. KADIR MASTAN SAYYED (GOREGAONKAR),Independent,3707,6,3713,0.32,15 - Hingoli (Maharashtra),13,15
14.0,ANIL DEVRAO MOHITE,Akhil Bhartiya Parivar Party,3353,21,3374,0.29,15 - Hingoli (Maharashtra),13,15
15.0,SUNIL MOTIRAM GAJBHAR,Independent,3192,-,3192,0.28,15 - Hingoli (Maharashtra),13,15
16.0,ADV ALTAF AHMED,Indian National League,2934,16,2950,0.25,15 - Hingoli (Maharashtra),13,15
17.0,ASHOK PANDURANG RATHOD,Independent,2897,9,2906,0.25,15 - Hingoli (Maharashtra),13,15
18.0,ADV RAVI SHINDE,Independent,2687,14,2701,0.23,15 - Hingoli (Maharashtra),13,15
19.0,SATTAR PATHAN,Independent,2461,2,2463,0.21,15 - Hingoli (Maharashtra),13,15
20.0,MAHESH KAILAS NAPTE,Independent,2298,1,2299,0.2,15 - Hingoli (Maharashtra),13,15
21.0,ADV. SHIVAJIRAO JADHAV,Independent,2181,33,2214,0.19,15 - Hingoli (Maharashtra),13,15
22.0,BHAWAR GOVINDRAO FULAJI,Independent,2138,8,2146,0.19,15 - Hingoli (Maharashtra),13,15
23.0,TRISHALA MILIND KAMBLE,Bahujan Samaj Party (Ambedkar),2128,22,2150,0.19,15 - Hingoli (Maharashtra),13,15
24.0,PRAKASH MASARAM RANVIR,Republican Party of India (A),2097,5,2102,0.18,15 - Hingoli (Maharashtra),13,15
25.0,ADV. RAMRAO ATMARAM JUMBADE,Independent,2095,9,2104,0.18,15 - Hingoli (Maharashtra),13,15
26.0,DESHA SHYAM BANJARA,Samnak Janta Party,2052,11,2063,0.18,15 - Hingoli (Maharashtra),13,15
27.0,VISHVANATH BHAURAO FALEGAONKAR,Independent,1856,3,1859,0.16,15 - Hingoli (Maharashtra),13,15
28.0,HEMANT RADHAKISHAN KANAKE,Rashtriya Kisan Bahujan Party,1791,9,1800,0.16,15 - Hingoli (Maharashtra),13,15
29.0,RAVI RAMDAS JADHAV (SAWANEKAR),Abhinav Bharat Janseva Paksh,1590,12,1602,0.14,15 - Hingoli (Maharashtra),13,15
30.0,DEWJI GANGARAM ASOLE,Independent,1476,7,1483,0.13,15 - Hingoli (Maharashtra),13,15
31.0,VIJAY DNYANBA RAUT,Independent,1115,11,1126,0.1,15 - Hingoli (Maharashtra),13,15
32.0,SUNIL DASHARATH INGOLE,Bhim Sena,1024,4,1028,0.09,15 - Hingoli (Maharashtra),13,15
33.0,VASANT KISAN PAIKRAO,Independent,590,3,593,0.05,15 - Hingoli (Maharashtra),13,15
34.0,NOTA,None of the Above,3079,44,3123,0.27,15 - Hingoli (Maharashtra),13,15
,Total,,1154970,4330,1159300,,15 - Hingoli (Maharashtra),13,15
1.0,CHAVAN VASANTRAO BALWANTRAO,Indian National Congress,526865,2029,528894,46.88,16 - Nanded (Maharashtra),13,16
2.0,CHIKHALIKAR PRATAPRAO GOVINDRAO,Bharatiya Janata Party,467452,2000,469452,41.61,16 - Nanded (Maharashtra),13,16
3.0,AVINASH VISHWANATH BHOSIKAR,Vanchit Bahujan Aaghadi,92090,422,92512,8.2,16 - Nanded (Maharashtra),13,16
4.0,PANDURANG RAMA ADGULWAR,Bahujan Samaj Party,6879,22,6901,0.61,16 - Nanded (Maharashtra),13,16
5.0,NIKHIL LAXMANRAO GARJE,Independent,4320,5,4325,0.38,16 - Nanded (Maharashtra),13,16
6.0,NAGESH SAMBHAJI GAIKWAD,Independent,3316,2,3318,0.29,16 - Nanded (Maharashtra),13,16
7.0,BHASKAR CHAMPATRAO DOIFODE,Independent,2078,2,2080,0.18,16 - Nanded (Maharashtra),13,16
8.0,SUSHILA NILKANTHRAO PAWAR,Samnak Janta Party,1873,17,1890,0.17,16 - Nanded (Maharashtra),13,16
9.0,ABDUL RAIS AHEMAD,Desh Janhit Party,1508,2,1510,0.13,16 - Nanded (Maharashtra),13,16
10.0,DEVIDAS GOVINDRAO INGLE,Independent,1466,5,1471,0.13,16 - Nanded (Maharashtra),13,16
11.0,KALPANA SANJAY GAIKWAD,Independent,1305,5,1310,0.12,16 - Nanded (Maharashtra),13,16
12.0,KAUSAR SULTANA,Indian National League,1211,4,1215,0.11,16 - Nanded (Maharashtra),13,16
13.0,SAHEBRAO BHIVA GAJBHARE,Independent,1189,4,1193,0.11,16 - Nanded (Maharashtra),13,16
14.0,JAGDISH LAXMAN POTRE,Independent,960,3,963,0.09,16 - Nanded (Maharashtra),13,16
15.0,GAJANAN DATTRAMJI DHUMAL,Independent,948,2,950,0.08,16 - Nanded (Maharashtra),13,16
16.0,LAXMAN NAGORAO PATIL,Independent,921,2,923,0.08,16 - Nanded (Maharashtra),13,16
17.0,MAHARUDRA KESHAV POPLAITKAR,Independent,911,2,913,0.08,16 - Nanded (Maharashtra),13,16
18.0,RUKMINBAI SHANKARRAO GITE,Bharatiya Praja Surajya Paksha,897,6,903,0.08,16 - Nanded (Maharashtra),13,16
19.0,HARI PIRAJI BOYALE,Bahujan Bharat Party,877,1,878,0.08,16 - Nanded (Maharashtra),13,16
20.0,RATHOD SURESH GOPINATH,Independent,806,2,808,0.07,16 - Nanded (Maharashtra),13,16
21.0,KADAM SURAJ DEVENDRA,Independent,796,3,799,0.07,16 - Nanded (Maharashtra),13,16
22.0,RAHUL SURYAKANT YANGADE,Bahujan Mukti Party,734,3,737,0.07,16 - Nanded (Maharashtra),13,16
23.0,DNYANESHWAR RAOSAHEB KAPATE,Independent,679,2,681,0.06,16 - Nanded (Maharashtra),13,16
24.0,NOTA,None of the Above,3579,49,3628,0.32,16 - Nanded (Maharashtra),13,16
,Total,,1123660,4594,1128254,,16 - Nanded (Maharashtra),13,16
1.0,JADHAV SANJAY ( BANDU ) HARIBHAU,Shiv Sena (Uddhav Balasaheb Thackrey),596871,4472,601343,45.17,17 - Parbhani (Maharashtra),13,17
2.0,JANKAR MAHADEV JAGANNATH,Rashtriya Samaj Paksha,463764,3518,467282,35.1,17 - Parbhani (Maharashtra),13,17
3.0,PANJAB UTTAMRAO DAKH,Vanchit Bahujan Aaghadi,95394,573,95967,7.21,17 - Parbhani (Maharashtra),13,17
4.0,DR. GOVARDHAN BHIWAJI KHANDAGALE,Bahujan Bharat Party,15355,40,15395,1.16,17 - Parbhani (Maharashtra),13,17
5.0,KAMBLE SHIVAJI DEVAJI,Independent,11050,10,11060,0.83,17 - Parbhani (Maharashtra),13,17
6.0,ALAMGIR MOHAMMAD KHAN,Bahujan Samaj Party,10972,90,11062,0.83,17 - Parbhani (Maharashtra),13,17
7.0,SAMIR GANESHRAO DUDHGAONKAR,Independent,10951,105,11056,0.83,17 - Parbhani (Maharashtra),13,17
8.0,KRUSHNA TRIMBAKRAO PAWAR,Independent,10145,9,10154,0.76,17 - Parbhani (Maharashtra),13,17
9.0,KAILAS BALIRAM PAWAR (NAIK),Baliraja Party,9487,33,9520,0.72,17 - Parbhani (Maharashtra),13,17
10.0,PROF. DR. VILAS BANSIDHAR TANGADE,Independent,8814,6,8820,0.66,17 - Parbhani (Maharashtra),13,17
11.0,ARJUN DNYANOBA BHISE,Independent,6915,8,6923,0.52,17 - Parbhani (Maharashtra),13,17
12.0,COMRADE RAJAN KSHIRSAGAR,Communist Party of India,6627,22,6649,0.5,17 - Parbhani (Maharashtra),13,17
13.0,KISHORKUMAR PRAKASH SHINDE,Independent,6547,1,6548,0.49,17 - Parbhani (Maharashtra),13,17
14.0,KISHORE RADHAKISHAN DHAGE,Independent,5446,34,5480,0.41,17 - Parbhani (Maharashtra),13,17
15.0,SAYED IRSHAD ALI SAYYED LAYAKH ALI,Social Democratic Party Of India,4629,15,4644,0.35,17 - Parbhani (Maharashtra),13,17
16.0,DASHARATH PRABHKAR RATHOD,Maharashtra Vikas Aghadi,4354,40,4394,0.33,17 - Parbhani (Maharashtra),13,17
17.0,KARBHARI KUNDLIK MITHE,Independent,4268,8,4276,0.32,17 - Parbhani (Maharashtra),13,17
18.0,APPASAHEB OMKAR KADAM,Independent,3883,8,3891,0.29,17 - Parbhani (Maharashtra),13,17
19.0,SHRIRAM BANSILAL JADHAV,Jai Sewalal Bahujan Vikas Party,3617,11,3628,0.27,17 - Parbhani (Maharashtra),13,17
20.0,COMRADE GANPAT BHISE,Independent,3589,15,3604,0.27,17 - Parbhani (Maharashtra),13,17
21.0,DNYANESHWAR JAGANNATH DAHIBHATE,Independent,3538,1,3539,0.27,17 - Parbhani (Maharashtra),13,17
22.0,ANIL MANIKRAO MUDGALKAR,Independent,3531,2,3533,0.27,17 - Parbhani (Maharashtra),13,17
23.0,GOVIND BHAIYYA RAMRAO DESHMUKH,Independent,3452,7,3459,0.26,17 - Parbhani (Maharashtra),13,17
24.0,SUBHASH DATTARAV JAVLE,Independent,3429,5,3434,0.26,17 - Parbhani (Maharashtra),13,17
25.0,RAJABHAU SHESHRAO KAKDE,Independent,3299,3,3302,0.25,17 - Parbhani (Maharashtra),13,17
26.0,RAJENDRA RAMDAS ATKAL,Independent,2807,5,2812,0.21,17 - Parbhani (Maharashtra),13,17
27.0,SAYYD ABDUL SATTAR AJIJ,Independent,2646,4,2650,0.2,17 - Parbhani (Maharashtra),13,17
28.0,SHAIKH SALEEM SHAIKH IBRAHIM,All India Majlis-E-Inquilab-E-Millat,2617,2,2619,0.2,17 - Parbhani (Maharashtra),13,17
29.0,SANGEETA VYAKANTRAO GIRI,Swarajya Shakti Sena,2324,15,2339,0.18,17 - Parbhani (Maharashtra),13,17
30.0,ADV. VINOD CHHAGANRAO AMBHORE,Bahujan Mukti Party,2017,24,2041,0.15,17 - Parbhani (Maharashtra),13,17
31.0,VIJAY ANNASAHEB THOMBARE,Independent,1957,2,1959,0.15,17 - Parbhani (Maharashtra),13,17
32.0,VISHNUDAS SHIVAJI BHOSALE,Independent,1856,4,1860,0.14,17 - Parbhani (Maharashtra),13,17
33.0,MUSTAFA MAINODDIN SHAIKH,Independent,1298,4,1302,0.1,17 - Parbhani (Maharashtra),13,17
34.0,BOBADE SAKHARAM PADEGAONKAR,Independent,1244,2,1246,0.09,17 - Parbhani (Maharashtra),13,17
35.0,NOTA,None of the Above,3306,79,3385,0.25,17 - Parbhani (Maharashtra),13,17
,Total,,1321999,9177,1331176,,17 - Parbhani (Maharashtra),13,17
1.0,KALYAN VAIJINATHRAO KALE,Indian National Congress,605504,2393,607897,44.59,18 - Jalna (Maharashtra),13,18
2.0,DANVE RAOSAHEB DADARAO,Bharatiya Janata Party,495809,2130,497939,36.52,18 - Jalna (Maharashtra),13,18
3.0,MANGESH SANJAY SABLE,Independent,155335,595,155930,11.44,18 - Jalna (Maharashtra),13,18
4.0,BAKALE PRABHAKAR DEVGAN,Vanchit Bahujan Aaghadi,37678,132,37810,2.77,18 - Jalna (Maharashtra),13,18
5.0,BABASAHEB SANTUKRAO SHELKE,Samata Party,9564,6,9570,0.7,18 - Jalna (Maharashtra),13,18
6.0,CHABUKSWAR RAHUL NIRANJAN,Independent,6330,7,6337,0.46,18 - Jalna (Maharashtra),13,18
7.0,NIVRUTTI VISHWNATH BANSODE,Bahujan Samaj Party,5974,34,6008,0.44,18 - Jalna (Maharashtra),13,18
8.0,DIPAK BHIMRAO BORHADE,Samnak Janta Party,5498,24,5522,0.41,18 - Jalna (Maharashtra),13,18
9.0,TANAJI TUKARAM BHOJANE,Independent,4933,15,4948,0.36,18 - Jalna (Maharashtra),13,18
10.0,KAMBLE MAROTI DASHARATH,Independent,3712,16,3728,0.27,18 - Jalna (Maharashtra),13,18
11.0,RAJENDRA NAMDEO MAGRE,Independent,2873,2,2875,0.21,18 - Jalna (Maharashtra),13,18
12.0,MANOJ NEMINATH KOLTE,Independent,2734,3,2737,0.2,18 - Jalna (Maharashtra),13,18
13.0,MUKESH PRABHAT RATHOD,Akhil Bhartiya Parivar Party,2580,11,2591,0.19,18 - Jalna (Maharashtra),13,18
14.0,BABASAHEB PATIL SHINDE,Independent,2413,4,2417,0.18,18 - Jalna (Maharashtra),13,18
15.0,KADUBA MHATARBA INGLE,Independent,1962,5,1967,0.14,18 - Jalna (Maharashtra),13,18
16.0,AJHAR ANWAR SAYYAD,Independent,1541,5,1546,0.11,18 - Jalna (Maharashtra),13,18
17.0,AHMAD RAHIM SAIKH BAGWAN,Independent,1390,4,1394,0.1,18 - Jalna (Maharashtra),13,18
18.0,ADV. YOGESH DATTU GULLAPELLI,Independent,1339,3,1342,0.1,18 - Jalna (Maharashtra),13,18
19.0,BHAGWAN SAHEBRAO REGUDE,Hindustan Janta Party,1173,1,1174,0.09,18 - Jalna (Maharashtra),13,18
20.0,DNYANESHWAR DAGDUJI NADE,Independent,1142,1,1143,0.08,18 - Jalna (Maharashtra),13,18
21.0,DHANANJAY RUPRAOJI KAKDE (PATIL),Bharatheeya Jawan Kisan Party,1132,7,1139,0.08,18 - Jalna (Maharashtra),13,18
22.0,ABDUL RAFIQ ABDUL LATIF,Independent,1045,2,1047,0.08,18 - Jalna (Maharashtra),13,18
23.0,SHYAM RUSTUMRAO SHIRSATH,Bahujan Republican Socialist Party,972,2,974,0.07,18 - Jalna (Maharashtra),13,18
24.0,RATAN ASARAM LANDGE,Independent,646,1,647,0.05,18 - Jalna (Maharashtra),13,18
25.0,VIKAS CHHAGAN LAHANE,Independent,644,-,644,0.05,18 - Jalna (Maharashtra),13,18
26.0,SHAM PAWALS RUPEKAR,Independent,544,2,546,0.04,18 - Jalna (Maharashtra),13,18
27.0,NOTA,None of the Above,3504,33,3537,0.26,18 - Jalna (Maharashtra),13,18
,Total,,1357971,5438,1363409,,18 - Jalna (Maharashtra),13,18
1.0,BHUMARE SANDIPANRAO ASARAM,Shiv Sena,474434,1696,476130,36.56,19 - Aurangabad (Maharashtra),13,19
2.0,IMTIAZ JALEEL SYED,All India Majlis-E-Ittehadul Muslimeen,340877,603,341480,26.22,19 - Aurangabad (Maharashtra),13,19
3.0,CHANDRAKANT KHAIRE,Shiv Sena (Uddhav Balasaheb Thackrey),291870,1580,293450,22.53,19 - Aurangabad (Maharashtra),13,19
4.0,AFSAR KHAN YASEEN KHA,Vanchit Bahujan Aaghadi,69087,179,69266,5.32,19 - Aurangabad (Maharashtra),13,19
5.0,HARSHWARDHAN DADA RAIBHANJI JADHAV,Independent,39654,174,39828,3.06,19 - Aurangabad (Maharashtra),13,19
6.0,SURENDRA DIGAMBAR GAJBHARE,Independent,10719,6,10725,0.82,19 - Aurangabad (Maharashtra),13,19
7.0,SANJAY UTTAMRAO JAGTAP,Bahujan Samaj Party,8188,64,8252,0.63,19 - Aurangabad (Maharashtra),13,19
8.0,RAVINDRA BHASKARRAO BODKHE,Bharatiya Yuva Jan Ekta Party,6250,4,6254,0.48,19 - Aurangabad (Maharashtra),13,19
9.0,ABDUL AZIM ABDUL AZIZ SHAIKH,Independent,4693,-,4693,0.36,19 - Aurangabad (Maharashtra),13,19
10.0,SANJAY BHASKAR SHIRSAT,Independent,3809,3,3812,0.29,19 - Aurangabad (Maharashtra),13,19
11.0,DR JIVAN BHAWLAL RAJPUT,Independent,3788,19,3807,0.29,19 - Aurangabad (Maharashtra),13,19
12.0,MANISHA KHARAT,Bahujan Maha Party,3097,8,3105,0.24,19 - Aurangabad (Maharashtra),13,19
13.0,JAGANNATH KHANDERAO JADHAV J K JADHAV,Independent,2916,16,2932,0.23,19 - Aurangabad (Maharashtra),13,19
14.0,MAANOJ VINAYAKRAO GHODKAY,Independent,2582,5,2587,0.2,19 - Aurangabad (Maharashtra),13,19
15.0,SANGITA GANESH JADHAV,Independent,2206,6,2212,0.17,19 - Aurangabad (Maharashtra),13,19
16.0,GALPHADE ARJUN BHAGWANRAO,Rashtriya Kisan Bahujan Party,2185,7,2192,0.17,19 - Aurangabad (Maharashtra),13,19
17.0,VISHAL UDDHAV NANDARKAR,Independent,2132,7,2139,0.16,19 - Aurangabad (Maharashtra),13,19
18.0,ARVIND KISANRAO KAMBLE,Bahujan Republican Socialist Party,1975,4,1979,0.15,19 - Aurangabad (Maharashtra),13,19
19.0,PRASHANT PUNDALIKRAO AVHALE,Independent,1945,3,1948,0.15,19 - Aurangabad (Maharashtra),13,19
20.0,GHUGE NITIN PUNDLIK,Independent,1870,2,1872,0.14,19 - Aurangabad (Maharashtra),13,19
21.0,BHALERAO VASANT SAMBHAJI,Prabuddha Republican Party,1546,1,1547,0.12,19 - Aurangabad (Maharashtra),13,19
22.0,BHARAT PURUSHOTTAM KADAM,Rashtriya Maratha Party,1489,6,1495,0.11,19 - Aurangabad (Maharashtra),13,19
23.0,ABDUL SAMAD BAGWAN,All India Majlis-E-Inquilab-E-Millat,1478,4,1482,0.11,19 - Aurangabad (Maharashtra),13,19
24.0,SANDIP DADARAO MANKAR,Independent,1373,2,1375,0.11,19 - Aurangabad (Maharashtra),13,19
25.0,ADV B U GOSAWI,Hindustan Janta Party,1271,4,1275,0.1,19 - Aurangabad (Maharashtra),13,19
26.0,PANCHASHILA BABULAL JADHAV,Republican Bahujan Sena,1267,7,1274,0.1,19 - Aurangabad (Maharashtra),13,19
27.0,PRATIKSHA PRASHANT CHAVAN,Ambedkarist Republican Party,1187,7,1194,0.09,19 - Aurangabad (Maharashtra),13,19
28.0,BHANUDAS SON OF RAMDAS SARODE PATIL,Independent,1107,3,1110,0.09,19 - Aurangabad (Maharashtra),13,19
29.0,NARAYAN JADHAV,Peoples Party of India (Democratic),1100,3,1103,0.08,19 - Aurangabad (Maharashtra),13,19
30.0,SURESH ASARAM FULARE,Independent,910,1,911,0.07,19 - Aurangabad (Maharashtra),13,19
31.0,SHAIKH KHAJA KISMATWALA KASIM KISMATWALA,Independent,892,2,894,0.07,19 - Aurangabad (Maharashtra),13,19
32.0,MEENASING AVDHESHSING SING,Independent,783,1,784,0.06,19 - Aurangabad (Maharashtra),13,19
33.0,LATIF JABBAR KHAN,Independent,765,-,765,0.06,19 - Aurangabad (Maharashtra),13,19
34.0,JAGANNATH KISAN UGALE,Independent,753,2,755,0.06,19 - Aurangabad (Maharashtra),13,19
35.0,SANDIP DEVIDAS JADHAV,Independent,609,-,609,0.05,19 - Aurangabad (Maharashtra),13,19
36.0,DEVIDAS RATAN KASBE,Independent,595,-,595,0.05,19 - Aurangabad (Maharashtra),13,19
37.0,TRIBHUVAN MADHUKAR PADMAKAR,Independent,593,-,593,0.05,19 - Aurangabad (Maharashtra),13,19
38.0,NOTA,None of the Above,5729,44,5773,0.44,19 - Aurangabad (Maharashtra),13,19
,Total,,1297724,4473,1302197,,19 - Aurangabad (Maharashtra),13,19
1.0,BHASKAR MURLIDHAR BHAGARE,Nationalist Congress Party – Sharadchandra Pawar,575291,2048,577339,46.53,20 - Dindori (Maharashtra),13,20
2.0,DR. BHARATI PRAVIN PAWAR,Bharatiya Janata Party,462333,1807,464140,37.4,20 - Dindori (Maharashtra),13,20
3.0,BABU SADU BHAGRE (SIR),Independent,103526,106,103632,8.35,20 - Dindori (Maharashtra),13,20
4.0,DHOMSE MALATI RAHUL,Vanchit Bahujan Aaghadi,37006,97,37103,2.99,20 - Dindori (Maharashtra),13,20
5.0,JAGTAP DIPAK GANPAT,Independent,15664,17,15681,1.26,20 - Dindori (Maharashtra),13,20
6.0,TULSHIRAM CHIMAN KHOTARE,Bahujan Samaj Party,9589,65,9654,0.78,20 - Dindori (Maharashtra),13,20
7.0,KISHOR AMBADAS DAGALE,Ambedkarite Party of India,8032,23,8055,0.65,20 - Dindori (Maharashtra),13,20
8.0,ANIL GAWALIRAM BARDE,Independent,6432,9,6441,0.52,20 - Dindori (Maharashtra),13,20
9.0,BHARAT ARUN PAWAR,Bahujan Republican Socialist Party,5613,8,5621,0.45,20 - Dindori (Maharashtra),13,20
10.0,GULAB MOHAN BARDE,Prabuddha Republican Party,4983,15,4998,0.4,20 - Dindori (Maharashtra),13,20
11.0,NOTA,None of the Above,8206,40,8246,0.66,20 - Dindori (Maharashtra),13,20
,Total,,1236675,4235,1240910,,20 - Dindori (Maharashtra),13,20
1.0,RAJABHAU (PARAG) PRAKASH WAJE,Shiv Sena (Uddhav Balasaheb Thackrey),614517,2212,616729,49.85,21 - Nashik (Maharashtra),13,21
2.0,GODSE HEMANT TUKARAM,Shiv Sena,453414,1314,454728,36.75,21 - Nashik (Maharashtra),13,21
3.0,KARAN PANDHARINATH GAIKAR,Vanchit Bahujan Aaghadi,47114,79,47193,3.81,21 - Nashik (Maharashtra),13,21
4.0,SHANTIGIRIJI MAUNGIRIJI MAHARAJ,Independent,44415,109,44524,3.6,21 - Nashik (Maharashtra),13,21
5.0,ARUN MADHUKAR KALE,Bahujan Samaj Party,7698,53,7751,0.63,21 - Nashik (Maharashtra),13,21
6.0,CHANDRAKANT KESHAVRAO THAKUR,Independent,6607,1,6608,0.53,21 - Nashik (Maharashtra),13,21
7.0,AMOL SAMPATRAO KAMBLE,Rashtriya Kisan Bahujan Party,4980,17,4997,0.4,21 - Nashik (Maharashtra),13,21
8.0,DARSHANA AMOL MEDHE,Prabuddha Republican Party,4730,6,4736,0.38,21 - Nashik (Maharashtra),13,21
9.0,KANOJE PRAKASH GIRDHARI,Independent,3917,3,3920,0.32,21 - Nashik (Maharashtra),13,21
10.0,VAMAN MAHADEV SANGALE,Dharmarajya Paksha,3861,-,3861,0.31,21 - Nashik (Maharashtra),13,21
11.0,SUDHIR SHRIDHAR DESHMUKH,Independent,3162,5,3167,0.26,21 - Nashik (Maharashtra),13,21
12.0,JITENDRA NARESH BHABHE (JITENDRA BHAVE),Independent,3125,7,3132,0.25,21 - Nashik (Maharashtra),13,21
13.0,ARIF USMAN MANSURI,Independent,2538,5,2543,0.21,21 - Nashik (Maharashtra),13,21
14.0,GANESH BALASAHEB BORASTE,Independent,2403,1,2404,0.19,21 - Nashik (Maharashtra),13,21
15.0,JAYSHRI MAHENDRA PATIL,Sainik Samaj Party,2398,28,2426,0.2,21 - Nashik (Maharashtra),13,21
16.0,SIDDHESHWARANAND SARASWATI,Independent,2378,10,2388,0.19,21 - Nashik (Maharashtra),13,21
17.0,SUSHAMA ABHIJIT GORANE,Independent,2258,2,2260,0.18,21 - Nashik (Maharashtra),13,21
18.0,KANTILAL KISAN JADHAV,Ambedkarite Party of India,2047,8,2055,0.17,21 - Nashik (Maharashtra),13,21
19.0,CHANDRABHAN AABAJI PURKAR,Independent,1888,2,1890,0.15,21 - Nashik (Maharashtra),13,21
20.0,YASHWANT VALU PARDHI,Bhartiya Asmita Party,1867,7,1874,0.15,21 - Nashik (Maharashtra),13,21
21.0,KAILASH MARUTI CHAVAN,Aam Janta Party (India),1686,17,1703,0.14,21 - Nashik (Maharashtra),13,21
22.0,KAMLAKAR BALASAHEB GAIKWAD,Dalit Soshit Pichhara Varg Adhikar Dal,1639,7,1646,0.13,21 - Nashik (Maharashtra),13,21
23.0,DHANAJI ASHOK TOPALE,Independent,1376,-,1376,0.11,21 - Nashik (Maharashtra),13,21
24.0,BHAGYASHRI NITIN ADSUL,Indian Peoples Adhikar Party,1242,2,1244,0.1,21 - Nashik (Maharashtra),13,21
25.0,SOPAN NIVRUTTI SOMWANSHI,Independent,1210,1,1211,0.1,21 - Nashik (Maharashtra),13,21
26.0,ADV. ZUNJAR MHASUJI AVHAD,Bahujan Republican Socialist Party,1205,5,1210,0.1,21 - Nashik (Maharashtra),13,21
27.0,KOLAPPA HANUMANT DHOTRE,Independent,1198,2,1200,0.1,21 - Nashik (Maharashtra),13,21
28.0,TILOTTAMA SUNIL JAGTAP,Independent,654,2,656,0.05,21 - Nashik (Maharashtra),13,21
29.0,DEEPAK GAIKWAD,Independent,640,2,642,0.05,21 - Nashik (Maharashtra),13,21
30.0,SACHINRAJE DATTATREYA DEORE,Independent,549,2,551,0.04,21 - Nashik (Maharashtra),13,21
31.0,DEVIDAS PIRAJI SARKATE,Independent,392,2,394,0.03,21 - Nashik (Maharashtra),13,21
32.0,NOTA,None of the Above,6144,41,6185,0.5,21 - Nashik (Maharashtra),13,21
,Total,,1233252,3952,1237204,,21 - Nashik (Maharashtra),13,21
1.0,DR. HEMANT VISHNU SAVARA,Bharatiya Janata Party,600208,1036,601244,43.69,22 - Palghar (Maharashtra),13,22
2.0,BHARTI BHARAT KAMDI,Shiv Sena (Uddhav Balasaheb Thackrey),416822,1116,417938,30.37,22 - Palghar (Maharashtra),13,22
3.0,RAJESH RAGHUNATH PATIL,Bahujan Vikas Aaghadi,254011,506,254517,18.5,22 - Palghar (Maharashtra),13,22
4.0,BHARAT SAMJI VANGA,Bahujan Samaj Party,15425,40,15465,1.12,22 - Palghar (Maharashtra),13,22
5.0,MEENA KISHOR BHAD,Independent,14223,12,14235,1.03,22 - Palghar (Maharashtra),13,22
6.0,VIJAYA RAJKUMAR MHATRE,Vanchit Bahujan Aaghadi,10882,54,10936,0.79,22 - Palghar (Maharashtra),13,22
7.0,MOHAN BARAKU GUHE,Bharat Adivasi Party,10737,24,10761,0.78,22 - Palghar (Maharashtra),13,22
8.0,DINKAR DATTATRAYA WADHAN,Independent,10672,15,10687,0.78,22 - Palghar (Maharashtra),13,22
9.0,AMAR KISAN KAVALE,Independent,9806,15,9821,0.71,22 - Palghar (Maharashtra),13,22
10.0,COMRADE RAHUL MEDHA,Marxist Leninist Party of India (Red Flag),7061,24,7085,0.51,22 - Palghar (Maharashtra),13,22
11.0,NOTA,None of the Above,23312,73,23385,1.7,22 - Palghar (Maharashtra),13,22
,Total,,1373159,2915,1376074,,22 - Palghar (Maharashtra),13,22
1.0,BALYA MAMA - SURESH GOPINATH MHATRE,Nationalist Congress Party – Sharadchandra Pawar,498199,1265,499464,39.85,23 - Bhiwandi (Maharashtra),13,23
2.0,KAPIL MORESHWAR PATIL,Bharatiya Janata Party,431907,1436,433343,34.57,23 - Bhiwandi (Maharashtra),13,23
3.0,NILESH BHAGWAN SAMBARE,Independent,230254,1163,231417,18.46,23 - Bhiwandi (Maharashtra),13,23
4.0,KANCHAN VINAYAK VAKHARE,New Rashtriya Samaj Party,24607,18,24625,1.96,23 - Bhiwandi (Maharashtra),13,23
5.0,TARA PINTYA WAGHE,Independent,6908,-,6908,0.55,23 - Bhiwandi (Maharashtra),13,23
6.0,MUMATAZ ABDULSATTAR ANSARI,Bahujan Samaj Party,6801,21,6822,0.54,23 - Bhiwandi (Maharashtra),13,23
7.0,MANISHA SANTOSH GONDHALE,Independent,5120,-,5120,0.41,23 - Bhiwandi (Maharashtra),13,23
8.0,MANOJ GOVAR TURE,Independent,4896,1,4897,0.39,23 - Bhiwandi (Maharashtra),13,23
9.0,JAHID MURABTAR ANSARI,Independent,4879,3,4882,0.39,23 - Bhiwandi (Maharashtra),13,23
10.0,CHANDRAKANT RAMBHAJI MOTE,Independent,3429,4,3433,0.27,23 - Bhiwandi (Maharashtra),13,23
11.0,RAHUL ASHOK KATHOLE,Independent,3131,4,3135,0.25,23 - Bhiwandi (Maharashtra),13,23
12.0,ASHOK BHIKU BAHADARE,Sanyukt Bharat Paksh,2044,3,2047,0.16,23 - Bhiwandi (Maharashtra),13,23
13.0,SURESH PANDAGALE,Apni Prajahit Party,1997,16,2013,0.16,23 - Bhiwandi (Maharashtra),13,23
14.0,MILIND KASHINATH KAMBLE,Independent,1843,18,1861,0.15,23 - Bhiwandi (Maharashtra),13,23
15.0,KHAN MOHD AKARAM ABDUL HANAN,All India Majlis-E-Ittehadul Muslimeen,1739,2,1741,0.14,23 - Bhiwandi (Maharashtra),13,23
16.0,DANISH EZAZ AH. SHAIKH,Bahujan Maha Party,1580,6,1586,0.13,23 - Bhiwandi (Maharashtra),13,23
17.0,HARSHAD RAMESH MHATRE,Independent,1568,-,1568,0.13,23 - Bhiwandi (Maharashtra),13,23
18.0,MUTKIRI SHANKAR NAGESH,Independent,1445,-,1445,0.12,23 - Bhiwandi (Maharashtra),13,23
19.0,KAPIL JAYHIND PATIL,Independent,1237,5,1242,0.1,23 - Bhiwandi (Maharashtra),13,23
20.0,SAIFAN CHAND PATHAN,Bhartiya Manavta Party,1188,1,1189,0.09,23 - Bhiwandi (Maharashtra),13,23
21.0,RANJANA RAVI TRIBHUWAN,Independent,1082,3,1085,0.09,23 - Bhiwandi (Maharashtra),13,23
22.0,MOHD. KALEEM ANSARI,Peoples Party of India (Democratic),934,3,937,0.07,23 - Bhiwandi (Maharashtra),13,23
23.0,WASEEM TUFAIL SIDDIQUI,Independent,803,2,805,0.06,23 - Bhiwandi (Maharashtra),13,23
24.0,SURESH SITARAM MHATRE,Independent,706,1,707,0.06,23 - Bhiwandi (Maharashtra),13,23
25.0,SONALI ASHOK GANGAWANE,Independent,698,-,698,0.06,23 - Bhiwandi (Maharashtra),13,23
26.0,AAPPA - VISHAL VIJAY MORE,Independent,598,3,601,0.05,23 - Bhiwandi (Maharashtra),13,23
27.0,PROF. AMEERUL HASAN SAYYED,Independent,479,2,481,0.04,23 - Bhiwandi (Maharashtra),13,23
28.0,NOTA,None of the Above,9266,81,9347,0.75,23 - Bhiwandi (Maharashtra),13,23
,Total,,1249338,4061,1253399,,23 - Bhiwandi (Maharashtra),13,23
1.0,DR SHRIKANT EKNATH SHINDE,Shiv Sena,587921,1715,589636,56.38,24 - Kalyan (Maharashtra),13,24
2.0,VAISHALI DAREKAR - RANE,Shiv Sena (Uddhav Balasaheb Thackrey),379236,1256,380492,36.39,24 - Kalyan (Maharashtra),13,24
3.0,MO. SAHABUDDIN SHAIKH SULEMANI THAKUR,Vanchit Bahujan Aaghadi,18697,44,18741,1.79,24 - Kalyan (Maharashtra),13,24
4.0,PRASHANT RAMESH INGLE,Bahujan Samaj Party,11285,56,11341,1.08,24 - Kalyan (Maharashtra),13,24
5.0,AMIT UPADHYAY,Right to Recall Party,4185,20,4205,0.4,24 - Kalyan (Maharashtra),13,24
6.0,ARUN BHAURAO NITURE,Rashtriya Kisan Bahujan Party,2751,2,2753,0.26,24 - Kalyan (Maharashtra),13,24
7.0,AMRISH RAJ MORAJKAR,Independent,2616,4,2620,0.25,24 - Kalyan (Maharashtra),13,24
8.0,ASHWINI AMOL KENDRE,Independent,2461,7,2468,0.24,24 - Kalyan (Maharashtra),13,24
9.0,NAFIS AHMED ANSARI,Independent,1997,3,2000,0.19,24 - Kalyan (Maharashtra),13,24
10.0,SUSHILA KASHINATH KAMBLE,Bahujan Samaj Party (Ambedkar),1847,11,1858,0.18,24 - Kalyan (Maharashtra),13,24
11.0,ABHIJIT WAMANRAO BICHUKALE,Independent,1823,1,1824,0.17,24 - Kalyan (Maharashtra),13,24
12.0,AJAY SHYAM MORYA,Independent,1798,4,1802,0.17,24 - Kalyan (Maharashtra),13,24
13.0,SAMBHAJI JAGANNATH JADHAV,Sanyukt Bharat Paksh,1607,2,1609,0.15,24 - Kalyan (Maharashtra),13,24
14.0,CHANDRAKANT RAMBHAJI MOTE,Independent,1378,2,1380,0.13,24 - Kalyan (Maharashtra),13,24
15.0,POONAM JAGANNATH BAISANE,Bahujan Republican Socialist Party,1376,5,1381,0.13,24 - Kalyan (Maharashtra),13,24
16.0,HINDURAO DADU PATIL,Rashtriya Maratha Party,1236,7,1243,0.12,24 - Kalyan (Maharashtra),13,24
17.0,GAWALI PRAVIN SHIVAJI,Apni Prajahit Party,1080,2,1082,0.1,24 - Kalyan (Maharashtra),13,24
18.0,ARUN VAMAN JADHAV,Independent,1077,5,1082,0.1,24 - Kalyan (Maharashtra),13,24
19.0,SHRIDHAR NARAYAN SALVE,Bhim Sena,1068,4,1072,0.1,24 - Kalyan (Maharashtra),13,24
20.0,SHRIKANT SHIVAJI VANJARE,Peoples Party of India (Democratic),806,2,808,0.08,24 - Kalyan (Maharashtra),13,24
21.0,PRAJAKTA NILESH YELVE,Independent,780,3,783,0.07,24 - Kalyan (Maharashtra),13,24
22.0,DNYANESHWAR LOKHANDE MAHARAJ,Independent,738,3,741,0.07,24 - Kalyan (Maharashtra),13,24
23.0,ADV. HITESH JAIKISHAN JESWANI,Independent,712,3,715,0.07,24 - Kalyan (Maharashtra),13,24
24.0,MOHAMMAD YUSUF KHAN,Independent,648,5,653,0.06,24 - Kalyan (Maharashtra),13,24
25.0,RAKESH KUMAR DHISULAL JAIN,Independent,599,3,602,0.06,24 - Kalyan (Maharashtra),13,24
26.0,SHIVA KRISHNAMURTI IYER,Independent,435,2,437,0.04,24 - Kalyan (Maharashtra),13,24
27.0,SALIMUDDIN KHALILUDDIN SHAIKH,Independent,370,1,371,0.04,24 - Kalyan (Maharashtra),13,24
28.0,DR. SACHIN SAHEBRAO PATIL,Independent,346,5,351,0.03,24 - Kalyan (Maharashtra),13,24
29.0,NOTA,None of the Above,11603,83,11686,1.12,24 - Kalyan (Maharashtra),13,24
,Total,,1042476,3260,1045736,,24 - Kalyan (Maharashtra),13,24
1.0,NARESH GANPAT MHASKE,Shiv Sena,732109,2122,734231,56.09,25 - Thane (Maharashtra),13,25
2.0,RAJAN BABURAO VICHARE,Shiv Sena (Uddhav Balasaheb Thackrey),515013,2207,517220,39.51,25 - Thane (Maharashtra),13,25
3.0,SANTOSH BHIKAJI BHALERAO,Bahujan Samaj Party,10602,60,10662,0.81,25 - Thane (Maharashtra),13,25
4.0,ADV. GURUDEV NARSINGH SURYAWANSHI,Independent,3489,5,3494,0.27,25 - Thane (Maharashtra),13,25
5.0,MUKESH KAILASNATH TIWARI,Bhim Sena,2509,13,2522,0.19,25 - Thane (Maharashtra),13,25
6.0,JHA SUBHASH CHANDRA,Sardar Vallabhbhai Patel Party,2354,4,2358,0.18,25 - Thane (Maharashtra),13,25
7.0,DR. PIYUSH K. SAXENA,Independent,2292,1,2293,0.18,25 - Thane (Maharashtra),13,25
8.0,CHANDRAKANT VITTHAL SONAWANE,Independent,2245,4,2249,0.17,25 - Thane (Maharashtra),13,25
9.0,VIJAY DNYANOBA GHATE,Republican Bahujan Sena,1870,17,1887,0.14,25 - Thane (Maharashtra),13,25
10.0,IRFAN IBRAHIM SHAIKH,Independent,1867,8,1875,0.14,25 - Thane (Maharashtra),13,25
11.0,PRAMOD ANANDRAO DHUMAL,Independent,1785,1,1786,0.14,25 - Thane (Maharashtra),13,25
12.0,BHANWARLAL KHETMAL MEHTA,Hindu Samaj Party,1483,5,1488,0.11,25 - Thane (Maharashtra),13,25
13.0,UTTAM KISANRAO TIRPUDE,Peoples Party of India (Democratic),1349,5,1354,0.1,25 - Thane (Maharashtra),13,25
14.0,ARCHANA DINKAR GAIKWAD,Independent,1164,16,1180,0.09,25 - Thane (Maharashtra),13,25
15.0,SALIMA MUKTAR VASANI,Bahujan Maha Party,905,7,912,0.07,25 - Thane (Maharashtra),13,25
16.0,RAJIV KONDIBA BHOSALE,Independent,878,8,886,0.07,25 - Thane (Maharashtra),13,25
17.0,RAHUL JAGBIRSINGH MEHAROLIYA,Bahujan Republican Socialist Party,818,-,818,0.06,25 - Thane (Maharashtra),13,25
18.0,RAJENDRA RAMCHANDRA SANKHE,Bharatheeya Jawan Kisan Party,759,8,767,0.06,25 - Thane (Maharashtra),13,25
19.0,KHAJASAB RASULSAB MULLA,Independent,646,2,648,0.05,25 - Thane (Maharashtra),13,25
20.0,SANJAY MANOHAR MORE,Independent,639,4,643,0.05,25 - Thane (Maharashtra),13,25
21.0,MALLIKARJUN SAYBANNA PUJARI,Independent,597,2,599,0.05,25 - Thane (Maharashtra),13,25
22.0,SAWALE DATTATRAY SITARAM,Independent,529,2,531,0.04,25 - Thane (Maharashtra),13,25
23.0,SURENDRAKUMAR K. JAIN,Independent,438,2,440,0.03,25 - Thane (Maharashtra),13,25
24.0,SIDDHANT CHHABAN SHIRSAT,Independent,319,5,324,0.02,25 - Thane (Maharashtra),13,25
25.0,NOTA,None of the Above,17768,133,17901,1.37,25 - Thane (Maharashtra),13,25
,Total,,1304427,4641,1309068,,25 - Thane (Maharashtra),13,25
1.0,PIYUSH GOYAL,Bharatiya Janata Party,678451,1695,680146,65.68,26 - Mumbai North (Maharashtra),13,26
2.0,BHUSHAN PATIL,Indian National Congress,321455,1083,322538,31.15,26 - Mumbai North (Maharashtra),13,26
3.0,ADV. SONAL DIWAKAR GONDANE,Vanchit Bahujan Aaghadi,6007,45,6052,0.58,26 - Mumbai North (Maharashtra),13,26
4.0,RAIS DOCTOR,Bahujan Samaj Party,2907,16,2923,0.28,26 - Mumbai North (Maharashtra),13,26
5.0,PANDEY DHARMENDRA RAMMURAT,Independent,1481,-,1481,0.14,26 - Mumbai North (Maharashtra),13,26
6.0,DIPTI ASHOK WALAWALKAR,Independent,1461,11,1472,0.14,26 - Mumbai North (Maharashtra),13,26
7.0,COMRADE JAYRAM VISHWAKARMA,Socialist Unity Centre Of India (COMMUNIST),1194,1,1195,0.12,26 - Mumbai North (Maharashtra),13,26
8.0,MUNNALAL GAJRAJ PRAJAPATI,Independent,968,3,971,0.09,26 - Mumbai North (Maharashtra),13,26
9.0,LAXMAN YELLPPA KURADE,Independent,680,6,686,0.07,26 - Mumbai North (Maharashtra),13,26
10.0,ADVOCATE KAPIL K. SONI,Independent,630,3,633,0.06,26 - Mumbai North (Maharashtra),13,26
11.0,DEEPALI BHAWARSING SHEKHAWAT,Maharashtra Vikas Aghadi,621,4,625,0.06,26 - Mumbai North (Maharashtra),13,26
12.0,KAMLESH DAYABHAI VYAS,Sardar Vallabhbhai Patel Party,619,3,622,0.06,26 - Mumbai North (Maharashtra),13,26
13.0,BIPIN BACHUBHAI SHAH,Hindu Samaj Party,505,3,508,0.05,26 - Mumbai North (Maharashtra),13,26
14.0,GURUDAS RAMDAS KHAIRNAR,Independent,484,2,486,0.05,26 - Mumbai North (Maharashtra),13,26
15.0,RAVI BABU GAVLI,Samata Party,447,3,450,0.04,26 - Mumbai North (Maharashtra),13,26
16.0,JAEENDRA VASANT SURVE,Bharatheeya Jawan Kisan Party,398,7,405,0.04,26 - Mumbai North (Maharashtra),13,26
17.0,ALIEK SUNDER MESHRAM,Bharatiya Mulnivasi Aazad Party,393,3,396,0.04,26 - Mumbai North (Maharashtra),13,26
18.0,SAYED ZULFIQAR ALAM,Bahujan Maha Party,344,4,348,0.03,26 - Mumbai North (Maharashtra),13,26
19.0,SANJAY MAFATLAL MORAKHIA,Independent,210,-,210,0.02,26 - Mumbai North (Maharashtra),13,26
20.0,NOTA,None of the Above,13248,98,13346,1.29,26 - Mumbai North (Maharashtra),13,26
,Total,,1032503,2990,1035493,,26 - Mumbai North (Maharashtra),13,26
1.0,AMOL GAJANAN KIRTIKAR,Shiv Sena (Uddhav Balasaheb Thackrey),451095,1501,452596,47.4,27 - Mumbai North West (Maharashtra),13,27
2.0,RAVINDRA DATTARAM WAIKAR,Shiv Sena,451094,1550,452644,47.4,27 - Mumbai North West (Maharashtra),13,27
3.0,PARMESHWAR ASHOK RANSHUR,Vanchit Bahujan Aaghadi,10001,51,10052,1.05,27 - Mumbai North West (Maharashtra),13,27
4.0,RAJESH RAMKISAN MALLAH,Bahujan Samaj Party,4790,22,4812,0.5,27 - Mumbai North West (Maharashtra),13,27
5.0,SAMEER MORE,Independent,3171,2,3173,0.33,27 - Mumbai North West (Maharashtra),13,27
6.0,SUNIL BHIMA CHAVAN,Independent,1999,3,2002,0.21,27 - Mumbai North West (Maharashtra),13,27
7.0,BALA VENKATESH VINAYAK NADAR,Aapki Apni Party (Peoples),1756,7,1763,0.18,27 - Mumbai North West (Maharashtra),13,27
8.0,ARORA SURINDER MOHAN,Bharat Jan Aadhar Party,1667,8,1675,0.18,27 - Mumbai North West (Maharashtra),13,27
9.0,ROHAN SATONE,Independent,1476,3,1479,0.15,27 - Mumbai North West (Maharashtra),13,27
10.0,ADV. SANJEEVKUMAR APPARAV KALKORI,Independent,1184,13,1197,0.13,27 - Mumbai North West (Maharashtra),13,27
11.0,ADV. LATA PANDURANG SHINDE,Independent,1152,2,1154,0.12,27 - Mumbai North West (Maharashtra),13,27
12.0,MANOJ SHRAVAN NAYAK,Right to Recall Party,1132,17,1149,0.12,27 - Mumbai North West (Maharashtra),13,27
13.0,HRUDA DHANANJAY SHINDE,Independent,1066,12,1078,0.11,27 - Mumbai North West (Maharashtra),13,27
14.0,BHARAT KHIMJI SHAH,Hindu Samaj Party,932,5,937,0.1,27 - Mumbai North West (Maharashtra),13,27
15.0,SUSHMA DAYANAND MEHTA,Independent,875,7,882,0.09,27 - Mumbai North West (Maharashtra),13,27
16.0,ADVOCATE KAPIL KANTILAL SONI,Independent,776,4,780,0.08,27 - Mumbai North West (Maharashtra),13,27
17.0,SARIKA DABRAL,India Greens Party,760,8,768,0.08,27 - Mumbai North West (Maharashtra),13,27
18.0,GAJANAN TUKARAM SONKAMBLE,Independent,496,5,501,0.05,27 - Mumbai North West (Maharashtra),13,27
19.0,ADV MITESH VARSHNEY,Bhim Sena,492,5,497,0.05,27 - Mumbai North West (Maharashtra),13,27
20.0,HARISHANKAR YADAV,Samaj Vikas Kranti Party,398,7,405,0.04,27 - Mumbai North West (Maharashtra),13,27
21.0,SANTOSH MANIK RAYBAN,Independent,234,-,234,0.02,27 - Mumbai North West (Maharashtra),13,27
22.0,NOTA,None of the Above,15036,125,15161,1.59,27 - Mumbai North West (Maharashtra),13,27
,Total,,951582,3357,954939,,27 - Mumbai North West (Maharashtra),13,27
1.0,SANJAY DINA PATIL,Shiv Sena (Uddhav Balasaheb Thackrey),448604,2333,450937,48.67,28 - Mumbai North East (Maharashtra),13,28
2.0,MIHIR CHANDRAKANT KOTECHA,Bharatiya Janata Party,419589,1487,421076,45.45,28 - Mumbai North East (Maharashtra),13,28
3.0,DAULAT KADAR KHAN,Vanchit Bahujan Aaghadi,14571,86,14657,1.58,28 - Mumbai North East (Maharashtra),13,28
4.0,NANDESH VITHAL UMAP,Bahujan Samaj Party,8217,101,8318,0.9,28 - Mumbai North East (Maharashtra),13,28
5.0,DR. SUSHMA MAURYA,Independent,2886,5,2891,0.31,28 - Mumbai North East (Maharashtra),13,28
6.0,SANJAY B. PATIL,National People's Party,2757,7,2764,0.3,28 - Mumbai North East (Maharashtra),13,28
7.0,SANJU MARUTI PAWAR,Maharashtra Vikas Aghadi,2555,27,2582,0.28,28 - Mumbai North East (Maharashtra),13,28
8.0,PROF. DR. PRASHANT GANGAWANE,Desh Janhit Party,2338,35,2373,0.26,28 - Mumbai North East (Maharashtra),13,28
9.0,PREM RAMAPATI GUPTA,Independent,1598,3,1601,0.17,28 - Mumbai North East (Maharashtra),13,28
10.0,MOHAMMED AHMED SHAIKH,Independent,1289,5,1294,0.14,28 - Mumbai North East (Maharashtra),13,28
11.0,MOHAMMAD ARMAN MOHAMMAD WASI KHAN,Rashtriya Janhit Sangharsh Party,1085,5,1090,0.12,28 - Mumbai North East (Maharashtra),13,28
12.0,VIDYA NAIK,Independent,974,5,979,0.11,28 - Mumbai North East (Maharashtra),13,28
13.0,BHOPINDER SINGH SAINI,Viro Ke Vir Indian Party,941,5,946,0.1,28 - Mumbai North East (Maharashtra),13,28
14.0,BANSODE DILIP,Independent,831,7,838,0.09,28 - Mumbai North East (Maharashtra),13,28
15.0,BHAWANI H. CHOUDHARY,Sardar Vallabhbhai Patel Party,742,4,746,0.08,28 - Mumbai North East (Maharashtra),13,28
16.0,DATTATRAY ARJUN UTEKAR,Bharatheeya Jawan Kisan Party,707,4,711,0.08,28 - Mumbai North East (Maharashtra),13,28
17.0,COMRADE SURENDRA SIBAG,All India Forward Bloc,675,3,678,0.07,28 - Mumbai North East (Maharashtra),13,28
18.0,SHAHAJI NANAI THORAT,Independent,648,2,650,0.07,28 - Mumbai North East (Maharashtra),13,28
19.0,SANJAY SAOJI DESHPANDE,Republican Party of India,641,-,641,0.07,28 - Mumbai North East (Maharashtra),13,28
20.0,SANJAY PATIL,Independent,520,4,524,0.06,28 - Mumbai North East (Maharashtra),13,28
21.0,NOTA,None of the Above,10088,85,10173,1.1,28 - Mumbai North East (Maharashtra),13,28
,Total,,922256,4213,926469,,28 - Mumbai North East (Maharashtra),13,28
1.0,GAIKWAD VARSHA EKNATH,Indian National Congress,444098,1447,445545,48.93,29 - Mumbai North Central (Maharashtra),13,29
2.0,ADV UJWAL NIKAM,Bharatiya Janata Party,427387,1644,429031,47.12,29 - Mumbai North Central (Maharashtra),13,29
3.0,SANTOSH GANPAT AMBULGE,Vanchit Bahujan Aaghadi,8233,55,8288,0.91,29 - Mumbai North Central (Maharashtra),13,29
4.0,AYYUB AMIN HUNGUND,Bahujan Samaj Party,3229,14,3243,0.36,29 - Mumbai North Central (Maharashtra),13,29
5.0,ANSON THOMAS,People's Party of India(secular),2207,4,2211,0.24,29 - Mumbai North Central (Maharashtra),13,29
6.0,RAMZAN ALI CHAUDHARY,All India Majlis-E-Ittehadul Muslimeen,1521,10,1531,0.17,29 - Mumbai North Central (Maharashtra),13,29
7.0,AJAZ MOHAMMAD SAFI KHAN,Independent,1041,-,1041,0.11,29 - Mumbai North Central (Maharashtra),13,29
8.0,HAYATULAH ABDULAH SHAIKH,Akhil Bharatiya Muslim League (Secular),818,3,821,0.09,29 - Mumbai North Central (Maharashtra),13,29
9.0,NAZMAKHATHUN MOHAMMED ZAFAR KHAN,Independent,730,2,732,0.08,29 - Mumbai North Central (Maharashtra),13,29
10.0,SHANTARAM S DIGHE,Independent,723,10,733,0.08,29 - Mumbai North Central (Maharashtra),13,29
11.0,NARENDRA MISHRA,Independent,706,2,708,0.08,29 - Mumbai North Central (Maharashtra),13,29
12.0,ADV ASIF ALI SIDDIQUIE,Independent,681,2,683,0.08,29 - Mumbai North Central (Maharashtra),13,29
13.0,HARSHADA BABURAV JADHAV,Maharashtra Vikas Aghadi,673,17,690,0.08,29 - Mumbai North Central (Maharashtra),13,29
14.0,RAMA ARUN SABLE,Independent,626,10,636,0.07,29 - Mumbai North Central (Maharashtra),13,29
15.0,SANDEEP BHAU RAMCHANDRA JADHAV,Independent,619,4,623,0.07,29 - Mumbai North Central (Maharashtra),13,29
16.0,DR GAFFAR IBRAHIM SAYED,Independent,584,2,586,0.06,29 - Mumbai North Central (Maharashtra),13,29
17.0,ADV UTTAMKUMAR NAKUL SAJANI SAHU,Independent,554,4,558,0.06,29 - Mumbai North Central (Maharashtra),13,29
18.0,KHAN ABBAS AHMED,Bahujan Maha Party,427,1,428,0.05,29 - Mumbai North Central (Maharashtra),13,29
19.0,MUSHTAQUE HAIDER SHAIKH,Independent,405,-,405,0.04,29 - Mumbai North Central (Maharashtra),13,29
20.0,DR ADV YASHWANT RAMBHAU KASBE,Bhartiya Jan Vikas Aaghadi,385,6,391,0.04,29 - Mumbai North Central (Maharashtra),13,29
21.0,KURBAN SHAHADAT HUSAIN,Rashtriya Ulama Council,366,1,367,0.04,29 - Mumbai North Central (Maharashtra),13,29
22.0,ABDUL TAHIR ADVOCATE BABLU RAJNIKANT,Independent,355,-,355,0.04,29 - Mumbai North Central (Maharashtra),13,29
23.0,SHAUKAT ABDUL RAFIQ KHAN,Insaniyat Party,341,4,345,0.04,29 - Mumbai North Central (Maharashtra),13,29
24.0,RAJESH MOHAN LOKHANDE,Independent,282,7,289,0.03,29 - Mumbai North Central (Maharashtra),13,29
25.0,YUNUSALI RASHID MULLA,Independent,220,-,220,0.02,29 - Mumbai North Central (Maharashtra),13,29
26.0,ADV FEROZ SHAIKH,Independent,180,-,180,0.02,29 - Mumbai North Central (Maharashtra),13,29
27.0,MUZAFAR ALI SHAIKH,Independent,173,-,173,0.02,29 - Mumbai North Central (Maharashtra),13,29
28.0,NOTA,None of the Above,9665,84,9749,1.07,29 - Mumbai North Central (Maharashtra),13,29
,Total,,907229,3333,910562,,29 - Mumbai North Central (Maharashtra),13,29
1.0,ANIL YESHWANT DESAI,Shiv Sena (Uddhav Balasaheb Thackrey),393342,1796,395138,49.73,30 - Mumbai South Central (Maharashtra),13,30
2.0,RAHUL RAMESH SHEWALE,Shiv Sena,339828,1926,341754,43.01,30 - Mumbai South Central (Maharashtra),13,30
3.0,ABUL HASAN ALI HASAN KHAN,Vanchit Bahujan Aaghadi,23675,192,23867,3.0,30 - Mumbai South Central (Maharashtra),13,30
4.0,VIDHYASAGAR ALIAS SURESH BHIMRAO VIDHYAGAR,Bahujan Samaj Party,6462,70,6532,0.82,30 - Mumbai South Central (Maharashtra),13,30
5.0,AKASH LAXMAN KHARATMAL,Independent,1891,8,1899,0.24,30 - Mumbai South Central (Maharashtra),13,30
6.0,ASHWINI KUMAR PATHAK,Independent,1607,5,1612,0.2,30 - Mumbai South Central (Maharashtra),13,30
7.0,ADV. SANTOSH PUNJIRAM SANJKAR,Independent,1565,13,1578,0.2,30 - Mumbai South Central (Maharashtra),13,30
8.0,KARAM HUSSAIN KITABULLAH KHAN,Peace Party,1533,4,1537,0.19,30 - Mumbai South Central (Maharashtra),13,30
9.0,ADV. MAHENDRA TULSHIRAM BHINGARDIVE,Right to Recall Party,1414,30,1444,0.18,30 - Mumbai South Central (Maharashtra),13,30
10.0,SAEED CHOUDHARY,Social Democratic Party Of India,1186,5,1191,0.15,30 - Mumbai South Central (Maharashtra),13,30
11.0,ISHWAR VILAS TATHAWADE,Rashtriya Mahaswaraj Bhumi Party,968,3,971,0.12,30 - Mumbai South Central (Maharashtra),13,30
12.0,DEEPAK M. CHAUGULE,Bahujan Republican Socialist Party,968,7,975,0.12,30 - Mumbai South Central (Maharashtra),13,30
13.0,JAHID ALI NASIR AHMED SHAIKH,Aazad Samaj Party (Kanshi Ram),957,2,959,0.12,30 - Mumbai South Central (Maharashtra),13,30
14.0,DR. ARJUN MAHADEO MURUDKAR,Bharatheeya Jawan Kisan Party,913,17,930,0.12,30 - Mumbai South Central (Maharashtra),13,30
15.0,VIVEK YESHWANT PATIL,Independent,713,1,714,0.09,30 - Mumbai South Central (Maharashtra),13,30
16.0,NOTA,None of the Above,13316,107,13423,1.69,30 - Mumbai South Central (Maharashtra),13,30
,Total,,790338,4186,794524,,30 - Mumbai South Central (Maharashtra),13,30
1.0,ARVIND GANPAT SAWANT,Shiv Sena (Uddhav Balasaheb Thackrey),393735,1920,395655,51.18,31 - Mumbai South (Maharashtra),13,31
2.0,YAMINI YASHWANT JADHAV,Shiv Sena,341291,1691,342982,44.36,31 - Mumbai South (Maharashtra),13,31
3.0,AFZAL S. DAWOODANI,Vanchit Bahujan Aaghadi,5575,37,5612,0.73,31 - Mumbai South (Maharashtra),13,31
4.0,MOHAMMED SHUAIB BASHIR KHATEEB,Bahujan Samaj Party,4440,38,4478,0.58,31 - Mumbai South (Maharashtra),13,31
5.0,ARVIND NARAYAN SAWANT,Independent,3065,25,3090,0.4,31 - Mumbai South (Maharashtra),13,31
6.0,MOHD. NAEEM SHAIKH,Aim Political Party,1709,6,1715,0.22,31 - Mumbai South (Maharashtra),13,31
7.0,SABEEHA KHAN,Independent,1678,16,1694,0.22,31 - Mumbai South (Maharashtra),13,31
8.0,GOHIL MANISHA SHIVRAM,Independent,1032,13,1045,0.14,31 - Mumbai South (Maharashtra),13,31
9.0,SHANKAR SONAWANE,Independent,854,8,862,0.11,31 - Mumbai South (Maharashtra),13,31
10.0,RAHUL PHANASWADIKAR,Lokshahi Ekta Party,784,3,787,0.1,31 - Mumbai South (Maharashtra),13,31
11.0,SUBHASH RAMESH CHIPLUNKAR,Rashtriya Kisan Bahujan Party,563,4,567,0.07,31 - Mumbai South (Maharashtra),13,31
12.0,PRASHANT PRAKASH GHADGE,Independent,487,3,490,0.06,31 - Mumbai South (Maharashtra),13,31
13.0,MOHAMMED MAHTAB SHAIKH,Independent,455,3,458,0.06,31 - Mumbai South (Maharashtra),13,31
14.0,MATEEN AHMED RANGREJ,Independent,265,2,267,0.03,31 - Mumbai South (Maharashtra),13,31
15.0,NOTA,None of the Above,13290,121,13411,1.73,31 - Mumbai South (Maharashtra),13,31
,Total,,769223,3890,773113,,31 - Mumbai South (Maharashtra),13,31
1.0,TATKARE SUNIL DATTATREY,Nationalist Congress Party,506529,1823,508352,50.17,32 - Raigad (Maharashtra),13,32
2.0,ANANT GEETE,Shiv Sena (Uddhav Balasaheb Thackrey),423137,2431,425568,42.0,32 - Raigad (Maharashtra),13,32
3.0,KUMUDINI RAVINDRA CHAVAN,Vanchit Bahujan Aaghadi,19500,118,19618,1.94,32 - Raigad (Maharashtra),13,32
4.0,SHRINIVAS SATYANARAYAN MATTAPARTI,Independent,9379,15,9394,0.93,32 - Raigad (Maharashtra),13,32
5.0,AMIT SHRIPAL KAWADE,Independent,5603,31,5634,0.56,32 - Raigad (Maharashtra),13,32
6.0,ANANT BALOJI GITE,Independent,3485,30,3515,0.35,32 - Raigad (Maharashtra),13,32
7.0,NITIN JAGANNATH MAYEKAR,Independent,2548,12,2560,0.25,32 - Raigad (Maharashtra),13,32
8.0,CHAULE PANDURANG DAMODAR,Independent,2394,23,2417,0.24,32 - Raigad (Maharashtra),13,32
9.0,ANANT PADMA GITE,Independent,2001,39,2040,0.2,32 - Raigad (Maharashtra),13,32
10.0,COL PRAKASHRAO CHAVAN,Bharatheeya Jawan Kisan Party,1863,76,1939,0.19,32 - Raigad (Maharashtra),13,32
11.0,KOLI MANGESH PADMAKAR,Independent,1797,23,1820,0.18,32 - Raigad (Maharashtra),13,32
12.0,ADV AJAY UPADHYE,Independent,1756,39,1795,0.18,32 - Raigad (Maharashtra),13,32
13.0,ANJANI ASHWIN KELKAR,Independent,1325,25,1350,0.13,32 - Raigad (Maharashtra),13,32
14.0,NOTA,None of the Above,27188,82,27270,2.69,32 - Raigad (Maharashtra),13,32
,Total,,1008505,4767,1013272,,32 - Raigad (Maharashtra),13,32
1.0,SHRIRANG APPA CHANDU BARNE,Shiv Sena,692101,731,692832,48.81,33 - Maval (Maharashtra),13,33
2.0,SANJOG BHIKU WAGHERE PATIL,Shiv Sena (Uddhav Balasaheb Thackrey),595542,675,596217,42.0,33 - Maval (Maharashtra),13,33
3.0,MADHAVITAI NARESH JOSHI,Vanchit Bahujan Aaghadi,27745,23,27768,1.96,33 - Maval (Maharashtra),13,33
4.0,RAJARAM NARAYAN PATIL,Bahujan Samaj Party,13982,21,14003,0.99,33 - Maval (Maharashtra),13,33
5.0,ADV JYOTISHWAR VISHNU BHOSALE,Baliraja Party,10874,5,10879,0.77,33 - Maval (Maharashtra),13,33
6.0,UMAKANT RAMESHWAR MISHRA,Independent,5029,1,5030,0.35,33 - Maval (Maharashtra),13,33
7.0,SANJOG PATIL,Independent,4828,2,4830,0.34,33 - Maval (Maharashtra),13,33
8.0,KAMBLE MARUTI APARAI,Independent,4827,2,4829,0.34,33 - Maval (Maharashtra),13,33
9.0,AJAY HANUMANT LONDHE,Independent,4766,1,4767,0.34,33 - Maval (Maharashtra),13,33
10.0,SANTOSH UBALE,Bhim Sena,3824,1,3825,0.27,33 - Maval (Maharashtra),13,33
11.0,ADHALGE LAXMAN SADASHIV,Independent,3166,1,3167,0.22,33 - Maval (Maharashtra),13,33
12.0,SUHAS MANOHAR RANE,Independent,2923,-,2923,0.21,33 - Maval (Maharashtra),13,33
13.0,IQBAL IBRAHIM NAWDEKAR,Independent,2899,1,2900,0.2,33 - Maval (Maharashtra),13,33
14.0,DADARAO KISAN KAMBLE,Independent,2636,6,2642,0.19,33 - Maval (Maharashtra),13,33
15.0,RAHUL NIVRUTTI MADANE,Independent,2279,3,2282,0.16,33 - Maval (Maharashtra),13,33
16.0,TUSHAR DIGAMBAR LONDHE,Bahujan Bharat Party,2199,4,2203,0.16,33 - Maval (Maharashtra),13,33
17.0,RAHIM MAINUDDIN SAYYAD,Aazad Samaj Party (Kanshi Ram),2148,1,2149,0.15,33 - Maval (Maharashtra),13,33
18.0,INDRAJEET D GOND,Independent,2135,-,2135,0.15,33 - Maval (Maharashtra),13,33
19.0,SHIVAJI KISAN JADHAV,All India Forward Bloc,1672,4,1676,0.12,33 - Maval (Maharashtra),13,33
20.0,YASHWANT VITTHAL PAWAR,Kranti Kari Jai Hind Sena,1634,4,1638,0.12,33 - Maval (Maharashtra),13,33
21.0,PRAFUL PANDIT BHOSALE,Independent,1602,1,1603,0.11,33 - Maval (Maharashtra),13,33
22.0,RAJENDRA MARUTI KATE,Independent,1417,2,1419,0.1,33 - Maval (Maharashtra),13,33
23.0,MAHESH THAKUR,Dharmarajya Paksha,1369,3,1372,0.1,33 - Maval (Maharashtra),13,33
24.0,PRASHANT RAMKRISHNA BHAGAT,Bharatheeya Jawan Kisan Party,1283,8,1291,0.09,33 - Maval (Maharashtra),13,33
25.0,PANKAJ PRABHAKAR OZARKAR,Akhil Bhartiya Parivar Party,1259,2,1261,0.09,33 - Maval (Maharashtra),13,33
26.0,MANOJ BHASKAR GARBADE,Independent,1233,-,1233,0.09,33 - Maval (Maharashtra),13,33
27.0,HAJRAT IMAMSAB PATEL,Independent,1093,-,1093,0.08,33 - Maval (Maharashtra),13,33
28.0,GOVIND GANGARAM HERODE,Independent,966,-,966,0.07,33 - Maval (Maharashtra),13,33
29.0,MADHUKAR DAMODAR THORAT,Independent,905,-,905,0.06,33 - Maval (Maharashtra),13,33
30.0,RAFIQUE RASHID QURESHI,Desh Janhit Party,829,-,829,0.06,33 - Maval (Maharashtra),13,33
31.0,CHIMAJI DHONDIBA SHINDE,Independent,757,-,757,0.05,33 - Maval (Maharashtra),13,33
32.0,ADV RAJU PATIL,Independent,669,1,670,0.05,33 - Maval (Maharashtra),13,33
33.0,MUKESH MANOHAR AGARWAL,Independent,546,1,547,0.04,33 - Maval (Maharashtra),13,33
34.0,NOTA,None of the Above,16729,31,16760,1.18,33 - Maval (Maharashtra),13,33
,Total,,1417866,1535,1419401,,33 - Maval (Maharashtra),13,33
1.0,MURLIDHAR MOHOL,Bharatiya Janata Party,584171,557,584728,52.94,34 - Pune (Maharashtra),13,34
2.0,DHANGEKAR RAVINDRA HEMRAJ,Indian National Congress,461409,281,461690,41.8,34 - Pune (Maharashtra),13,34
3.0,VASANT (TATYA) MORE,Vanchit Bahujan Aaghadi,31991,21,32012,2.9,34 - Pune (Maharashtra),13,34
4.0,RANPISE PRASHANT DADARAM,Bahujan Samaj Party,3969,5,3974,0.36,34 - Pune (Maharashtra),13,34
5.0,CHORMALE SANDIP SOPAN,Independent,1644,1,1645,0.15,34 - Pune (Maharashtra),13,34
6.0,GORAKH NARAYAN GHODKE,Independent,1451,-,1451,0.13,34 - Pune (Maharashtra),13,34
7.0,KIRAN LAXMAN RAYKAR,Independent,1052,-,1052,0.1,34 - Pune (Maharashtra),13,34
8.0,ANIS ARASHID SUNDAKE,All India Majlis-E-Ittehadul Muslimeen,859,1,860,0.08,34 - Pune (Maharashtra),13,34
9.0,SACHIN DATTATRAY DHANKUDE,Independent,788,1,789,0.07,34 - Pune (Maharashtra),13,34
10.0,YUVRAJ CHANDRAKANT LIMBOLE,Right to Recall Party,698,-,698,0.06,34 - Pune (Maharashtra),13,34
11.0,DR. DEVYANI PANDIT,Independent,645,5,650,0.06,34 - Pune (Maharashtra),13,34
12.0,NARENDRA DNYANESHWAR PAWTEKAR,Independent,533,1,534,0.05,34 - Pune (Maharashtra),13,34
13.0,SAGAR SAMBHAJI PORE,Independent,515,-,515,0.05,34 - Pune (Maharashtra),13,34
14.0,SURESH DNYANOBA PATIL,Sainik Samaj Party,437,-,437,0.04,34 - Pune (Maharashtra),13,34
15.0,AMBORE MANJUNATH MARUTI,Independent,433,-,433,0.04,34 - Pune (Maharashtra),13,34
16.0,ASHWINI PRATIBHA KHAIRNAR,Independent,412,3,415,0.04,34 - Pune (Maharashtra),13,34
17.0,VIJAY VINAYAK JAGTAP,Independent,382,-,382,0.03,34 - Pune (Maharashtra),13,34
18.0,HEMANT BABURAV KOLEKAR ALIAS HEMANT PATIL,Apni Prajahit Party,374,1,375,0.03,34 - Pune (Maharashtra),13,34
19.0,NEERAJ SUNIL KAMTHAN,Hindu Samaj Party,351,-,351,0.03,34 - Pune (Maharashtra),13,34
20.0,MANOJ LAXMAN VETAL,Bhim Sena,351,1,352,0.03,34 - Pune (Maharashtra),13,34
21.0,KAMBLE MILIND,Bahujan Samaj Party (Ambedkar),344,3,347,0.03,34 - Pune (Maharashtra),13,34
22.0,CHANDRAKANT PARMESHWAR SAWANT,Independent,314,-,314,0.03,34 - Pune (Maharashtra),13,34
23.0,SHABBIR SAJJANBHAI TAMBOLI,Independent,313,-,313,0.03,34 - Pune (Maharashtra),13,34
24.0,SANJAY LAXMAN KENDALE,Independent,311,-,311,0.03,34 - Pune (Maharashtra),13,34
25.0,JOHNSON VASANT KOLHAPURE,Independent,304,1,305,0.03,34 - Pune (Maharashtra),13,34
26.0,ADV. YOGESH MAKANE,Independent,298,1,299,0.03,34 - Pune (Maharashtra),13,34
27.0,SUBROTO ROY,Ekam Sanatan Bharat Dal,293,1,294,0.03,34 - Pune (Maharashtra),13,34
28.0,DR. BALASAHEB ARJUN POL,Independent,259,-,259,0.02,34 - Pune (Maharashtra),13,34
29.0,VIJAYALAXMI SHRIKANT SINDAGI,Rashtriya Maratha Party,239,1,240,0.02,34 - Pune (Maharashtra),13,34
30.0,MAHESH DASHRATH MHASKE,Independent,229,2,231,0.02,34 - Pune (Maharashtra),13,34
31.0,YABES ALIAS AMOL SHAMUVEL TUJARE,Independent,223,-,223,0.02,34 - Pune (Maharashtra),13,34
32.0,VIJAY PANDURANGRAO DESHMUKH (DABADGAONKAR),Independent,183,2,185,0.02,34 - Pune (Maharashtra),13,34
33.0,BABA SALIM SAYYED,Independent,163,1,164,0.01,34 - Pune (Maharashtra),13,34
34.0,BAGBAN SALEEM ABDUL RAZZAQUE,Independent,146,-,146,0.01,34 - Pune (Maharashtra),13,34
35.0,ZNYOSHO VIJAYPRAKASH,Independent,138,-,138,0.01,34 - Pune (Maharashtra),13,34
36.0,NOTA,None of the Above,7449,11,7460,0.68,34 - Pune (Maharashtra),13,34
,Total,,1103671,901,1104572,,34 - Pune (Maharashtra),13,34
1.0,SUPRIYA SULE,Nationalist Congress Party – Sharadchandra Pawar,731400,912,732312,51.85,35 - Baramati (Maharashtra),13,35
2.0,SUNETRA AJITDADA PAWAR,Nationalist Congress Party,573391,588,573979,40.64,35 - Baramati (Maharashtra),13,35
3.0,MAHESH SITARAM BHAGWAT,Independent,15620,43,15663,1.11,35 - Baramati (Maharashtra),13,35
4.0,SHAIKH SOYALSHAHA YUNUSSHAHA,Independent,14913,4,14917,1.06,35 - Baramati (Maharashtra),13,35
5.0,PRIYADARSHANI NANDKUMAR KOKARE,Bahujan Samaj Party,9995,35,10030,0.71,35 - Baramati (Maharashtra),13,35
6.0,SACHIN SHANKAR AGAWANE,Independent,6633,-,6633,0.47,35 - Baramati (Maharashtra),13,35
7.0,KAMBLE TRISHALA,Bahujan Samaj Party (Ambedkar),5032,4,5036,0.36,35 - Baramati (Maharashtra),13,35
8.0,SUNITA PAWAR,Independent,4150,1,4151,0.29,35 - Baramati (Maharashtra),13,35
9.0,GAJANAN UTTAM GAWALI (PATIL),Independent,2991,4,2995,0.21,35 - Baramati (Maharashtra),13,35
10.0,MANOJ BALASAHEB RASAL,Independent,2610,-,2610,0.18,35 - Baramati (Maharashtra),13,35
11.0,MAHADEV SAHEBRAO KHENGARE - PATIL,Bhartiya Navjawan Sena (Paksha),2412,6,2418,0.17,35 - Baramati (Maharashtra),13,35
12.0,PRADEEP RAMCHANDRA MANE,Independent,2234,1,2235,0.16,35 - Baramati (Maharashtra),13,35
13.0,SHIVAJI JAYSING KOKRE,Independent,2161,3,2164,0.15,35 - Baramati (Maharashtra),13,35
14.0,PROF. NAMDEORAO JADHAV,Independent,2125,9,2134,0.15,35 - Baramati (Maharashtra),13,35
15.0,RAJENDRA PANDURANG BHOSALE,People’s Union Party,2007,2,2009,0.14,35 - Baramati (Maharashtra),13,35
16.0,KALYANI SUJITKUMAR WAGHMODE,Independent,1974,1,1975,0.14,35 - Baramati (Maharashtra),13,35
17.0,DASHRATH NANA RAUT,Bharatiya Praja Surajya Paksha,1828,6,1834,0.13,35 - Baramati (Maharashtra),13,35
18.0,ANKUSH DNYANESHAWAR PILANE,Independent,1663,-,1663,0.12,35 - Baramati (Maharashtra),13,35
19.0,SANDIP ABAJI DEOKATE,Independent,1622,2,1624,0.11,35 - Baramati (Maharashtra),13,35
20.0,DATTATRAY RAMBHAU CHANDARE,Independent,1433,1,1434,0.1,35 - Baramati (Maharashtra),13,35
21.0,SHAILENDRA ALIAS SANDEEP KARANJAWANE,Independent,1392,-,1392,0.1,35 - Baramati (Maharashtra),13,35
22.0,SHUBHANGI DHAYGUDE,Independent,1283,9,1292,0.09,35 - Baramati (Maharashtra),13,35
23.0,DR. SOMNATH ALIAS BALASAHEB ARJUN POL,Independent,1169,-,1169,0.08,35 - Baramati (Maharashtra),13,35
24.0,ROHIDAS BALASO KONDAKE,Bahujan Republican Socialist Party,1127,3,1130,0.08,35 - Baramati (Maharashtra),13,35
25.0,MILIND VITTHAL SHINDE,Independent,1099,-,1099,0.08,35 - Baramati (Maharashtra),13,35
26.0,SURESHDADA BABURAO VIR,Independent,1012,-,1012,0.07,35 - Baramati (Maharashtra),13,35
27.0,BAPU PRALHAD PAWAR,Independent,997,1,998,0.07,35 - Baramati (Maharashtra),13,35
28.0,RAJENDRA MAHADEV BARAKADE,Independent,905,2,907,0.06,35 - Baramati (Maharashtra),13,35
29.0,UMESH MAHADEV MHETRE,Independent,807,1,808,0.06,35 - Baramati (Maharashtra),13,35
30.0,SHIVAJI RAMBHAU NANDKHILE,Bharatheeya Jawan Kisan Party,785,4,789,0.06,35 - Baramati (Maharashtra),13,35
31.0,SHARAD RAM PAWAR,Independent,730,1,731,0.05,35 - Baramati (Maharashtra),13,35
32.0,LAXMAN RAM KUMBHAR,Dalit Soshit Pichhara Varg Adhikar Dal,694,2,696,0.05,35 - Baramati (Maharashtra),13,35
33.0,SHRIDHAR NARAYAN SALVE,Bhim Sena,675,4,679,0.05,35 - Baramati (Maharashtra),13,35
34.0,BALASO MARUTI DHAPATE,Independent,655,-,655,0.05,35 - Baramati (Maharashtra),13,35
35.0,VIJAY LAXMAN GHAVALE,Independent,617,3,620,0.04,35 - Baramati (Maharashtra),13,35
36.0,VISHAL ARUN PAWAR,Independent,553,-,553,0.04,35 - Baramati (Maharashtra),13,35
37.0,SAVITA BHIMRAO KADALE,Hindustan Janta Party,549,2,551,0.04,35 - Baramati (Maharashtra),13,35
38.0,VIJAYPRAKASH ANANT KONDEKAR,Independent,301,-,301,0.02,35 - Baramati (Maharashtra),13,35
39.0,NOTA,None of the Above,9130,21,9151,0.65,35 - Baramati (Maharashtra),13,35
,Total,,1410674,1675,1412349,,35 - Baramati (Maharashtra),13,35
1.0,DR. AMOL RAMSING KOLHE,Nationalist Congress Party – Sharadchandra Pawar,697768,924,698692,50.83,36 - Shirur (Maharashtra),13,36
2.0,ADHALRAO SHIVAJI DATTATREY,Nationalist Congress Party,557138,603,557741,40.58,36 - Shirur (Maharashtra),13,36
3.0,MANOHAR MAHADU WADEKAR,Independent,28324,6,28330,2.06,36 - Shirur (Maharashtra),13,36
4.0,DR. ANWAR SHAIKH,Vanchit Bahujan Aaghadi,17444,18,17462,1.27,36 - Shirur (Maharashtra),13,36
5.0,RAHUL RAGHUNATH OWHAL,Bahujan Samaj Party,10280,15,10295,0.75,36 - Shirur (Maharashtra),13,36
6.0,CHANDGUDE VINOD VASANT,Independent,8076,2,8078,0.59,36 - Shirur (Maharashtra),13,36
7.0,GORAKSH KASABE,Independent,4913,2,4915,0.36,36 - Shirur (Maharashtra),13,36
8.0,ADV. DR. LAXMAN RAMBHAU DAMSE,Bharat Adivasi Party,4125,11,4136,0.3,36 - Shirur (Maharashtra),13,36
9.0,GAIKWAD NILOBA CHANGADEO,Independent,3569,2,3571,0.26,36 - Shirur (Maharashtra),13,36
10.0,UMESH MAHADEV MHETRE,Independent,3499,-,3499,0.25,36 - Shirur (Maharashtra),13,36
11.0,ADV.SWAPNIL BHAUSAHEB SHELAR,Independent,2667,-,2667,0.19,36 - Shirur (Maharashtra),13,36
12.0,AMOL VILAS PACHUNDKAR,Independent,2386,2,2388,0.17,36 - Shirur (Maharashtra),13,36
13.0,ASLAM ISAK BAGWAN,Lok Sena Party,2348,2,2350,0.17,36 - Shirur (Maharashtra),13,36
14.0,KAMBLE TRIMBAK NARAYAN,Baliraja Party,2223,4,2227,0.16,36 - Shirur (Maharashtra),13,36
15.0,SUBASH KASHINATH SARODE,Independent,2161,-,2161,0.16,36 - Shirur (Maharashtra),13,36
16.0,CHAAYA SANJAY JAGDALE-SOLANKE,Independent,1823,7,1830,0.13,36 - Shirur (Maharashtra),13,36
17.0,SUSHIL DNYANDEV KANSE,Independent,1731,1,1732,0.13,36 - Shirur (Maharashtra),13,36
18.0,NARAYAN PRABHAKAR ANKUSHE,Bharatheeya Jawan Kisan Party,1279,5,1284,0.09,36 - Shirur (Maharashtra),13,36
19.0,BHOR VIKAS ROHIDAS,Independent,1145,2,1147,0.08,36 - Shirur (Maharashtra),13,36
20.0,DADA ALIAS VIKAS SURESH KASBE,Independent,1105,1,1106,0.08,36 - Shirur (Maharashtra),13,36
21.0,SURAJ CHANDRAKANT GAIKWAD,Independent,936,2,938,0.07,36 - Shirur (Maharashtra),13,36
22.0,SWAPNIL DHANAJI LONDHE,Bhim Sena,913,1,914,0.07,36 - Shirur (Maharashtra),13,36
23.0,AMAR MACHINDRA BORHADE,Independent,887,1,888,0.06,36 - Shirur (Maharashtra),13,36
24.0,RAVINDRA MOTIRAM SIRSAM,Independent,870,-,870,0.06,36 - Shirur (Maharashtra),13,36
25.0,TUKARAM NAMDEO DAPHAL,Sainik Samaj Party,862,20,882,0.06,36 - Shirur (Maharashtra),13,36
26.0,PANDURANG BHAGWAN WAGHOLE,Independent,818,1,819,0.06,36 - Shirur (Maharashtra),13,36
27.0,SANJAY LAXMAN PADWAL,Bhartiya Navjawan Sena (Paksha),779,5,784,0.06,36 - Shirur (Maharashtra),13,36
28.0,HARIDAS CHANDAR BHISE,Bharatiya Lokvikas Party,721,2,723,0.05,36 - Shirur (Maharashtra),13,36
29.0,SALIM BABA SAYYAD,Independent,671,-,671,0.05,36 - Shirur (Maharashtra),13,36
30.0,PRAKASH SUKHADEO JAMDHADE,Independent,602,1,603,0.04,36 - Shirur (Maharashtra),13,36
31.0,WAKHARE PRADIP PANDURANG,Independent,574,-,574,0.04,36 - Shirur (Maharashtra),13,36
32.0,RAHUL ARJUN HORE,Independent,526,-,526,0.04,36 - Shirur (Maharashtra),13,36
33.0,NOTA,None of the Above,9634,27,9661,0.7,36 - Shirur (Maharashtra),13,36
,Total,,1372797,1667,1374464,,36 - Shirur (Maharashtra),13,36
1.0,NILESH DNYANDEV LANKE,Nationalist Congress Party – Sharadchandra Pawar,622144,2653,624797,47.14,37 - Ahmednagar (Maharashtra),13,37
2.0,DR. SUJAY RADHAKRISHNA VIKHEPATIL,Bharatiya Janata Party,593568,2300,595868,44.95,37 - Ahmednagar (Maharashtra),13,37
3.0,ALEKAR GORAKH DASHRATH,Independent,44582,15,44597,3.36,37 - Ahmednagar (Maharashtra),13,37
4.0,DEELIP KONDIBA KHEDKAR,Vanchit Bahujan Aaghadi,13689,60,13749,1.04,37 - Ahmednagar (Maharashtra),13,37
5.0,AMOL VILAS PACHUNDKAR,Independent,5491,2,5493,0.41,37 - Ahmednagar (Maharashtra),13,37
6.0,BHAGWAT DHONDIBA GAIKWAD,Samata Party,4941,3,4944,0.37,37 - Ahmednagar (Maharashtra),13,37
7.0,UMASHANKAR SHYAMBABU YADAV,Bahujan Samaj Party,4509,30,4539,0.34,37 - Ahmednagar (Maharashtra),13,37
8.0,ADV. JAMIR SHAIKH,Independent,3934,1,3935,0.3,37 - Ahmednagar (Maharashtra),13,37
9.0,AARTI KISHORKUMAR HALDAR,Prabuddha Republican Party,3790,9,3799,0.29,37 - Ahmednagar (Maharashtra),13,37
10.0,NAVSHAD MUNSILAL SHAIKH,Independent,2226,-,2226,0.17,37 - Ahmednagar (Maharashtra),13,37
11.0,SURYABHAN (ALIAS SURESH) DATTATRAYA LAMBE,Independent,2092,-,2092,0.16,37 - Ahmednagar (Maharashtra),13,37
12.0,KALIRAM BAHIRU POPALGHAT,Bhartiya Navjawan Sena (Paksha),1975,6,1981,0.15,37 - Ahmednagar (Maharashtra),13,37
13.0,GAVADE MACCHINDRA RADHAKISAN,Independent,1940,1,1941,0.15,37 - Ahmednagar (Maharashtra),13,37
14.0,PRAVIN SUBHASH DALVI,Independent,1896,2,1898,0.14,37 - Ahmednagar (Maharashtra),13,37
15.0,MADAN KANIFNATH SONVANE,Right to Recall Party,1445,6,1451,0.11,37 - Ahmednagar (Maharashtra),13,37
16.0,DR. KAILASH NIVRUTTI JADHAV,Maharashtra Vikas Aghadi,1425,10,1435,0.11,37 - Ahmednagar (Maharashtra),13,37
17.0,KOTHARI RAVINDRA LILACHAND,Rashtriya Janmanch (Secular),1330,3,1333,0.1,37 - Ahmednagar (Maharashtra),13,37
18.0,ADV. SHIVAJIRAO WAMAN DAMALE (EX. SGT OF IAF),Sainik Samaj Party,1093,11,1104,0.08,37 - Ahmednagar (Maharashtra),13,37
19.0,GANGADHAR HARIBHAU KOLEKAR,Independent,1059,-,1059,0.08,37 - Ahmednagar (Maharashtra),13,37
20.0,DATTATRAY APPA WAGHMODE,Rashtriya Jankranti Party,868,5,873,0.07,37 - Ahmednagar (Maharashtra),13,37
21.0,WABLE BHAUSAHEB BAPURAO,Bharatheeya Jawan Kisan Party,790,11,801,0.06,37 - Ahmednagar (Maharashtra),13,37
22.0,SHEKATKAR ANIL GANPAT,Independent,702,-,702,0.05,37 - Ahmednagar (Maharashtra),13,37
23.0,ADV. MAHENDRA DADASAHEB SHINDE,Independent,674,1,675,0.05,37 - Ahmednagar (Maharashtra),13,37
24.0,BILAL GAFUR SHAIKH,Independent,531,-,531,0.04,37 - Ahmednagar (Maharashtra),13,37
25.0,RAOSAHEB SHANKAR KALE,Independent,370,2,372,0.03,37 - Ahmednagar (Maharashtra),13,37
26.0,NOTA,None of the Above,3254,28,3282,0.25,37 - Ahmednagar (Maharashtra),13,37
,Total,,1320318,5159,1325477,,37 - Ahmednagar (Maharashtra),13,37
1.0,BHAUSAHEB RAJARAM WAKCHAURE,Shiv Sena (Uddhav Balasaheb Thackrey),475637,1263,476900,45.0,38 - Shirdi (Maharashtra),13,38
2.0,LOKHANDE SADASHIV KISAN,Shiv Sena,425498,873,426371,40.23,38 - Shirdi (Maharashtra),13,38
3.0,UTKARSHA PREMANAND RUPWATE,Vanchit Bahujan Aaghadi,90748,181,90929,8.58,38 - Shirdi (Maharashtra),13,38
4.0,BHAUSAHEB RAMNATH WAKCHAURE,Independent,13973,33,14006,1.32,38 - Shirdi (Maharashtra),13,38
5.0,RAMCHANDRA NAMDEV JADHAV,Bahujan Samaj Party,7000,40,7040,0.66,38 - Shirdi (Maharashtra),13,38
6.0,RAVINDRA KALLAYYA SWAMY,Independent,5536,1,5537,0.52,38 - Shirdi (Maharashtra),13,38
7.0,ABHIJEET ASHOKRAO POTE,Independent,4761,15,4776,0.45,38 - Shirdi (Maharashtra),13,38
8.0,BHARAT SAMBHAJI BHOSLE,Samata Party,3395,8,3403,0.32,38 - Shirdi (Maharashtra),13,38
9.0,SATISH BHIVA PAWAR,Independent,2765,6,2771,0.26,38 - Shirdi (Maharashtra),13,38
10.0,GANGADHAR RAJARAM KADAM,Independent,2743,14,2757,0.26,38 - Shirdi (Maharashtra),13,38
11.0,BAGUL GORAKSHA TANHAJI,Independent,2658,2,2660,0.25,38 - Shirdi (Maharashtra),13,38
12.0,PRASHANT VASANT NIKAM,Independent,2542,3,2545,0.24,38 - Shirdi (Maharashtra),13,38
13.0,ADV NITIN DADAHARI POL,Bahujan Bharat Party,2517,15,2532,0.24,38 - Shirdi (Maharashtra),13,38
14.0,RAJENDRA RATNAKAR WAGHMARE,Rashtriya Jankranti Party,2500,5,2505,0.24,38 - Shirdi (Maharashtra),13,38
15.0,ADV SIDHARTH DEEPAK BODHAK,Independent,2202,2,2204,0.21,38 - Shirdi (Maharashtra),13,38
16.0,CHANDRAKANT SAMBHAJI DONDE,Independent,2074,6,2080,0.2,38 - Shirdi (Maharashtra),13,38
17.0,ASHOK RAMCHANDRA ALHAT,Independent,1794,4,1798,0.17,38 - Shirdi (Maharashtra),13,38
18.0,KHAJEKAR VIJAYRAO GOVINDRAO,Independent,1555,2,1557,0.15,38 - Shirdi (Maharashtra),13,38
19.0,KHARAT NACHIKET RAGHUNATH,Independent,1146,4,1150,0.11,38 - Shirdi (Maharashtra),13,38
20.0,SANJAY POPAT BHALERAO,Independent,958,5,963,0.09,38 - Shirdi (Maharashtra),13,38
21.0,NOTA,None of the Above,5326,54,5380,0.51,38 - Shirdi (Maharashtra),13,38
,Total,,1057328,2536,1059864,,38 - Shirdi (Maharashtra),13,38
1.0,BAJRANG MANOHAR SONWANE,Nationalist Congress Party – Sharadchandra Pawar,682532,1418,683950,44.93,39 - Beed (Maharashtra),13,39
2.0,PANKAJA GOPINATHRAO MUNDE,Bharatiya Janata Party,675349,2048,677397,44.5,39 - Beed (Maharashtra),13,39
3.0,ASHOK BHAGOJI THORAT,Bahujan Maha Party,54829,21,54850,3.6,39 - Beed (Maharashtra),13,39
4.0,ASHOK SUKHDEV HINGE,Vanchit Bahujan Aaghadi,50741,126,50867,3.34,39 - Beed (Maharashtra),13,39
5.0,SHAIKH TOUSIF ABDUL SATTAR,Independent,9472,-,9472,0.62,39 - Beed (Maharashtra),13,39
6.0,DR. SIDDHARTH RAJENDRA TAKANKAR,Bahujan Samaj Party,5092,19,5111,0.34,39 - Beed (Maharashtra),13,39
7.0,SHAMSHER KHAN SAHEB KHAN PATHAN,Independent,4704,-,4704,0.31,39 - Beed (Maharashtra),13,39
8.0,JAVED SIKANDAR MOMIN,Independent,2662,-,2662,0.17,39 - Beed (Maharashtra),13,39
9.0,NAZEM KHAN JABBAR KHAN PATHAN,Independent,2586,-,2586,0.17,39 - Beed (Maharashtra),13,39
10.0,GOKUL BAPURAO SAWASE,Independent,2576,1,2577,0.17,39 - Beed (Maharashtra),13,39
11.0,GAFFARKHAN JABBARKHAN PATHAN,Independent,2561,2,2563,0.17,39 - Beed (Maharashtra),13,39
12.0,DATTA SUDAM GAIKWAD,Independent,2130,-,2130,0.14,39 - Beed (Maharashtra),13,39
13.0,SATISH PADMAKAR KAPSE,Independent,2098,1,2099,0.14,39 - Beed (Maharashtra),13,39
14.0,KARUNA DHANANJAY MUNDE,Swarajya Shakti Sena,1594,5,1599,0.11,39 - Beed (Maharashtra),13,39
15.0,DR. SHRIRAM VITTHALRAO KHALGE,Independent,1512,-,1512,0.1,39 - Beed (Maharashtra),13,39
16.0,ADV. GANESH NAVNATHRAO KARANDE,Independent,1506,2,1508,0.1,39 - Beed (Maharashtra),13,39
17.0,SHITAL SHIVAJI DHONDRE,Independent,1302,1,1303,0.09,39 - Beed (Maharashtra),13,39
18.0,SHAIKH YASHED SHAIKH TAYYAB,Independent,1258,-,1258,0.08,39 - Beed (Maharashtra),13,39
19.0,JAWED SALEEM SYED,Tipu Sultan Party,972,6,978,0.06,39 - Beed (Maharashtra),13,39
20.0,PRAKASH BHAGWANRAO SOLANKE,Independent,885,1,886,0.06,39 - Beed (Maharashtra),13,39
21.0,CHANDRAKANT KUMAR HAJARE,Maharashtra Vikas Aghadi,800,3,803,0.05,39 - Beed (Maharashtra),13,39
22.0,SALAUDDIN KHAN PATHAN,Independent,724,-,724,0.05,39 - Beed (Maharashtra),13,39
23.0,KASPATE GANESH VYANKATRAO,Independent,719,-,719,0.05,39 - Beed (Maharashtra),13,39
24.0,MUBEEN ZUBERI ZAHEER UL AFAQUE,Independent,675,1,676,0.04,39 - Beed (Maharashtra),13,39
25.0,WASIM SHAIKH SALIM SHAIKH,Independent,579,1,580,0.04,39 - Beed (Maharashtra),13,39
26.0,SHAIKH EJAJ SHAIKH UMAR,Independent,550,-,550,0.04,39 - Beed (Maharashtra),13,39
27.0,SHESHERAO CHOKHOBA VEER,Prabuddha Republican Party,537,-,537,0.04,39 - Beed (Maharashtra),13,39
28.0,TATE MAHENDRA ASHOK,Ambedkarist Republican Party,531,2,533,0.04,39 - Beed (Maharashtra),13,39
29.0,MUSTAFA MAINODDIN SHAIKH,Independent,531,-,531,0.03,39 - Beed (Maharashtra),13,39
30.0,SULEMAN KHAIRODDIN MOHMMAD,Independent,522,-,522,0.03,39 - Beed (Maharashtra),13,39
31.0,HIDAYAT SADEKH ALI SYED,Independent,448,-,448,0.03,39 - Beed (Maharashtra),13,39
32.0,RAJENDRA ACHYUTRAO HOKE,Independent,427,-,427,0.03,39 - Beed (Maharashtra),13,39
33.0,ADV. MANIK BANSI AADMANE,Bahujan Republican Socialist Party,425,1,426,0.03,39 - Beed (Maharashtra),13,39
34.0,VACHISHT UDDHAV KUTE,Independent,414,-,414,0.03,39 - Beed (Maharashtra),13,39
35.0,ADV. SHARAD BAHINAJI KAMBLE,All India National Raksha Sena,393,3,396,0.03,39 - Beed (Maharashtra),13,39
36.0,BHASKAR BANSIDHARRAO KHANDE,Independent,390,-,390,0.03,39 - Beed (Maharashtra),13,39
37.0,RAHEMAN BAHODDIN SAYYED,Independent,384,-,384,0.03,39 - Beed (Maharashtra),13,39
38.0,LAXMIBAI BAJIRAO MORE,Independent,382,-,382,0.03,39 - Beed (Maharashtra),13,39
39.0,SYED MINHAJ ALI,Independent,310,-,310,0.02,39 - Beed (Maharashtra),13,39
40.0,SALIM ALLABAKSHA SAYYAD,Independent,238,-,238,0.02,39 - Beed (Maharashtra),13,39
41.0,SADEK IBRAHIM SHAIKH,Independent,206,-,206,0.01,39 - Beed (Maharashtra),13,39
42.0,NOTA,None of the Above,2068,19,2087,0.14,39 - Beed (Maharashtra),13,39
,Total,,1518614,3681,1522295,,39 - Beed (Maharashtra),13,39
1.0,OMPRAKASH BHUPALSINH ALIAS PAVAN RAJENIMBALKAR,Shiv Sena (Uddhav Balasaheb Thackrey),743597,5155,748752,58.45,40 - Osmanabad (Maharashtra),13,40
2.0,ARCHANA RANAJAGJITSINH PATIL,Nationalist Congress Party,416699,2207,418906,32.7,40 - Osmanabad (Maharashtra),13,40
3.0,ANDHALKAR BHAUSAHEB RAOSAHEB,Vanchit Bahujan Aaghadi,33221,181,33402,2.61,40 - Osmanabad (Maharashtra),13,40
4.0,GOVARDHAN SUBRAO NIMBALKAR,Independent,18947,19,18966,1.48,40 - Osmanabad (Maharashtra),13,40
5.0,DNYANESHWAR NAGANATHRAO KOLI,Samata Party,6459,13,6472,0.51,40 - Osmanabad (Maharashtra),13,40
6.0,KAKASAHEB SANDIPAN KHOT,Independent,5707,8,5715,0.45,40 - Osmanabad (Maharashtra),13,40
7.0,SANJAYKUMAR BHAGWAT WAGHMARE,Bahujan Samaj Party,5525,90,5615,0.44,40 - Osmanabad (Maharashtra),13,40
8.0,KAKA FULCHAND KAMBLE,Independent,4807,4,4811,0.38,40 - Osmanabad (Maharashtra),13,40
9.0,RAM HANUMANT SHENDAGE,Independent,3255,8,3263,0.25,40 - Osmanabad (Maharashtra),13,40
10.0,UMAJI PANDURANG GAIKWAD,Independent,3089,6,3095,0.24,40 - Osmanabad (Maharashtra),13,40
11.0,GORE NETAJI NAGNATH,Desh Janhit Party,2314,22,2336,0.18,40 - Osmanabad (Maharashtra),13,40
12.0,HANUMANT LAXMAN BONDAR,Independent,2170,2,2172,0.17,40 - Osmanabad (Maharashtra),13,40
13.0,NAVNATH DASHRATH UPALEKAR,Independent,2099,9,2108,0.16,40 - Osmanabad (Maharashtra),13,40
14.0,SIDDIK IBRAHIM BAUDIWALE ALIAS GOLABHAI,All India Majlis-E-Ittehadul Muslimeen,2052,8,2060,0.16,40 - Osmanabad (Maharashtra),13,40
15.0,ARJUN (DADA) SALGAR,Independent,1923,12,1935,0.15,40 - Osmanabad (Maharashtra),13,40
16.0,ARYANRAJE KISANRAO SHINDE,Rashtriya Samaj Dal (R),1852,35,1887,0.15,40 - Osmanabad (Maharashtra),13,40
17.0,SHAIKH NAUSHAD IQBAL,Swarajya Shakti Sena,1671,15,1686,0.13,40 - Osmanabad (Maharashtra),13,40
18.0,SHAMRAO HARIBHAU PAWAR,Samnak Janta Party,1492,17,1509,0.12,40 - Osmanabad (Maharashtra),13,40
19.0,YOGIRAJ ANANTA TAMBE,Independent,1326,10,1336,0.1,40 - Osmanabad (Maharashtra),13,40
20.0,SOMNATH NANASAHEB KAMBLE,Independent,1262,6,1268,0.1,40 - Osmanabad (Maharashtra),13,40
21.0,BHORE NITIN KHANDU,Independent,1195,9,1204,0.09,40 - Osmanabad (Maharashtra),13,40
22.0,MANOHAR ANANDRAO PATIL,Independent,1182,8,1190,0.09,40 - Osmanabad (Maharashtra),13,40
23.0,NAVNATH VISHWANATH DUDHAL,Vishva Shakti Party,1123,12,1135,0.09,40 - Osmanabad (Maharashtra),13,40
24.0,NITESH SHIVAJI PAWAR,Hindrashtra Sangh,1060,19,1079,0.08,40 - Osmanabad (Maharashtra),13,40
25.0,ADV. VISHVJEET VIJAYKUMAR SHINDE,Aadarsh Sangram Party,855,10,865,0.07,40 - Osmanabad (Maharashtra),13,40
26.0,SHAYANI NAVANATH JADHAV,Independent,779,3,782,0.06,40 - Osmanabad (Maharashtra),13,40
27.0,NITIN NAGNATH GAIKWAD,Independent,729,2,731,0.06,40 - Osmanabad (Maharashtra),13,40
28.0,ADV. BHAUSAHEB ANIL BELURE,Independent,675,2,677,0.05,40 - Osmanabad (Maharashtra),13,40
29.0,VILAS BHAGWAT GHADGE,Independent,604,6,610,0.05,40 - Osmanabad (Maharashtra),13,40
30.0,SAMEERSINGH RAMESHCHANDRA SALVI,Independent,591,3,594,0.05,40 - Osmanabad (Maharashtra),13,40
31.0,RAJKUMAR SAHEBRAO PATIL,Independent,589,4,593,0.05,40 - Osmanabad (Maharashtra),13,40
32.0,NOTA,None of the Above,4250,48,4298,0.34,40 - Osmanabad (Maharashtra),13,40
,Total,,1273099,7953,1281052,,40 - Osmanabad (Maharashtra),13,40
1.0,DR. KALGE SHIVAJI BANDAPPA,Indian National Congress,607030,1991,609021,49.15,41 - Latur (Maharashtra),13,41
2.0,SUDHAKAR TUKARAM SHRANGARE,Bharatiya Janata Party,545240,1900,547140,44.16,41 - Latur (Maharashtra),13,41
3.0,NARSINGRAO UDGIRKAR,Vanchit Bahujan Aaghadi,42104,121,42225,3.41,41 - Latur (Maharashtra),13,41
4.0,ATITHI KHANDERAO SURYVANSHI,Swarajya Shakti Sena,5150,28,5178,0.42,41 - Latur (Maharashtra),13,41
5.0,ALTE VISHWANATH MAHADEV,Bahujan Samaj Party,5081,40,5121,0.41,41 - Latur (Maharashtra),13,41
6.0,KAMANT MACHHINDRA GUNWANTRAO,Bahujan Bharat Party,2249,20,2269,0.18,41 - Latur (Maharashtra),13,41
7.0,ABHANG GANGARAM SURYAWANSHI,Independent,2102,-,2102,0.17,41 - Latur (Maharashtra),13,41
8.0,DATTU SOPAN NARSINGE,Independent,2000,2,2002,0.16,41 - Latur (Maharashtra),13,41
9.0,DEEPAK KEDAR,Independent,1712,14,1726,0.14,41 - Latur (Maharashtra),13,41
10.0,UMESH AMBADAS KAMBLE,Independent,1683,8,1691,0.14,41 - Latur (Maharashtra),13,41
11.0,BANSODE RAGHUNATH WAGHOJI,Independent,1596,4,1600,0.13,41 - Latur (Maharashtra),13,41
12.0,BHARAT HARIBA NANAWARE,Peoples Party of India (Democratic),1442,7,1449,0.12,41 - Latur (Maharashtra),13,41
13.0,SHRIKANT BABURAO HOVAL,Bahujan Mukti Party,1380,2,1382,0.11,41 - Latur (Maharashtra),13,41
14.0,PRAVIN MADHAV JOHARE,Swarajya Sena (Maharashtra),1268,5,1273,0.1,41 - Latur (Maharashtra),13,41
15.0,PANCHSHIL VIKRAM KAMBLE,Independent,1232,9,1241,0.1,41 - Latur (Maharashtra),13,41
16.0,SHANKAR HARI TADAKHE,Baliraja Party,1126,2,1128,0.09,41 - Latur (Maharashtra),13,41
17.0,AMOL MALU HANMANTE,Independent,1094,5,1099,0.09,41 - Latur (Maharashtra),13,41
18.0,ADV. KASBEKAR SHRIDHAR LIMBAJI,Rashtriya Sant Sandesh Party,987,7,994,0.08,41 - Latur (Maharashtra),13,41
19.0,BALAJI SHESHRAO BANSODE,Independent,953,1,954,0.08,41 - Latur (Maharashtra),13,41
20.0,BHIKAJI GANGARAM JADHAV,Kranti Kari Jai Hind Sena,863,3,866,0.07,41 - Latur (Maharashtra),13,41
21.0,VIKAS KONDIBA SHINDE,Maharashtra Vikas Aghadi,793,8,801,0.06,41 - Latur (Maharashtra),13,41
22.0,LAKHAN RAJARAM KAMBLE,Rashtriy Bahujan Party,790,5,795,0.06,41 - Latur (Maharashtra),13,41
23.0,BALAJI TUKARAM GAIKWAD,Bharat Peoples Sena,679,4,683,0.06,41 - Latur (Maharashtra),13,41
24.0,SUDHAKAR TUKARAM SURYAWANSHI,Independent,617,3,620,0.05,41 - Latur (Maharashtra),13,41
25.0,PAPITA RAOSAHEB RANDIVE,Independent,576,5,581,0.05,41 - Latur (Maharashtra),13,41
26.0,ADV. PRADIP S. CHINCHOLIKAR,Independent,528,5,533,0.04,41 - Latur (Maharashtra),13,41
27.0,MUKESH GOVINDRAO GHODAKE,Independent,524,1,525,0.04,41 - Latur (Maharashtra),13,41
28.0,PANKAJ GOPALRAO WAKHARADAKAR,Independent,512,1,513,0.04,41 - Latur (Maharashtra),13,41
29.0,NOTA,None of the Above,3542,25,3567,0.29,41 - Latur (Maharashtra),13,41
,Total,,1234853,4226,1239079,,41 - Latur (Maharashtra),13,41
1.0,PRANITI SUSHILKUMAR SHINDE,Indian National Congress,618350,1875,620225,51.49,42 - Solapur (Maharashtra),13,42
2.0,RAM VITTHAL SATPUTE,Bharatiya Janata Party,544770,1258,546028,45.33,42 - Solapur (Maharashtra),13,42
3.0,AATISH MOHAN BANSODE,Independent,10493,14,10507,0.87,42 - Solapur (Maharashtra),13,42
4.0,BABLU SIDRAM GAIKWAD,Bahujan Samaj Party,5236,32,5268,0.44,42 - Solapur (Maharashtra),13,42
5.0,SHRIVIDYADURGADEVI MAULAPPA KURANE,Independent,3489,4,3493,0.29,42 - Solapur (Maharashtra),13,42
6.0,RAMESH BHIMRAO SHIKHARE,Independent,3146,-,3146,0.26,42 - Solapur (Maharashtra),13,42
7.0,PROF DR ARJUN GENA OHOL,Bahujan Mukti Party,2651,3,2654,0.22,42 - Solapur (Maharashtra),13,42
8.0,BHANTENAAGAMURTI MOULAPPA KURANE,Independent,1547,7,1554,0.13,42 - Solapur (Maharashtra),13,42
9.0,SUNILKUMAR TUKARAM SHINDE,Independent,1478,2,1480,0.12,42 - Solapur (Maharashtra),13,42
10.0,YUGANDHAR CHANDRAKANT THOKALE,Peoples Party of India (Democratic),1125,-,1125,0.09,42 - Solapur (Maharashtra),13,42
11.0,PARMESHWAR PANDURANG GEJAGE,Independent,885,1,886,0.07,42 - Solapur (Maharashtra),13,42
12.0,ADV VIKRAM UTTAM KASABE,Independent,843,3,846,0.07,42 - Solapur (Maharashtra),13,42
13.0,UGHADE VIJAYKUMAR BHAGWAN,Independent,832,1,833,0.07,42 - Solapur (Maharashtra),13,42
14.0,KUMAR CHANDRAKANT LONDHE,Baliraja Party,678,1,679,0.06,42 - Solapur (Maharashtra),13,42
15.0,KRISHNA NAGNATH BHISE,Independent,561,1,562,0.05,42 - Solapur (Maharashtra),13,42
16.0,ANNA SUKHADEV MASKE,Independent,496,5,501,0.04,42 - Solapur (Maharashtra),13,42
17.0,MAHASIDDHA TUKARAM GAYAKWAD,Independent,406,3,409,0.03,42 - Solapur (Maharashtra),13,42
18.0,SUDARSHAN RAYCHAND KHANDARE,Independent,400,1,401,0.03,42 - Solapur (Maharashtra),13,42
19.0,SONAVANE SHIVAJI CHANDRAKANT,Independent,394,-,394,0.03,42 - Solapur (Maharashtra),13,42
20.0,SACHIN SHAHU MASKE,Independent,389,-,389,0.03,42 - Solapur (Maharashtra),13,42
21.0,PROF. DR. SUBHASH KHANDERAO GAIKWAD,Independent,379,1,380,0.03,42 - Solapur (Maharashtra),13,42
22.0,NOTA,None of the Above,2713,12,2725,0.23,42 - Solapur (Maharashtra),13,42
,Total,,1201261,3224,1204485,,42 - Solapur (Maharashtra),13,42
1.0,MOHITE-PATIL DHAIRYASHEEL RAJSINH,Nationalist Congress Party – Sharadchandra Pawar,618566,3647,622213,48.86,43 - Madha (Maharashtra),13,43
2.0,RANJEETSINGH HINDURAO NAIK NIMBALKAR,Bharatiya Janata Party,499171,2205,501376,39.37,43 - Madha (Maharashtra),13,43
3.0,ER. RAMCHANDRA MAYAPPA GHUTUKADE,New Rashtriya Samaj Party,58344,77,58421,4.59,43 - Madha (Maharashtra),13,43
4.0,BARASKAR RAMESH NAGNATH,Vanchit Bahujan Aaghadi,20519,85,20604,1.62,43 - Madha (Maharashtra),13,43
5.0,JANKAR SWARUP DADA,Bahujan Samaj Party,7036,58,7094,0.56,43 - Madha (Maharashtra),13,43
6.0,HAKE LAXMAN SOPAN,Independent,5083,51,5134,0.4,43 - Madha (Maharashtra),13,43
7.0,SITARAM VITTHAL RANDIVE,Independent,4980,6,4986,0.39,43 - Madha (Maharashtra),13,43
8.0,DHANAJI SHRIPATI MASKE,Independent,4433,-,4433,0.35,43 - Madha (Maharashtra),13,43
9.0,BICHUKALE SANTOSH BALASAHEB,Republican Party of India (A),4039,7,4046,0.32,43 - Madha (Maharashtra),13,43
10.0,SAWANT RAHUL SHASHIKANT,Independent,3903,6,3909,0.31,43 - Madha (Maharashtra),13,43
11.0,AWARE SIDDHESHWAR BHARAT,All India Forward Bloc,3058,9,3067,0.24,43 - Madha (Maharashtra),13,43
12.0,HANUMANT NARAYAN MANE,Independent,2862,2,2864,0.22,43 - Madha (Maharashtra),13,43
13.0,NANDU SAMBHAJI MORE,Independent,2686,1,2687,0.21,43 - Madha (Maharashtra),13,43
14.0,NAVANATH BIRA MADANE,Independent,2434,1,2435,0.19,43 - Madha (Maharashtra),13,43
15.0,GIRISH PRABHAKAR SHETE,Independent,2380,3,2383,0.19,43 - Madha (Maharashtra),13,43
16.0,ADV. JORE SACHIN BHASKAR,Independent,2344,3,2347,0.18,43 - Madha (Maharashtra),13,43
17.0,NANASAHEB RAMHARI YADAV,Independent,2213,1,2214,0.17,43 - Madha (Maharashtra),13,43
18.0,KIRAN TANAJI SATHE,Independent,2167,8,2175,0.17,43 - Madha (Maharashtra),13,43
19.0,BHAUSAHEB SUKHADEV LIGADE,Independent,2034,18,2052,0.16,43 - Madha (Maharashtra),13,43
20.0,ER. BALIRAM SUKHADEV MORE,Independent,1952,1,1953,0.15,43 - Madha (Maharashtra),13,43
21.0,KHARAT SANDIP JANARADHAN,Independent,1746,9,1755,0.14,43 - Madha (Maharashtra),13,43
22.0,NARAYAN TATOBA KALEL,Independent,1557,3,1560,0.12,43 - Madha (Maharashtra),13,43
23.0,KASHINATH KISAN DEOKATE,Independent,1276,3,1279,0.1,43 - Madha (Maharashtra),13,43
24.0,GOPAL YESHVANT JADHAV,Bharatheeya Jawan Kisan Party,1273,16,1289,0.1,43 - Madha (Maharashtra),13,43
25.0,SATYAWAN VIJAY OMBASE,Swarajya Sena (Maharashtra),1254,6,1260,0.1,43 - Madha (Maharashtra),13,43
26.0,SITAPURE VINOD DILIP,Independent,1190,1,1191,0.09,43 - Madha (Maharashtra),13,43
27.0,ASHOK DNYANDEV WAGHMODE,Independent,984,5,989,0.08,43 - Madha (Maharashtra),13,43
28.0,ANIL BHAGAVAN SHEDAGE,Independent,977,5,982,0.08,43 - Madha (Maharashtra),13,43
29.0,AMOL MADHUKAR KARADE,Independent,900,3,903,0.07,43 - Madha (Maharashtra),13,43
30.0,RASHID ISMAIL SHAIKH,Independent,842,1,843,0.07,43 - Madha (Maharashtra),13,43
31.0,MORE ROHIT RAMKRUSHNA,Independent,669,2,671,0.05,43 - Madha (Maharashtra),13,43
32.0,SARADE GANESH NAVNATH,Independent,598,3,601,0.05,43 - Madha (Maharashtra),13,43
33.0,NOTA,None of the Above,3655,47,3702,0.29,43 - Madha (Maharashtra),13,43
,Total,,1267125,6293,1273418,,43 - Madha (Maharashtra),13,43
1.0,VISHAL (DADA) PRAKASHBAPU PATIL,Independent,569651,2015,571666,48.91,44 - Sangli (Maharashtra),13,44
2.0,SANJAY (KAKA) PATIL,Bharatiya Janata Party,469392,2221,471613,40.35,44 - Sangli (Maharashtra),13,44
3.0,CHANDRAHAR SUBHASH PATIL,Shiv Sena (Uddhav Balasaheb Thackrey),60115,745,60860,5.21,44 - Sangli (Maharashtra),13,44
4.0,ALLAUDDIN HAYATCHAND KAZI,Independent,9269,13,9282,0.79,44 - Sangli (Maharashtra),13,44
5.0,PRAKASH SHIVAJIRAO SHENDGE,Independent,8150,101,8251,0.71,44 - Sangli (Maharashtra),13,44
6.0,PANDURANG RAOSAHEB BHOSALE,Bharatheeya Jawan Kisan Party,5518,47,5565,0.48,44 - Sangli (Maharashtra),13,44
7.0,TIPUSULATAN SIKANDAR PATAVEGAR,Bahujan Samaj Party,5502,58,5560,0.48,44 - Sangli (Maharashtra),13,44
8.0,MAHESH YASHWANT KHARADE,Swabhimani Paksha,5491,30,5521,0.47,44 - Sangli (Maharashtra),13,44
9.0,RAVINDRA CHANDAR SOLANKAR,Independent,3649,9,3658,0.31,44 - Sangli (Maharashtra),13,44
10.0,ANAND SHANKAR NALAGE,Baliraja Party,3531,9,3540,0.3,44 - Sangli (Maharashtra),13,44
11.0,SHASHIKANT GAUTAM DESHMUKH,Independent,3143,12,3155,0.27,44 - Sangli (Maharashtra),13,44
12.0,SATISH LALITA KRISHNA KADAM,Hindustan Janta Party,2851,8,2859,0.24,44 - Sangli (Maharashtra),13,44
13.0,SUWARNATAI SUDHAKAR GAYAKWAD,Independent,1925,12,1937,0.17,44 - Sangli (Maharashtra),13,44
14.0,DATTATRAY PANDIT PATIL,Independent,1468,1,1469,0.13,44 - Sangli (Maharashtra),13,44
15.0,TOUHID ILAHI MOMIN,Independent,1460,-,1460,0.12,44 - Sangli (Maharashtra),13,44
16.0,AJIT DHANAJI KHANDARE,Independent,1380,18,1398,0.12,44 - Sangli (Maharashtra),13,44
17.0,BANDAGAR NANASO BALASO,Independent,1292,8,1300,0.11,44 - Sangli (Maharashtra),13,44
18.0,JALINDAR MACHINDRA THOMAKE,Independent,1257,3,1260,0.11,44 - Sangli (Maharashtra),13,44
19.0,SANGRAM RAJARAM MORE,Independent,1004,7,1011,0.09,44 - Sangli (Maharashtra),13,44
20.0,DR AKASH VHATKAR,Independent,803,11,814,0.07,44 - Sangli (Maharashtra),13,44
21.0,NOTA,None of the Above,6512,53,6565,0.56,44 - Sangli (Maharashtra),13,44
,Total,,1163363,5381,1168744,,44 - Sangli (Maharashtra),13,44
1.0,SHRIMANT CHH UDAYANRAJE PRATAPSINHAMAHARAJ BHONSLE,Bharatiya Janata Party,568749,2385,571134,47.67,45 - Satara (Maharashtra),13,45
2.0,SHASHIKANT JAYVANTRAO SHINDE,Nationalist Congress Party – Sharadchandra Pawar,536475,1888,538363,44.94,45 - Satara (Maharashtra),13,45
3.0,GADE SANJAY KONDIBA,Independent,37035,27,37062,3.09,45 - Satara (Maharashtra),13,45
4.0,KADAM PRASHANT RAGHUNATH,Vanchit Bahujan Aaghadi,11878,34,11912,0.99,45 - Satara (Maharashtra),13,45
5.0,ANAND RAMESH THORWADE,Bahujan Samaj Party,6432,53,6485,0.54,45 - Satara (Maharashtra),13,45
6.0,KORDE SURESHRAO DINKAR,Independent,4699,13,4712,0.39,45 - Satara (Maharashtra),13,45
7.0,MARUTI DHONDIRAM JANKAR,Independent,3944,7,3951,0.33,45 - Satara (Maharashtra),13,45
8.0,SEEMA SUNIL POTDAR,Independent,3458,-,3458,0.29,45 - Satara (Maharashtra),13,45
9.0,VISHWAJIT PATIL UNDALKAR,Independent,3432,6,3438,0.29,45 - Satara (Maharashtra),13,45
10.0,NIVRUTTI KERU SHINDE,Independent,2666,8,2674,0.22,45 - Satara (Maharashtra),13,45
11.0,SAYAJI GANPAT WAGHMARE,Bahujan Republican Socialist Party,2490,11,2501,0.21,45 - Satara (Maharashtra),13,45
12.0,SACHIN SUBHASH MAHAJAN,Independent,2010,5,2015,0.17,45 - Satara (Maharashtra),13,45
13.0,DR ABHIJEET WAMANRAO AWADE BICHUKALE,Independent,1388,7,1395,0.12,45 - Satara (Maharashtra),13,45
14.0,TUSHAR VIJAY MOTLING,Bahujan Mukti Party,1296,5,1301,0.11,45 - Satara (Maharashtra),13,45
15.0,PRATIBHA SHELAR,Independent,1104,19,1123,0.09,45 - Satara (Maharashtra),13,45
16.0,BAGAL SADASHIV SAHEBRAO,Independent,955,3,958,0.08,45 - Satara (Maharashtra),13,45
17.0,NOTA,None of the Above,5476,46,5522,0.46,45 - Satara (Maharashtra),13,45
,Total,,1193487,4517,1198004,,45 - Satara (Maharashtra),13,45
1.0,NARAYAN TATU RANE,Bharatiya Janata Party,445339,3175,448514,49.07,46 - Ratnagiri- Sindhudurg (Maharashtra),13,46
2.0,VINAYAK BHAURAO RAUT,Shiv Sena (Uddhav Balasaheb Thackrey),396524,4132,400656,43.83,46 - Ratnagiri- Sindhudurg (Maharashtra),13,46
3.0,VINAYAK LAVU RAUT,Independent,15769,57,15826,1.73,46 - Ratnagiri- Sindhudurg (Maharashtra),13,46
4.0,MARUTI RAMACHANDRA JOSHI,Vanchit Bahujan Aaghadi,9873,166,10039,1.1,46 - Ratnagiri- Sindhudurg (Maharashtra),13,46
5.0,AAYARE RAJENDRA LAHU,Bahujan Samaj Party,7796,60,7856,0.86,46 - Ratnagiri- Sindhudurg (Maharashtra),13,46
6.0,SHAKIL SAWANT,Independent,6373,22,6395,0.7,46 - Ratnagiri- Sindhudurg (Maharashtra),13,46
7.0,TAMBADE AMRUT ANANT (RAJAPURKAR),Independent,5563,19,5582,0.61,46 - Ratnagiri- Sindhudurg (Maharashtra),13,46
8.0,ASHOK GANGARAM PAWAR,Bahujan Mukti Party,5244,36,5280,0.58,46 - Ratnagiri- Sindhudurg (Maharashtra),13,46
9.0,SURESH GOVINDRAO SHINDE,Sainik Samaj Party,2209,38,2247,0.25,46 - Ratnagiri- Sindhudurg (Maharashtra),13,46
10.0,NOTA,None of the Above,11516,127,11643,1.27,46 - Ratnagiri- Sindhudurg (Maharashtra),13,46
,Total,,906206,7832,914038,,46 - Ratnagiri- Sindhudurg (Maharashtra),13,46
1.0,CHHATRAPATI SHAHU SHAHAJI,Indian National Congress,750323,4199,754522,54.15,47 - Kolhapur (Maharashtra),13,47
2.0,SANJAY SADASHIVRAO MANDLIK,Shiv Sena,597014,2544,599558,43.03,47 - Kolhapur (Maharashtra),13,47
3.0,SANJAY BHIKAJI MAGADE,Bahujan Samaj Party,3946,56,4002,0.29,47 - Kolhapur (Maharashtra),13,47
4.0,MUSHTAK AJIJ MULLA,Independent,3822,2,3824,0.27,47 - Kolhapur (Maharashtra),13,47
5.0,MADHURI RAJU JADHAV,Independent,3503,5,3508,0.25,47 - Kolhapur (Maharashtra),13,47
6.0,KHADE BAJIRAO NANASO,Independent,3497,15,3512,0.25,47 - Kolhapur (Maharashtra),13,47
7.0,KRUSHNABAI DIPAK CHOUGALE,Independent,3045,18,3063,0.22,47 - Kolhapur (Maharashtra),13,47
8.0,KOGALE SANDEEP BHAIRAVNATH,Desh Janhit Party,2952,23,2975,0.21,47 - Kolhapur (Maharashtra),13,47
9.0,ADV. YASH SUHAS HEGDEPATIL,Independent,2457,2,2459,0.18,47 - Kolhapur (Maharashtra),13,47
10.0,NAGNATH PUNDALIK BENAKE,Independent,1215,12,1227,0.09,47 - Kolhapur (Maharashtra),13,47
11.0,RAJANDARA BALASO KOLI,Independent,1029,15,1044,0.07,47 - Kolhapur (Maharashtra),13,47
12.0,B. T. PATIL (EX SERVICEMAN),Bharatheeya Jawan Kisan Party,1011,96,1107,0.08,47 - Kolhapur (Maharashtra),13,47
13.0,SUBHASH VAIJU DESAI,Independent,847,2,849,0.06,47 - Kolhapur (Maharashtra),13,47
14.0,MANGESH JAYSINGH PATIL,Independent,647,6,653,0.05,47 - Kolhapur (Maharashtra),13,47
15.0,SHASHIBHUSHAN JEEVANRAO DESAI,Akhil Bharat Hindu Mahasabha,636,15,651,0.05,47 - Kolhapur (Maharashtra),13,47
16.0,SANTOSH GANPATI BISURE,Apni Prajahit Party,635,4,639,0.05,47 - Kolhapur (Maharashtra),13,47
17.0,DR. SUNIL NAMDEV PATIL,National Black Panther Party,626,7,633,0.05,47 - Kolhapur (Maharashtra),13,47
18.0,KRUSHNA HANMANT DESAI,Independent,602,2,604,0.04,47 - Kolhapur (Maharashtra),13,47
19.0,IRFAN ABUTALIB CHAND,Independent,595,2,597,0.04,47 - Kolhapur (Maharashtra),13,47
20.0,MANE ARVIND BHIVA,Bhartiya Rashtriya Dal,558,12,570,0.04,47 - Kolhapur (Maharashtra),13,47
21.0,SANDEEP GUNDOPANT SANKPAL,Independent,541,3,544,0.04,47 - Kolhapur (Maharashtra),13,47
22.0,KUDARTULLA ADAM LATIF,Independent,465,2,467,0.03,47 - Kolhapur (Maharashtra),13,47
23.0,SALIM NURMUHAMAD BAGWAN,Independent,334,1,335,0.02,47 - Kolhapur (Maharashtra),13,47
24.0,NOTA,None of the Above,5932,51,5983,0.43,47 - Kolhapur (Maharashtra),13,47
,Total,,1386232,7094,1393326,,47 - Kolhapur (Maharashtra),13,47
1.0,DHAIRYASHEEL SAMBHAJIRAO MANE,Shiv Sena,518334,1856,520190,40.14,48 - Hatkanangale (Maharashtra),13,48
2.0,SATYAJEET BABASAHEB PATIL (AABA) SARUDKAR,Shiv Sena (Uddhav Balasaheb Thackrey),504181,2583,506764,39.1,48 - Hatkanangale (Maharashtra),13,48
3.0,RAJU SHETTI,Swabhimani Paksha,178866,984,179850,13.88,48 - Hatkanangale (Maharashtra),13,48
4.0,D. C. PATIL DADASAHEB / DADGONDA CHAVGONDA PATIL,Vanchit Bahujan Aaghadi,32591,105,32696,2.52,48 - Hatkanangale (Maharashtra),13,48
5.0,ASLAM AINODIN MULLA,Independent,6107,4,6111,0.47,48 - Hatkanangale (Maharashtra),13,48
6.0,ANANDRAO VASANTRAO SARNAIK (FOUJI BAPU),Independent,4944,11,4955,0.38,48 - Hatkanangale (Maharashtra),13,48
7.0,TANDALE LAXMAN SHIVAJI,Independent,4788,1,4789,0.37,48 - Hatkanangale (Maharashtra),13,48
8.0,PROF. PARASHURAM MANE,Independent,4467,10,4477,0.35,48 - Hatkanangale (Maharashtra),13,48
9.0,KAMBLE RAVINDRA TUKARAM,Bahujan Samaj Party,3968,65,4033,0.31,48 - Hatkanangale (Maharashtra),13,48
10.0,SATYAJEET PATIL (AABA),Independent,3602,30,3632,0.28,48 - Hatkanangale (Maharashtra),13,48
11.0,ANANDRAO TUKARAM THORAT,Independent,3497,2,3499,0.27,48 - Hatkanangale (Maharashtra),13,48
12.0,IMRAN IQBAL KHATIB,Bahujan Mukti Party,3172,18,3190,0.25,48 - Hatkanangale (Maharashtra),13,48
13.0,RAGHUNATHDADA PATIL,Bharatheeya Jawan Kisan Party,2146,28,2174,0.17,48 - Hatkanangale (Maharashtra),13,48
14.0,JAVED SIKANDAR MUJAVAR,Independent,1849,3,1852,0.14,48 - Hatkanangale (Maharashtra),13,48
15.0,SANTOSH KERBA KHOT,Kamgaar Kisan Party,1697,4,1701,0.13,48 - Hatkanangale (Maharashtra),13,48
16.0,DR. ISHWAR MAHADEV YAMGAR,Bharatiya Lokshakti Party,1520,17,1537,0.12,48 - Hatkanangale (Maharashtra),13,48
17.0,SHIVAJI DHONDIRAM SANKPAL,Independent,1390,2,1392,0.11,48 - Hatkanangale (Maharashtra),13,48
18.0,SHARAD BABURAO PATIL,National Black Panther Party,1356,5,1361,0.11,48 - Hatkanangale (Maharashtra),13,48
19.0,MANOHAR PRADIP SATPUTE,Independent,1063,3,1066,0.08,48 - Hatkanangale (Maharashtra),13,48
20.0,DHANAJI JAGANNATH GURAV (SHIVAREKAR),Lokrajya Janata Party,1054,7,1061,0.08,48 - Hatkanangale (Maharashtra),13,48
21.0,DAVARI LAXMAN SHRIPATI,Independent,1004,5,1009,0.08,48 - Hatkanangale (Maharashtra),13,48
22.0,RAJENDRA BHIMRAO MANE,Independent,935,5,940,0.07,48 - Hatkanangale (Maharashtra),13,48
23.0,DINAKARRAO TULSHIDAS CHAVAN (PATIL),All India Forward Bloc,674,5,679,0.05,48 - Hatkanangale (Maharashtra),13,48
24.0,RAMCHANDRA GOVINDRAO SALUNKHE,Independent,618,-,618,0.05,48 - Hatkanangale (Maharashtra),13,48
25.0,MOHITE DEVENDRA NANA,Independent,559,1,560,0.04,48 - Hatkanangale (Maharashtra),13,48
26.0,MANE ARVIND BHIVA,Independent,422,2,424,0.03,48 - Hatkanangale (Maharashtra),13,48
27.0,MAHAMMAD MUBARAK DARAVESHI,Independent,360,1,361,0.03,48 - Hatkanangale (Maharashtra),13,48
28.0,NOTA,None of the Above,5027,76,5103,0.39,48 - Hatkanangale (Maharashtra),13,48
,Total,,1290191,5833,1296024,,48 - Hatkanangale (Maharashtra),13,48
1.0,ANGOMCHA BIMOL AKOIJAM,Indian National Congress,370678,3339,374017,46.93,1 - Inner Manipur (Manipur),14,1
2.0,THOUNAOJAM BASANTA KUMAR SINGH,Bharatiya Janata Party,262217,1999,264216,33.16,1 - Inner Manipur (Manipur),14,1
3.0,MAHESHWAR THOUNAOJAM,Republican Party of India (Athawale),134308,1332,135640,17.02,1 - Inner Manipur (Manipur),14,1
4.0,RAJKUMAR SOMENDRO SINGH,Independent,12892,158,13050,1.64,1 - Inner Manipur (Manipur),14,1
5.0,MOIRANGTHEM TOTOMSHANA NONGSHABA,Independent,4831,50,4881,0.61,1 - Inner Manipur (Manipur),14,1
6.0,HAORUNGBAM SARAT SINGH,Independent,1279,17,1296,0.16,1 - Inner Manipur (Manipur),14,1
7.0,NOTA,None of the Above,3707,90,3797,0.48,1 - Inner Manipur (Manipur),14,1
,Total,,789912,6985,796897,,1 - Inner Manipur (Manipur),14,1
1.0,ALFRED KANNGAM S ARTHUR,Indian National Congress,381813,3141,384954,48.32,2 - Outer Manipur (Manipur),14,2
2.0,KACHUI TIMOTHY ZIMIK,Naga Peoples Front,298358,1178,299536,37.6,2 - Outer Manipur (Manipur),14,2
3.0,S KHO JOHN,Independent,89677,233,89910,11.28,2 - Outer Manipur (Manipur),14,2
4.0,ALYSON ABONMAI,Independent,14865,245,15110,1.9,2 - Outer Manipur (Manipur),14,2
5.0,NOTA,None of the Above,6530,695,7225,0.91,2 - Outer Manipur (Manipur),14,2
,Total,,791243,5492,796735,,2 - Outer Manipur (Manipur),14,2
1.0,DR. RICKY ANDREW J. SYNGKON,Voice of the People Party,569156,1922,571078,55.02,1 - Shillong (Meghalaya),15,1
2.0,VINCENT H. PALA,Indian National Congress,198045,1123,199168,19.19,1 - Shillong (Meghalaya),15,1
3.0,DR. MAZEL AMPAREEN LYNGDOH,National People's Party,185531,957,186488,17.97,1 - Shillong (Meghalaya),15,1
4.0,ROBERTJUNE KHARJAHRIN,United Democratic Party,44278,285,44563,4.29,1 - Shillong (Meghalaya),15,1
5.0,PROF. LAKHON KMA,Independent,18522,60,18582,1.79,1 - Shillong (Meghalaya),15,1
6.0,PETER SHALLAM,Independent,6975,49,7024,0.68,1 - Shillong (Meghalaya),15,1
7.0,NOTA,None of the Above,10944,64,11008,1.06,1 - Shillong (Meghalaya),15,1
,Total,,1033451,4460,1037911,,1 - Shillong (Meghalaya),15,1
1.0,SALENG A SANGMA,Indian National Congress,382058,1861,383919,56.96,2 - Tura (Meghalaya),15,2
2.0,AGATHA K SANGMA,National People's Party,227210,1468,228678,33.93,2 - Tura (Meghalaya),15,2
3.0,ZENITH M SANGMA,All India Trinamool Congress,48518,191,48709,7.23,2 - Tura (Meghalaya),15,2
4.0,LABENN CH MARAK,Independent,6846,64,6910,1.03,2 - Tura (Meghalaya),15,2
5.0,NOTA,None of the Above,5809,31,5840,0.87,2 - Tura (Meghalaya),15,2
,Total,,670441,3615,674056,,2 - Tura (Meghalaya),15,2
1.0,RICHARD VANLALHMANGAIHA,Zoram People’s Movement,206377,2175,208552,42.45,1 - MIZORAM (Mizoram),16,1
2.0,K VANLALVENA,Mizo National Front,139532,732,140264,28.55,1 - MIZORAM (Mizoram),16,1
3.0,LALBIAKZAMA,Indian National Congress,97761,834,98595,20.07,1 - MIZORAM (Mizoram),16,1
4.0,VANLALHMUAKA,Bharatiya Janata Party,33009,524,33533,6.82,1 - MIZORAM (Mizoram),16,1
5.0,LALHRIATRENGA CHHANGTE,Independent,4663,43,4706,0.96,1 - MIZORAM (Mizoram),16,1
6.0,RITA MALSAWMI,Mizoram People's Conference,3681,112,3793,0.77,1 - MIZORAM (Mizoram),16,1
7.0,NOTA,None of the Above,1866,27,1893,0.39,1 - MIZORAM (Mizoram),16,1
,Total,,486889,4447,491336,,1 - MIZORAM (Mizoram),16,1
1.0,S SUPONGMEREN JAMIR,Indian National Congress,399512,2439,401951,52.83,1 - Nagaland (Nagaland),17,1
2.0,DR CHUMBEN MURRY,Nationalist Democratic Progressive Party,350072,895,350967,46.13,1 - Nagaland (Nagaland),17,1
3.0,HAYITHUNG TUNGOE LOTHA,Independent,6050,182,6232,0.82,1 - Nagaland (Nagaland),17,1
4.0,NOTA,None of the Above,1520,126,1646,0.22,1 - Nagaland (Nagaland),17,1
,Total,,757154,3642,760796,,1 - Nagaland (Nagaland),17,1
1.0,PRADEEP PUROHIT,Bharatiya Janata Party,709606,6753,716359,54.69,1 - Bargarh (Odisha),18,1
2.0,PARINITA MISHRA,Biju Janata Dal,463008,1684,464692,35.48,1 - Bargarh (Odisha),18,1
3.0,SANJAY BHOI,Indian National Congress,92666,885,93551,7.14,1 - Bargarh (Odisha),18,1
4.0,JAYARAM BAGH,Bahujan Samaj Party,9215,107,9322,0.71,1 - Bargarh (Odisha),18,1
5.0,GNYANENDRA BEHERA,Independent,4539,24,4563,0.35,1 - Bargarh (Odisha),18,1
6.0,DEVIKA SIKA,National Apni Party,4524,14,4538,0.35,1 - Bargarh (Odisha),18,1
7.0,PRABHAT KUMAR DHARUA,Independent,4294,4,4298,0.33,1 - Bargarh (Odisha),18,1
8.0,NOTA,None of the Above,12414,127,12541,0.96,1 - Bargarh (Odisha),18,1
,Total,,1300266,9598,1309864,,1 - Bargarh (Odisha),18,1
1.0,JUAL ORAM,Bharatiya Janata Party,490655,3627,494282,42.77,2 - Sundargarh (Odisha),18,2
2.0,DILIP KUMAR TIRKEY,Biju Janata Dal,353708,1766,355474,30.76,2 - Sundargarh (Odisha),18,2
3.0,JANARDAN DEHURY,Indian National Congress,260681,1305,261986,22.67,2 - Sundargarh (Odisha),18,2
4.0,JUSTIN LUGUN,Socialist Unity Centre Of India (COMMUNIST),9120,21,9141,0.79,2 - Sundargarh (Odisha),18,2
5.0,JAGABANDHU ORAM,Independent,6023,4,6027,0.52,2 - Sundargarh (Odisha),18,2
6.0,SUMANTA KUMAR SORENG,National Apni Party,4035,17,4052,0.35,2 - Sundargarh (Odisha),18,2
7.0,SANTOSH JURA,Naba Bharata Nirmana Seva Party,3976,5,3981,0.34,2 - Sundargarh (Odisha),18,2
8.0,PARUA EKKA,Jharkhand Party,3018,15,3033,0.26,2 - Sundargarh (Odisha),18,2
9.0,NOTA,None of the Above,17752,49,17801,1.54,2 - Sundargarh (Odisha),18,2
,Total,,1148968,6809,1155777,,2 - Sundargarh (Odisha),18,2
1.0,DHARMENDRA PRADHAN,Bharatiya Janata Party,587827,4335,592162,49.48,3 - Sambalpur (Odisha),18,3
2.0,PRANAB PRAKASH DAS,Biju Janata Dal,471198,1128,472326,39.47,3 - Sambalpur (Odisha),18,3
3.0,NAGENDRA KUMAR PRADHAN,Indian National Congress,88573,540,89113,7.45,3 - Sambalpur (Odisha),18,3
4.0,SADANAND RANBIDA,Bahujan Samaj Party,4776,19,4795,0.4,3 - Sambalpur (Odisha),18,3
5.0,SRIRAM PANDEY,Independent,4700,2,4702,0.39,3 - Sambalpur (Odisha),18,3
6.0,SHUSHIL KUMAR BABU,Independent,4298,5,4303,0.36,3 - Sambalpur (Odisha),18,3
7.0,GNYANENDRA BEHERA,Independent,3331,3,3334,0.28,3 - Sambalpur (Odisha),18,3
8.0,NABAKISHORE PRADHAN,Socialist Unity Centre Of India (COMMUNIST),3151,6,3157,0.26,3 - Sambalpur (Odisha),18,3
9.0,ATMA RAM SUPKAR,Independent,2053,6,2059,0.17,3 - Sambalpur (Odisha),18,3
10.0,PURUSHOTTAM PATRA,Kosal Janata Dal,1731,4,1735,0.14,3 - Sambalpur (Odisha),18,3
11.0,RAKESH BAG,Bharatiya Nyay-Adhikar Raksha Party,1704,4,1708,0.14,3 - Sambalpur (Odisha),18,3
12.0,SUBASH MOHAPATRA,National Jan Dal,1669,24,1693,0.14,3 - Sambalpur (Odisha),18,3
13.0,LAXMAN KUMAR BHOI,Paschimanchal Vikas Party,1662,20,1682,0.14,3 - Sambalpur (Odisha),18,3
14.0,KHAGESWAR BEHERA,Rashtriya Manav Party,1492,3,1495,0.12,3 - Sambalpur (Odisha),18,3
15.0,NOTA,None of the Above,12451,32,12483,1.04,3 - Sambalpur (Odisha),18,3
,Total,,1190616,6131,1196747,,3 - Sambalpur (Odisha),18,3
1.0,ANANTA NAYAK,Bharatiya Janata Party,571133,2790,573923,45.67,4 - Keonjhar (Odisha),18,4
2.0,DHANURJAYA SIDU,Biju Janata Dal,476206,675,476881,37.95,4 - Keonjhar (Odisha),18,4
3.0,BINOD BIHARI NAIK,Indian National Congress,104944,334,105278,8.38,4 - Keonjhar (Odisha),18,4
4.0,JOHN MIRAN MUNDA,Independent,31729,7,31736,2.53,4 - Keonjhar (Odisha),18,4
5.0,SAHEBA JUANGA,Manas Lokshakti Dal,11040,3,11043,0.88,4 - Keonjhar (Odisha),18,4
6.0,SUSHANT KUMAR NAIK,Independent,9041,3,9044,0.72,4 - Keonjhar (Odisha),18,4
7.0,LAMBODAR NAIK,Independent,6778,-,6778,0.54,4 - Keonjhar (Odisha),18,4
8.0,HARIHAR MUNDA,Socialist Unity Centre Of India (COMMUNIST),6569,5,6574,0.52,4 - Keonjhar (Odisha),18,4
9.0,RAGHUMANI NAIK,Independent,4550,6,4556,0.36,4 - Keonjhar (Odisha),18,4
10.0,RAM PRASAD HEMBRAM,Bahujan Samaj Party,3884,11,3895,0.31,4 - Keonjhar (Odisha),18,4
11.0,PITABASA NAIK,AJSU Party,2141,3,2144,0.17,4 - Keonjhar (Odisha),18,4
12.0,NOTA,None of the Above,24746,17,24763,1.97,4 - Keonjhar (Odisha),18,4
,Total,,1252761,3854,1256615,,4 - Keonjhar (Odisha),18,4
1.0,NABA CHARAN MAJHI,Bharatiya Janata Party,580579,5392,585971,49.91,5 - Mayurbhanj (Odisha),18,5
2.0,SUDAM MARNDI,Biju Janata Dal,364745,1892,366637,31.23,5 - Mayurbhanj (Odisha),18,5
3.0,ANJANI SOREN,Jharkhand Mukti Morcha,134713,686,135399,11.53,5 - Mayurbhanj (Odisha),18,5
4.0,RABINDRA NATH SINGH,Independent,9282,42,9324,0.79,5 - Mayurbhanj (Odisha),18,5
5.0,ASHOK KUMAR SING,Independent,8918,35,8953,0.76,5 - Mayurbhanj (Odisha),18,5
6.0,JATIA SAWAYAN,Bahujan Samaj Party,8457,45,8502,0.72,5 - Mayurbhanj (Odisha),18,5
7.0,SANTILATA CHATTAR,Independent,8448,29,8477,0.72,5 - Mayurbhanj (Odisha),18,5
8.0,PITAMBAR NAIK,Socialist Unity Centre Of India (COMMUNIST),8070,44,8114,0.69,5 - Mayurbhanj (Odisha),18,5
9.0,ANTA ALOK BASKEY,AJSU Party,5386,8,5394,0.46,5 - Mayurbhanj (Odisha),18,5
10.0,BAJUN HANSDA,Independent,5304,18,5322,0.45,5 - Mayurbhanj (Odisha),18,5
11.0,KANHU CHARAN TUDU,Independent,5103,35,5138,0.44,5 - Mayurbhanj (Odisha),18,5
12.0,SUKANTA HEMBRAM,Bharatiya Nyay-Adhikar Raksha Party,3636,20,3656,0.31,5 - Mayurbhanj (Odisha),18,5
13.0,GURU CHARAN HEMBRAM,Bharatheeya Jawan Kisan Party,3175,35,3210,0.27,5 - Mayurbhanj (Odisha),18,5
14.0,NOTA,None of the Above,19853,100,19953,1.7,5 - Mayurbhanj (Odisha),18,5
,Total,,1165669,8381,1174050,,5 - Mayurbhanj (Odisha),18,5
1.0,PRATAP CHANDRA SARANGI,Bharatiya Janata Party,561590,2275,563865,45.49,6 - Balasore (Odisha),18,6
2.0,LEKHASRI SAMANTSINGHAR,Biju Janata Dal,415917,792,416709,33.62,6 - Balasore (Odisha),18,6
3.0,SHRIKANTA JENA,Indian National Congress,236081,926,237007,19.12,6 - Balasore (Odisha),18,6
4.0,RAJAT KUMAR BEHERA,Bahujan Samaj Party,2913,7,2920,0.24,6 - Balasore (Odisha),18,6
5.0,GOBINDA CHANDRA BHOI,National Apni Party,2640,-,2640,0.21,6 - Balasore (Odisha),18,6
6.0,SURYAKANTA DASMOHAPATRA,Independent,2156,5,2161,0.17,6 - Balasore (Odisha),18,6
7.0,MAHAMEGHABAHAN AIRA KHARABELA SWAIN,Independent,1863,5,1868,0.15,6 - Balasore (Odisha),18,6
8.0,PRAMOD KUMAR PATTAYAT,Independent,1637,2,1639,0.13,6 - Balasore (Odisha),18,6
9.0,BIREN PUHAN,Krupaa Party,1450,2,1452,0.12,6 - Balasore (Odisha),18,6
10.0,DEEPAK SANKAR THAKUR GIRI,Independent,1191,3,1194,0.1,6 - Balasore (Odisha),18,6
11.0,AKHIL KUMAR MOHANTA,Independent,829,1,830,0.07,6 - Balasore (Odisha),18,6
12.0,NOTA,None of the Above,7333,17,7350,0.59,6 - Balasore (Odisha),18,6
,Total,,1235600,4035,1239635,,6 - Balasore (Odisha),18,6
1.0,AVIMANYU SETHI,Bharatiya Janata Party,569705,3614,573319,44.19,7 - Bhadrak (Odisha),18,7
2.0,MANJULATA MANDAL,Biju Janata Dal,480105,1670,481775,37.13,7 - Bhadrak (Odisha),18,7
3.0,ANANTA PRASAD SETHI,Indian National Congress,221020,854,221874,17.1,7 - Bhadrak (Odisha),18,7
4.0,KIRTAN BIHARI MALIK,Socialist Unity Centre Of India (COMMUNIST),4879,1,4880,0.38,7 - Bhadrak (Odisha),18,7
5.0,ADV. ARJUN CHARAN MALLIK,Bahujan Samaj Party,3581,23,3604,0.28,7 - Bhadrak (Odisha),18,7
6.0,ANJAN DAS,Ambedkarite Party of India,3512,5,3517,0.27,7 - Bhadrak (Odisha),18,7
7.0,BASANTA KUMAR MAHALIK,Independent,1527,3,1530,0.12,7 - Bhadrak (Odisha),18,7
8.0,SARBESWAR BEHERA,Independent,1397,3,1400,0.11,7 - Bhadrak (Odisha),18,7
9.0,NOTA,None of the Above,5457,21,5478,0.42,7 - Bhadrak (Odisha),18,7
,Total,,1291183,6194,1297377,,7 - Bhadrak (Odisha),18,7
1.0,SARMISTHA SETHI,Biju Janata Dal,529428,3224,532652,45.87,8 - Jajpur (Odisha),18,8
2.0,RABINDRA NARAYAN BEHERA,Bharatiya Janata Party,528959,5280,534239,46.01,8 - Jajpur (Odisha),18,8
3.0,ANCHAL DAS,Indian National Congress,52455,690,53145,4.58,8 - Jajpur (Odisha),18,8
4.0,SUBASH CHANDRA MALLIK,Socialist Unity Centre Of India (COMMUNIST),17955,52,18007,1.55,8 - Jajpur (Odisha),18,8
5.0,ER. SANDHYA RANI MALLICK,Bahujan Samaj Party,3189,29,3218,0.28,8 - Jajpur (Odisha),18,8
6.0,BHAIRABA PRASAD BEHERA,Independent,2398,5,2403,0.21,8 - Jajpur (Odisha),18,8
7.0,SUMANTA MALIK,Independent,2295,6,2301,0.2,8 - Jajpur (Odisha),18,8
8.0,BIDYADHAR DALEI,Ambedkarite Party of India,2172,-,2172,0.19,8 - Jajpur (Odisha),18,8
9.0,JHUNA MALIK,Manas Lokshakti Dal,2075,2,2077,0.18,8 - Jajpur (Odisha),18,8
10.0,ARTTATRANA MALIK,Independent,1234,18,1252,0.11,8 - Jajpur (Odisha),18,8
11.0,NARENDRA MALIKA,Independent,1119,-,1119,0.1,8 - Jajpur (Odisha),18,8
12.0,MANTU SETHI,Janta Darbar Party,954,2,956,0.08,8 - Jajpur (Odisha),18,8
13.0,BINOD KUMAR JENA,Gana Suraksha Party,876,3,879,0.08,8 - Jajpur (Odisha),18,8
14.0,NOTA,None of the Above,6738,50,6788,0.58,8 - Jajpur (Odisha),18,8
,Total,,1151847,9361,1161208,,8 - Jajpur (Odisha),18,8
1.0,RUDRA NARAYAN PANY,Bharatiya Janata Party,593907,4814,598721,50.24,9 - Dhenkanal (Odisha),18,9
2.0,ABINASH SAMAL,Biju Janata Dal,520144,2010,522154,43.82,9 - Dhenkanal (Odisha),18,9
3.0,SASHMITA BEHERA,Indian National Congress,34052,678,34730,2.91,9 - Dhenkanal (Odisha),18,9
4.0,PRAFULLA KUMAR NAIK,Bahujan Samaj Party,4850,45,4895,0.41,9 - Dhenkanal (Odisha),18,9
5.0,MAHESWAR SAHOO,Independent,4614,15,4629,0.39,9 - Dhenkanal (Odisha),18,9
6.0,MANASI SWAIN,Socialist Unity Centre Of India (COMMUNIST),3376,8,3384,0.28,9 - Dhenkanal (Odisha),18,9
7.0,PRIYABRATA GARNAIK,Independent,2904,5,2909,0.24,9 - Dhenkanal (Odisha),18,9
8.0,JANARDAN NAIK,Independent,2647,6,2653,0.22,9 - Dhenkanal (Odisha),18,9
9.0,KAILAS CHANDRA PRADHAN,Independent,2205,8,2213,0.19,9 - Dhenkanal (Odisha),18,9
10.0,SWAPNA RANI JAMES,Utkal Samaj,1603,5,1608,0.13,9 - Dhenkanal (Odisha),18,9
11.0,NOTA,None of the Above,13731,46,13777,1.16,9 - Dhenkanal (Odisha),18,9
,Total,,1184033,7640,1191673,,9 - Dhenkanal (Odisha),18,9
1.0,SANGEETA KUMARI SINGH DEO,Bharatiya Janata Party,614196,3548,617744,44.12,10 - Bolangir (Odisha),18,10
2.0,SURENDRA SINGH BHOI,Biju Janata Dal,483964,1116,485080,34.64,10 - Bolangir (Odisha),18,10
3.0,MANOJ KUMAR MISHRA,Indian National Congress,229577,1297,230874,16.49,10 - Bolangir (Odisha),18,10
4.0,SUNIL KUMAR BHOI,Socialist Unity Centre Of India (COMMUNIST),10334,21,10355,0.74,10 - Bolangir (Odisha),18,10
5.0,JAGADISH CHANDRA BIBHAR,Bahujan Samaj Party,9404,65,9469,0.68,10 - Bolangir (Odisha),18,10
6.0,BALRAM SINGH YADAV,Independent,8637,37,8674,0.62,10 - Bolangir (Odisha),18,10
7.0,MADHUSUDAN BARIK,Ambedkarite Party of India,7239,13,7252,0.52,10 - Bolangir (Odisha),18,10
8.0,BALARAM SA,Independent,6092,5,6097,0.44,10 - Bolangir (Odisha),18,10
9.0,AKSHAYA DISHRI,National Apni Party,5465,4,5469,0.39,10 - Bolangir (Odisha),18,10
10.0,RAJESH KUMAR PANDA,Ekam Sanatan Bharat Dal,3163,7,3170,0.23,10 - Bolangir (Odisha),18,10
11.0,NOTA,None of the Above,16010,54,16064,1.15,10 - Bolangir (Odisha),18,10
,Total,,1394081,6167,1400248,,10 - Bolangir (Odisha),18,10
1.0,MALVIKA DEVI,Bharatiya Janata Party,538535,5768,544303,40.79,11 - Kalahandi (Odisha),18,11
2.0,LAMBODAR NIAL,Biju Janata Dal,408267,2223,410490,30.77,11 - Kalahandi (Odisha),18,11
3.0,DROUPADI MAJHI,Indian National Congress,300060,3139,303199,22.72,11 - Kalahandi (Odisha),18,11
4.0,UMAKANTA TANDI,Independent,9180,14,9194,0.69,11 - Kalahandi (Odisha),18,11
5.0,BIRANCHI NARAYAN DURGA,Bahujan Samaj Party,8440,57,8497,0.64,11 - Kalahandi (Odisha),18,11
6.0,DR. DHARMANANDA GAHIR,Independent,7775,36,7811,0.59,11 - Kalahandi (Odisha),18,11
7.0,SIBA HATI,Samajwadi Party,7138,30,7168,0.54,11 - Kalahandi (Odisha),18,11
8.0,RAJARAM SAHU,Independent,6712,18,6730,0.5,11 - Kalahandi (Odisha),18,11
9.0,NARESH HIANLA,Independent,6627,14,6641,0.5,11 - Kalahandi (Odisha),18,11
10.0,GANGADHAR JAL,Independent,5547,43,5590,0.42,11 - Kalahandi (Odisha),18,11
11.0,HIMANSHU TRIPATHY,Samruddha Odisha,4898,8,4906,0.37,11 - Kalahandi (Odisha),18,11
12.0,NOTA,None of the Above,19620,95,19715,1.48,11 - Kalahandi (Odisha),18,11
,Total,,1322799,11445,1334244,,11 - Kalahandi (Odisha),18,11
1.0,BALABHADRA MAJHI,Bharatiya Janata Party,478330,3066,481396,38.74,12 - Nabarangpur (Odisha),18,12
2.0,PRADEEP KUMAR MAJHI,Biju Janata Dal,392448,1412,393860,31.7,12 - Nabarangpur (Odisha),18,12
3.0,BHUJABAL MAJHI,Indian National Congress,302095,1297,303392,24.42,12 - Nabarangpur (Odisha),18,12
4.0,TRINATH MUNDAGUDIA,Socialist Unity Centre Of India (COMMUNIST),20548,11,20559,1.65,12 - Nabarangpur (Odisha),18,12
5.0,NOTA,None of the Above,43240,28,43268,3.48,12 - Nabarangpur (Odisha),18,12
,Total,,1236661,5814,1242475,,12 - Nabarangpur (Odisha),18,12
1.0,SUKANTA KUMAR PANIGRAHI,Bharatiya Janata Party,413320,3095,416415,41.8,13 - Kandhamal (Odisha),18,13
2.0,ACHYUTANANDA SAMANTA,Biju Janata Dal,393644,1400,395044,39.66,13 - Kandhamal (Odisha),18,13
3.0,AMIR CHAND NAYAK,Indian National Congress,143311,1011,144322,14.49,13 - Kandhamal (Odisha),18,13
4.0,BHAGIRATHI BALIARSINGH,Manas Lokshakti Dal,7329,1,7330,0.74,13 - Kandhamal (Odisha),18,13
5.0,KANAK MANJARI RATH,Independent,5201,4,5205,0.52,13 - Kandhamal (Odisha),18,13
6.0,HARIBANDHU BEHERA,Bahujan Samaj Party,5121,16,5137,0.52,13 - Kandhamal (Odisha),18,13
7.0,SUBASH MOHAPATRA,National Jan Dal,4133,4,4137,0.42,13 - Kandhamal (Odisha),18,13
8.0,PARSURAM PRADHAN,Kalinga Sena,2770,11,2781,0.28,13 - Kandhamal (Odisha),18,13
9.0,NOTA,None of the Above,15691,29,15720,1.58,13 - Kandhamal (Odisha),18,13
,Total,,990520,5571,996091,,13 - Kandhamal (Odisha),18,13
1.0,BHARTRUHARI MAHTAB,Bharatiya Janata Party,529271,2330,531601,47.43,14 - Cuttack (Odisha),18,14
2.0,SANTRUPT MISRA,Biju Janata Dal,473443,1081,474524,42.34,14 - Cuttack (Odisha),18,14
3.0,SURESH MOHAPATRA,Indian National Congress,83461,354,83815,7.48,14 - Cuttack (Odisha),18,14
4.0,PRAMOD KUMAR MALLICK,Bahujan Samaj Party,4461,23,4484,0.4,14 - Cuttack (Odisha),18,14
5.0,NIRANJAN PATI,Independent,4390,6,4396,0.39,14 - Cuttack (Odisha),18,14
6.0,SOBHA PANDEY,Independent,3878,10,3888,0.35,14 - Cuttack (Odisha),18,14
7.0,PRAKASH CHANDRA SAHOO,Krupaa Party,3790,4,3794,0.34,14 - Cuttack (Odisha),18,14
8.0,RAJAKISHORE MALLIK,Socialist Unity Centre Of India (COMMUNIST),3072,3,3075,0.27,14 - Cuttack (Odisha),18,14
9.0,GOKULANANDA MISHRA,Independent,1804,4,1808,0.16,14 - Cuttack (Odisha),18,14
10.0,MINATI PATNAIK,Samruddha Odisha,1241,10,1251,0.11,14 - Cuttack (Odisha),18,14
11.0,NOTA,None of the Above,8130,29,8159,0.73,14 - Cuttack (Odisha),18,14
,Total,,1116941,3854,1120795,,14 - Cuttack (Odisha),18,14
1.0,BAIJAYANT PANDA,Bharatiya Janata Party,612916,2789,615705,48.21,15 - Kendrapara (Odisha),18,15
2.0,ANSHUMAN MOHANTY,Biju Janata Dal,547681,1488,549169,43.0,15 - Kendrapara (Odisha),18,15
3.0,SIDHARTH SWARUP DASH,Indian National Congress,94595,237,94832,7.43,15 - Kendrapara (Odisha),18,15
4.0,SOUBHAGYA KETAN SAMAL,Socialist Unity Centre Of India (COMMUNIST),3393,2,3395,0.27,15 - Kendrapara (Odisha),18,15
5.0,SEKHA SADIKA HOSEN,Bahujan Samaj Party,1845,7,1852,0.15,15 - Kendrapara (Odisha),18,15
6.0,SUPRAVA DAS,Akhil Bhartiya Parivar Party,1559,2,1561,0.12,15 - Kendrapara (Odisha),18,15
7.0,SRIRAM PANDEY,Independent,1397,2,1399,0.11,15 - Kendrapara (Odisha),18,15
8.0,SANTOSH KUMAR PATRA,Independent,1370,3,1373,0.11,15 - Kendrapara (Odisha),18,15
9.0,PRATAP CHANDRA MOHANTY,Independent,1088,7,1095,0.09,15 - Kendrapara (Odisha),18,15
10.0,PRANGYAN PRAKASH MOHAPATRA,Odisha Janata Party,910,2,912,0.07,15 - Kendrapara (Odisha),18,15
11.0,NOTA,None of the Above,5807,8,5815,0.46,15 - Kendrapara (Odisha),18,15
,Total,,1272561,4547,1277108,,15 - Kendrapara (Odisha),18,15
1.0,BIBHU PRASAD TARAI,Bharatiya Janata Party,585672,3421,589093,45.8,16 - Jagatsinghpur (Odisha),18,16
2.0,DR. RAJASHREE MALLICK,Biju Janata Dal,546443,1954,548397,42.63,16 - Jagatsinghpur (Odisha),18,16
3.0,RABINDRA KUMAR SETHY,Indian National Congress,122875,695,123570,9.61,16 - Jagatsinghpur (Odisha),18,16
4.0,RAMESH CHANDRA SETHY,Communist Party of India,8112,18,8130,0.63,16 - Jagatsinghpur (Odisha),18,16
5.0,PEEYUUSH DAS,Ambedkarite Party of India,3225,5,3230,0.25,16 - Jagatsinghpur (Odisha),18,16
6.0,BIBHUTI BHUSAN MAJHI,Bahujan Samaj Party,2718,22,2740,0.21,16 - Jagatsinghpur (Odisha),18,16
7.0,MAHESWAR DAS,Socialist Unity Centre Of India (COMMUNIST),2374,10,2384,0.19,16 - Jagatsinghpur (Odisha),18,16
8.0,SANKAR DAS,Independent,1476,12,1488,0.12,16 - Jagatsinghpur (Odisha),18,16
9.0,SILI MALLICK,Samruddha Odisha,924,6,930,0.07,16 - Jagatsinghpur (Odisha),18,16
10.0,ARJUNA CHARAN BEHERA,Independent,758,8,766,0.06,16 - Jagatsinghpur (Odisha),18,16
11.0,BHANUMATI DAS,Utkal Samaj,674,3,677,0.05,16 - Jagatsinghpur (Odisha),18,16
12.0,NOTA,None of the Above,4852,30,4882,0.38,16 - Jagatsinghpur (Odisha),18,16
,Total,,1280103,6184,1286287,,16 - Jagatsinghpur (Odisha),18,16
1.0,SAMBIT PATRA,Bharatiya Janata Party,625372,3958,629330,52.58,17 - Puri (Odisha),18,17
2.0,ARUP MOHAN PATNAIK,Biju Janata Dal,523036,1585,524621,43.83,17 - Puri (Odisha),18,17
3.0,JAYANARAYAN PATTANAYAK,Indian National Congress,24066,276,24342,2.03,17 - Puri (Odisha),18,17
4.0,SANTANU KUMAR DAS,Bahujan Samaj Party,3918,11,3929,0.33,17 - Puri (Odisha),18,17
5.0,SUBASH CHANDRA BHOI,Socialist Unity Centre Of India (COMMUNIST),3257,9,3266,0.27,17 - Puri (Odisha),18,17
6.0,SOBHA PANDEY,Independent,2212,17,2229,0.19,17 - Puri (Odisha),18,17
7.0,DILLIP KUMAR BARAL,Independent,1605,6,1611,0.13,17 - Puri (Odisha),18,17
8.0,NOTA,None of the Above,7568,42,7610,0.64,17 - Puri (Odisha),18,17
,Total,,1191034,5904,1196938,,17 - Puri (Odisha),18,17
1.0,APARAJITA SARANGI,Bharatiya Janata Party,509567,2952,512519,47.36,18 - Bhubaneswar (Odisha),18,18
2.0,MANMATH KUMAR ROUTRAY,Biju Janata Dal,475990,1377,477367,44.11,18 - Bhubaneswar (Odisha),18,18
3.0,SYED YASHIR NAWAZ,Indian National Congress,66045,317,66362,6.13,18 - Bhubaneswar (Odisha),18,18
4.0,SURESH CHANDRA PANIGRAHY,Communist Party of India (Marxist),4134,14,4148,0.38,18 - Bhubaneswar (Odisha),18,18
5.0,HULAS SENAPATI,Independent,2248,3,2251,0.21,18 - Bhubaneswar (Odisha),18,18
6.0,KISHOR KUMAR SUTAR,Independent,2202,1,2203,0.2,18 - Bhubaneswar (Odisha),18,18
7.0,SUDHANSU SEKHAR DAS,Independent,1751,7,1758,0.16,18 - Bhubaneswar (Odisha),18,18
8.0,SANTOSH KUMAR MISHRA,Independent,1738,6,1744,0.16,18 - Bhubaneswar (Odisha),18,18
9.0,SANGEETA PATTANAIK,Odisha Janata Party,1528,2,1530,0.14,18 - Bhubaneswar (Odisha),18,18
10.0,PRADEEP KUMAR SAHOO,Kalinga Sena,1495,8,1503,0.14,18 - Bhubaneswar (Odisha),18,18
11.0,SANTILATA ROUT,Supreme Zero Party of Bharat,1437,4,1441,0.13,18 - Bhubaneswar (Odisha),18,18
12.0,NATABAR MAHARANA,Bharatiya Bikash Parishad,1080,7,1087,0.1,18 - Bhubaneswar (Odisha),18,18
13.0,NOTA,None of the Above,8261,41,8302,0.77,18 - Bhubaneswar (Odisha),18,18
,Total,,1077476,4739,1082215,,18 - Bhubaneswar (Odisha),18,18
1.0,ANITA SUBHADARSHINI,Bharatiya Janata Party,493032,1194,494226,48.55,19 - Aska (Odisha),18,19
2.0,RANJITA SAHU,Biju Janata Dal,393759,493,394252,38.73,19 - Aska (Odisha),18,19
3.0,DEBAKANTA SARMA,Indian National Congress,75108,147,75255,7.39,19 - Aska (Odisha),18,19
4.0,SANJAYA KUMAR BISHOYI,Independent,11234,6,11240,1.1,19 - Aska (Odisha),18,19
5.0,PAPUNU SAHU,Socialist Unity Centre Of India (COMMUNIST),8671,2,8673,0.85,19 - Aska (Odisha),18,19
6.0,PITABAS SAHU,Sanatan Sanskriti Raksha Dal,6888,-,6888,0.68,19 - Aska (Odisha),18,19
7.0,BRUNDABANA NAHAK,Bahujan Samaj Party,5430,9,5439,0.53,19 - Aska (Odisha),18,19
8.0,NOTA,None of the Above,21925,16,21941,2.16,19 - Aska (Odisha),18,19
,Total,,1016047,1867,1017914,,19 - Aska (Odisha),18,19
1.0,DR. PRADEEP KUMAR PANIGRAHY,Bharatiya Janata Party,510585,2517,513102,49.2,20 - Berhampur (Odisha),18,20
2.0,BHRUGU BAXIPATRA,Biju Janata Dal,346780,846,347626,33.33,20 - Berhampur (Odisha),18,20
3.0,RASMI RANJAN PATNAIK,Indian National Congress,129096,648,129744,12.44,20 - Berhampur (Odisha),18,20
4.0,V CHANDRA SHEKHAR,Independent,8376,3,8379,0.8,20 - Berhampur (Odisha),18,20
5.0,BHASKAR CHAUDHORY,Bahujan Samaj Party,5198,13,5211,0.5,20 - Berhampur (Odisha),18,20
6.0,SOMANATH BEHERA,Socialist Unity Centre Of India (COMMUNIST),5121,14,5135,0.49,20 - Berhampur (Odisha),18,20
7.0,SIRIN TAMMANA,Independent,5069,9,5078,0.49,20 - Berhampur (Odisha),18,20
8.0,BOMMALI KANTA RAO,Naba Bharata Nirmana Seva Party,4190,11,4201,0.4,20 - Berhampur (Odisha),18,20
9.0,RAM SANKAR SATAPATHY,Independent,3869,2,3871,0.37,20 - Berhampur (Odisha),18,20
10.0,RAJENDRA DALABEHERA,Bharatiya Bikash Parishad,2335,8,2343,0.22,20 - Berhampur (Odisha),18,20
11.0,SANTOSH KUMAR SAHU,All India Forward Bloc,2284,7,2291,0.22,20 - Berhampur (Odisha),18,20
12.0,NOTA,None of the Above,15903,39,15942,1.53,20 - Berhampur (Odisha),18,20
,Total,,1038806,4117,1042923,,20 - Berhampur (Odisha),18,20
1.0,SAPTAGIRI SANKAR ULAKA,Indian National Congress,469295,2098,471393,41.03,21 - Koraput (Odisha),18,21
2.0,KAUSALYA HIKAKA,Biju Janata Dal,322797,852,323649,28.17,21 - Koraput (Odisha),18,21
3.0,KALIRAM MAJHI,Bharatiya Janata Party,230792,1722,232514,20.24,21 - Koraput (Odisha),18,21
4.0,DAMINI JANI,Bahujan Samaj Party,15373,54,15427,1.34,21 - Koraput (Odisha),18,21
5.0,PRAKASH HIKAKA,Communist Party of India (Marxist-Leninist) (Liberation),14847,5,14852,1.29,21 - Koraput (Odisha),18,21
6.0,LASU HANTAL,Independent,14362,11,14373,1.25,21 - Koraput (Odisha),18,21
7.0,RAGHUMANI GOMANGO,Independent,10528,12,10540,0.92,21 - Koraput (Odisha),18,21
8.0,ABINASH GOMANGO,Independent,10258,16,10274,0.89,21 - Koraput (Odisha),18,21
9.0,SUMAN KANTA,Naba Bharata Nirmana Seva Party,8386,10,8396,0.73,21 - Koraput (Odisha),18,21
10.0,SANTOSH KUMAR BIDIKA,Republican Party of India (A),5413,2,5415,0.47,21 - Koraput (Odisha),18,21
11.0,PRAMILA PUJARI,Socialist Unity Centre Of India (COMMUNIST),4866,12,4878,0.42,21 - Koraput (Odisha),18,21
12.0,NOTA,None of the Above,37106,25,37131,3.23,21 - Koraput (Odisha),18,21
,Total,,1144023,4819,1148842,,21 - Koraput (Odisha),18,21
1.0,SUKHJINDER SINGH RANDHAWA,Indian National Congress,361713,2330,364043,33.78,1 - Gurdaspur (Punjab),19,1
2.0,DINESH SINGH BABBU,Bharatiya Janata Party,278701,2481,281182,26.09,1 - Gurdaspur (Punjab),19,1
3.0,AMANSHER SINGH (SHERY KALSI),Aam Aadmi Party,275416,1836,277252,25.72,1 - Gurdaspur (Punjab),19,1
4.0,DR. DALJIT SINGH CHEEMA,Shiromani Akali Dal,85194,306,85500,7.93,1 - Gurdaspur (Punjab),19,1
5.0,GURINDER SINGH BAJWA,Shiromani Akali Dal (Amritsar)(Simranjit Singh Mann),25425,340,25765,2.39,1 - Gurdaspur (Punjab),19,1
6.0,SANT SEWAK,Independent,5950,2,5952,0.55,1 - Gurdaspur (Punjab),19,1
7.0,RAJ KUMAR,Bahujan Samaj Party,4859,71,4930,0.46,1 - Gurdaspur (Punjab),19,1
8.0,SANTOSH KAUR,Independent,4733,5,4738,0.44,1 - Gurdaspur (Punjab),19,1
9.0,SAMUEL SONI,Independent,4427,13,4440,0.41,1 - Gurdaspur (Punjab),19,1
10.0,SURJIT SINGH,Independent,3372,1,3373,0.31,1 - Gurdaspur (Punjab),19,1
11.0,SANJEEV SINGH,Independent,2172,6,2178,0.2,1 - Gurdaspur (Punjab),19,1
12.0,SURINDER SINGH,Independent,1775,7,1782,0.17,1 - Gurdaspur (Punjab),19,1
13.0,GURPREET KAUR BAJWA,Independent,1688,21,1709,0.16,1 - Gurdaspur (Punjab),19,1
14.0,SANJEEV MANHAS,Independent,1634,1,1635,0.15,1 - Gurdaspur (Punjab),19,1
15.0,ROBI MASIH,Independent,1509,2,1511,0.14,1 - Gurdaspur (Punjab),19,1
16.0,SANTOSH KUMARI,Megh Desham Party,1171,23,1194,0.11,1 - Gurdaspur (Punjab),19,1
17.0,RAMESH KUMAR TOLLA,Bharatheeya Jawan Kisan Party,1085,13,1098,0.1,1 - Gurdaspur (Punjab),19,1
18.0,AMIT AGGARWAL,Independent,920,4,924,0.09,1 - Gurdaspur (Punjab),19,1
19.0,TARSEM MASIH SAHOTA,Independent,878,7,885,0.08,1 - Gurdaspur (Punjab),19,1
20.0,TILAK RAJ,Independent,802,3,805,0.07,1 - Gurdaspur (Punjab),19,1
21.0,RANJODH SINGH,Jan Sewa Driver Party,776,13,789,0.07,1 - Gurdaspur (Punjab),19,1
22.0,I.S.GULATI,Independent,696,3,699,0.06,1 - Gurdaspur (Punjab),19,1
23.0,RAMESH LAL,National Republic Party Of India,653,4,657,0.06,1 - Gurdaspur (Punjab),19,1
24.0,JAGDISH MASIH,Independent,545,1,546,0.05,1 - Gurdaspur (Punjab),19,1
25.0,JATINDER KUMAR SHARMA,Bhartiya Rashtriya Dal,456,5,461,0.04,1 - Gurdaspur (Punjab),19,1
26.0,DARBARA SINGH,Nationalist Justice Party,415,9,424,0.04,1 - Gurdaspur (Punjab),19,1
27.0,NOTA,None of the Above,3289,65,3354,0.31,1 - Gurdaspur (Punjab),19,1
,Total,,1070254,7572,1077826,,1 - Gurdaspur (Punjab),19,1
1.0,GURJEET SINGH AUJLA,Indian National Congress,254414,767,255181,28.18,2 - Amritsar (Punjab),19,2
2.0,KULDEEP SINGH DHALIWAL,Aam Aadmi Party,214268,612,214880,23.73,2 - Amritsar (Punjab),19,2
3.0,TARANJIT SINGH SANDHU SAMUNDRI,Bharatiya Janata Party,206832,373,207205,22.88,2 - Amritsar (Punjab),19,2
4.0,ANIL JOSHI,Shiromani Akali Dal,162686,210,162896,17.99,2 - Amritsar (Punjab),19,2
5.0,EMAAN SINGH MANN,Shiromani Akali Dal (Amritsar)(Simranjit Singh Mann),26584,212,26796,2.96,2 - Amritsar (Punjab),19,2
6.0,SATBIR SINGH JAMMU,Independent,3394,5,3399,0.38,2 - Amritsar (Punjab),19,2
7.0,VISHAL SIDHU,Bahujan Samaj Party,2713,20,2733,0.3,2 - Amritsar (Punjab),19,2
8.0,DASWINDER KAUR,Communist Party of India,2468,13,2481,0.27,2 - Amritsar (Punjab),19,2
9.0,SHARANJIT KAUR,Independent,2456,4,2460,0.27,2 - Amritsar (Punjab),19,2
10.0,AMANPREET SINGH MAHADIPUR,Independent,2353,9,2362,0.26,2 - Amritsar (Punjab),19,2
11.0,GURINDER SINGH SABHI GILL,Independent,2124,5,2129,0.24,2 - Amritsar (Punjab),19,2
12.0,SAHIB SINGH,Independent,1987,1,1988,0.22,2 - Amritsar (Punjab),19,2
13.0,SHAMSHER SINGH SHERA,Independent,1504,3,1507,0.17,2 - Amritsar (Punjab),19,2
14.0,SHAM LAL GANDHI,Independent,1487,-,1487,0.16,2 - Amritsar (Punjab),19,2
15.0,LOVEPREET SHARMA,Aas Punjab Party,1372,3,1375,0.15,2 - Amritsar (Punjab),19,2
16.0,MASTER HARJINDER PAL,Independent,1358,-,1358,0.15,2 - Amritsar (Punjab),19,2
17.0,JASPAL MASIH,Independent,1223,4,1227,0.14,2 - Amritsar (Punjab),19,2
18.0,RESHAM SINGH,Independent,1130,3,1133,0.13,2 - Amritsar (Punjab),19,2
19.0,BAL KRISHAN SHARMA,Independent,1106,1,1107,0.12,2 - Amritsar (Punjab),19,2
20.0,SIMRANPREET SINGH,Independent,1104,2,1106,0.12,2 - Amritsar (Punjab),19,2
21.0,NARINDER KAUR,Aam Janta Party (India),1064,33,1097,0.12,2 - Amritsar (Punjab),19,2
22.0,DILDAR MASIH,Shiromani Lok Dal Party,1042,2,1044,0.12,2 - Amritsar (Punjab),19,2
23.0,RAJINDER KUMAR SHARMA,Independent,899,1,900,0.1,2 - Amritsar (Punjab),19,2
24.0,BALWINDER SINGH,Independent,854,3,857,0.09,2 - Amritsar (Punjab),19,2
25.0,GURPREET SINGH RATTAN,Republican Party of India (Athawale),735,3,738,0.08,2 - Amritsar (Punjab),19,2
26.0,DR RAMESH KUMAR,Sacho Sach Party,650,2,652,0.07,2 - Amritsar (Punjab),19,2
27.0,GAGANDEEP,Independent,608,2,610,0.07,2 - Amritsar (Punjab),19,2
28.0,PRITHVI PAL,Independent,434,-,434,0.05,2 - Amritsar (Punjab),19,2
29.0,NEELAM,Independent,404,5,409,0.05,2 - Amritsar (Punjab),19,2
30.0,DILBAGH SINGH,Independent,388,3,391,0.04,2 - Amritsar (Punjab),19,2
31.0,NOTA,None of the Above,3685,29,3714,0.41,2 - Amritsar (Punjab),19,2
,Total,,903326,2330,905656,,2 - Amritsar (Punjab),19,2
1.0,AMRITPAL SINGH,Independent,402600,1830,404430,38.62,3 - Khadoor Sahib (Punjab),19,3
2.0,KULBIR SINGH ZIRA,Indian National Congress,206286,1024,207310,19.8,3 - Khadoor Sahib (Punjab),19,3
3.0,LALJIT SINGH BHULLAR,Aam Aadmi Party,194160,676,194836,18.61,3 - Khadoor Sahib (Punjab),19,3
4.0,VIRSA SINGH VALTOHA,Shiromani Akali Dal,86291,125,86416,8.25,3 - Khadoor Sahib (Punjab),19,3
5.0,MANJIT SINGH MANNA,Bharatiya Janata Party,85810,563,86373,8.25,3 - Khadoor Sahib (Punjab),19,3
6.0,PARAMJIT SINGH,Independent,12522,3,12525,1.2,3 - Khadoor Sahib (Punjab),19,3
7.0,CHAIN SINGH BAINKA,Aas Punjab Party,6728,11,6739,0.64,3 - Khadoor Sahib (Punjab),19,3
8.0,SATNAM SINGH,Bahujan Samaj Party,5021,45,5066,0.48,3 - Khadoor Sahib (Punjab),19,3
9.0,SARABJIT SINGH,Independent,4835,1,4836,0.46,3 - Khadoor Sahib (Punjab),19,3
10.0,GURDIAL SINGH,Communist Party of India,3945,7,3952,0.38,3 - Khadoor Sahib (Punjab),19,3
11.0,ANOKH SINGH KATWAL,Independent,2766,3,2769,0.26,3 - Khadoor Sahib (Punjab),19,3
12.0,GURPREET SINGH,Independent,2609,-,2609,0.25,3 - Khadoor Sahib (Punjab),19,3
13.0,AJIT SINGH,Independent,2528,7,2535,0.24,3 - Khadoor Sahib (Punjab),19,3
14.0,ARUN KUMAR,Independent,2522,3,2525,0.24,3 - Khadoor Sahib (Punjab),19,3
15.0,SURJIT SINGH BHIKHIWIND,Independent,2367,4,2371,0.23,3 - Khadoor Sahib (Punjab),19,3
16.0,KAWALJIT SINGH,Independent,2290,4,2294,0.22,3 - Khadoor Sahib (Punjab),19,3
17.0,HARJINDER SINGH,Independent,1969,1,1970,0.19,3 - Khadoor Sahib (Punjab),19,3
18.0,KANWALJIT SINGH,Independent,1895,6,1901,0.18,3 - Khadoor Sahib (Punjab),19,3
19.0,PARMINDER SINGH,Independent,1802,1,1803,0.17,3 - Khadoor Sahib (Punjab),19,3
20.0,JASWANT SINGH SOHAL,Independent,1637,2,1639,0.16,3 - Khadoor Sahib (Punjab),19,3
21.0,LAKHBIR SINGH,Independent,1420,1,1421,0.14,3 - Khadoor Sahib (Punjab),19,3
22.0,VIKRAMJIT SINGH,Independent,1417,3,1420,0.14,3 - Khadoor Sahib (Punjab),19,3
23.0,VIJAY KUMAR,Independent,1388,-,1388,0.13,3 - Khadoor Sahib (Punjab),19,3
24.0,DILBAGH SINGH,All India Mazdoor Party (Rangreta),1363,11,1374,0.13,3 - Khadoor Sahib (Punjab),19,3
25.0,SIMRANJEET SINGH,Independent,1338,3,1341,0.13,3 - Khadoor Sahib (Punjab),19,3
26.0,MAHINDER SINGH HAMIRA,Independent,1044,2,1046,0.1,3 - Khadoor Sahib (Punjab),19,3
27.0,NAVEEN KUMAR SHARMA,Sanjhi Virasat Party,823,1,824,0.08,3 - Khadoor Sahib (Punjab),19,3
28.0,NOTA,None of the Above,3420,32,3452,0.33,3 - Khadoor Sahib (Punjab),19,3
,Total,,1042796,4369,1047165,,3 - Khadoor Sahib (Punjab),19,3
1.0,CHARANJIT SINGH CHANNI,Indian National Congress,389509,544,390053,39.43,4 - Jalandhar (Punjab),19,4
2.0,SUSHIL KUMAR RINKU,Bharatiya Janata Party,213702,358,214060,21.64,4 - Jalandhar (Punjab),19,4
3.0,PAWAN KUMAR TINU,Aam Aadmi Party,208549,340,208889,21.12,4 - Jalandhar (Punjab),19,4
4.0,MOHINDER SINGH KAYPEE,Shiromani Akali Dal,67811,100,67911,6.87,4 - Jalandhar (Punjab),19,4
5.0,ADVOCATE BALWINDER KUMAR,Bahujan Samaj Party,64856,85,64941,6.57,4 - Jalandhar (Punjab),19,4
6.0,SARABJIT SINGH KHALSA,Shiromani Akali Dal (Amritsar)(Simranjit Singh Mann),19252,32,19284,1.95,4 - Jalandhar (Punjab),19,4
7.0,MASTER PARSHOTAM LAL BILGA,Communist Party of India (Marxist),5948,10,5958,0.6,4 - Jalandhar (Punjab),19,4
8.0,IQBAL CHAND MATTU,Independent,1956,-,1956,0.2,4 - Jalandhar (Punjab),19,4
9.0,NEETU SHATTRA WALA,Independent,1878,1,1879,0.19,4 - Jalandhar (Punjab),19,4
10.0,AMRISH BHAGAT,Independent,1183,1,1184,0.12,4 - Jalandhar (Punjab),19,4
11.0,GURDEEP SINGH BITTU,Independent,1112,1,1113,0.11,4 - Jalandhar (Punjab),19,4
12.0,RAJ KUMAR SAQI,Peoples Party of India (Democratic),1087,1,1088,0.11,4 - Jalandhar (Punjab),19,4
13.0,SONIA,Republican Party of India (Athawale),1054,1,1055,0.11,4 - Jalandhar (Punjab),19,4
14.0,RAJWANT KAUR KHALSA,Apna Samaj Party,948,4,952,0.1,4 - Jalandhar (Punjab),19,4
15.0,BHAGAT GULSHAN AZAAD,Democratic Bharatiya Samaj Party,929,1,930,0.09,4 - Jalandhar (Punjab),19,4
16.0,RAMESH LAL KALA,Independent,875,1,876,0.09,4 - Jalandhar (Punjab),19,4
17.0,ASHOK KUMAR JAKHU,Independent,742,1,743,0.08,4 - Jalandhar (Punjab),19,4
18.0,BAL MUKAND BAWRA,Global Republican Party,587,4,591,0.06,4 - Jalandhar (Punjab),19,4
19.0,PARAMJIT KAUR TEJI,Independent,500,-,500,0.05,4 - Jalandhar (Punjab),19,4
20.0,TARACHAND SHEELA,Loktantrik Lok Rajyam Party,400,1,401,0.04,4 - Jalandhar (Punjab),19,4
21.0,NOTA,None of the Above,4724,19,4743,0.48,4 - Jalandhar (Punjab),19,4
,Total,,987602,1505,989107,,4 - Jalandhar (Punjab),19,4
1.0,DR. RAJ KUMAR CHABBEWAL,Aam Aadmi Party,302402,1457,303859,32.04,5 - Hoshiarpur (Punjab),19,5
2.0,YAMINI GOMAR,Indian National Congress,257936,1812,259748,27.39,5 - Hoshiarpur (Punjab),19,5
3.0,ANITA SOM PARKASH,Bharatiya Janata Party,198576,1418,199994,21.09,5 - Hoshiarpur (Punjab),19,5
4.0,SOHAN SINGH THANDAL,Shiromani Akali Dal,91503,286,91789,9.68,5 - Hoshiarpur (Punjab),19,5
5.0,RANJIT KUMAR,Bahujan Samaj Party,47975,239,48214,5.08,5 - Hoshiarpur (Punjab),19,5
6.0,JASWANT SINGH,Shiromani Akali Dal (Amritsar)(Simranjit Singh Mann),20680,243,20923,2.21,5 - Hoshiarpur (Punjab),19,5
7.0,JEEVAN SINGH TAMIL,Bahujan Dravida Party,4607,14,4621,0.49,5 - Hoshiarpur (Punjab),19,5
8.0,ROHIT KUMAR TINKU,Independent,2417,2,2419,0.26,5 - Hoshiarpur (Punjab),19,5
9.0,RAJESH,Democratic Bharatiya Samaj Party,2330,6,2336,0.25,5 - Hoshiarpur (Punjab),19,5
10.0,SONU SINGH PHAGWARA,Independent,1871,13,1884,0.2,5 - Hoshiarpur (Punjab),19,5
11.0,DAVINDER SINGH,Independent,1584,33,1617,0.17,5 - Hoshiarpur (Punjab),19,5
12.0,HARDEEP SINGH,Nationalist Justice Party,1403,22,1425,0.15,5 - Hoshiarpur (Punjab),19,5
13.0,RAJPAL NADALI,Bahujan Mukti Party,1138,2,1140,0.12,5 - Hoshiarpur (Punjab),19,5
14.0,BHIMRAO YASHWANT AMBEDKAR,Global Republican Party,1034,7,1041,0.11,5 - Hoshiarpur (Punjab),19,5
15.0,SATPAL,Independent,978,15,993,0.1,5 - Hoshiarpur (Punjab),19,5
16.0,DAVINDER KUMAR SAROYA,Samaj Bhalai Morcha,923,7,930,0.1,5 - Hoshiarpur (Punjab),19,5
17.0,NOTA,None of the Above,5453,99,5552,0.59,5 - Hoshiarpur (Punjab),19,5
,Total,,942810,5675,948485,,5 - Hoshiarpur (Punjab),19,5
1.0,MALVINDER SINGH KANG,Aam Aadmi Party,312241,976,313217,29.08,6 - Anandpur Sahib (Punjab),19,6
2.0,VIJAY INDER SINGLA,Indian National Congress,301414,957,302371,28.07,6 - Anandpur Sahib (Punjab),19,6
3.0,DR SUBHASH SHARMA,Bharatiya Janata Party,185836,742,186578,17.32,6 - Anandpur Sahib (Punjab),19,6
4.0,PREM SINGH CHANDUMAJRA,Shiromani Akali Dal,117651,285,117936,10.95,6 - Anandpur Sahib (Punjab),19,6
5.0,JASVIR SINGH GARHI,Bahujan Samaj Party,89953,204,90157,8.37,6 - Anandpur Sahib (Punjab),19,6
6.0,KUSHAL PAL SINGH MANN,Shiromani Akali Dal (Amritsar)(Simranjit Singh Mann),24725,106,24831,2.31,6 - Anandpur Sahib (Punjab),19,6
7.0,GAJJAN SINGH,Independent,6164,7,6171,0.57,6 - Anandpur Sahib (Punjab),19,6
8.0,SIMPLE KUMAR,Independent,2962,-,2962,0.27,6 - Anandpur Sahib (Punjab),19,6
9.0,SATPAL,Independent,2294,3,2297,0.21,6 - Anandpur Sahib (Punjab),19,6
10.0,GURMIT SINGH,Independent,2179,3,2182,0.2,6 - Anandpur Sahib (Punjab),19,6
11.0,DHARMINDER SINGH HARMAN,Akhil Bhartiya Parivar Party,2037,6,2043,0.19,6 - Anandpur Sahib (Punjab),19,6
12.0,SUNIL KUMAR,Bhartiya Jan Samman Party,1968,9,1977,0.18,6 - Anandpur Sahib (Punjab),19,6
13.0,ER DALJEET SINGH SAINI,Bharatheeya Jawan Kisan Party,1710,5,1715,0.16,6 - Anandpur Sahib (Punjab),19,6
14.0,KULWINDER SINGH,Democratic Bharatiya Samaj Party,1651,1,1652,0.15,6 - Anandpur Sahib (Punjab),19,6
15.0,SUNAINA,Bhartiya Rashtriya Dal,1621,19,1640,0.15,6 - Anandpur Sahib (Punjab),19,6
16.0,ADV KULWINDER SINGH,Independent,1596,4,1600,0.15,6 - Anandpur Sahib (Punjab),19,6
17.0,MEGH RAJ,Independent,1429,1,1430,0.13,6 - Anandpur Sahib (Punjab),19,6
18.0,HARWINDER KARWAL,Independent,1309,2,1311,0.12,6 - Anandpur Sahib (Punjab),19,6
19.0,DAVINDER SINGH,Independent,1164,11,1175,0.11,6 - Anandpur Sahib (Punjab),19,6
20.0,DARSHAN SINGH,Punjab National Party,1164,8,1172,0.11,6 - Anandpur Sahib (Punjab),19,6
21.0,HANISH SHARMA,Ekam Sanatan Bharat Dal,1072,4,1076,0.1,6 - Anandpur Sahib (Punjab),19,6
22.0,DEEPAK SHARMA,Independent,1012,-,1012,0.09,6 - Anandpur Sahib (Punjab),19,6
23.0,PARMINDER SINGH,Independent,930,-,930,0.09,6 - Anandpur Sahib (Punjab),19,6
24.0,YOG RAJ SAHOTA,Revolutionary Socialist Party,925,-,925,0.09,6 - Anandpur Sahib (Punjab),19,6
25.0,RAMJAAN KHAN,Independent,672,-,672,0.06,6 - Anandpur Sahib (Punjab),19,6
26.0,ROHTASH,Independent,617,2,619,0.06,6 - Anandpur Sahib (Punjab),19,6
27.0,MANDAR SINGH,Independent,555,-,555,0.05,6 - Anandpur Sahib (Punjab),19,6
28.0,KIRAN JAIN,Hindustan Shakti Sena,507,8,515,0.05,6 - Anandpur Sahib (Punjab),19,6
29.0,NOTA,None of the Above,6351,51,6402,0.59,6 - Anandpur Sahib (Punjab),19,6
,Total,,1073709,3414,1077123,,6 - Anandpur Sahib (Punjab),19,6
1.0,AMRINDER SINGH RAJA WARRING,Indian National Congress,321424,800,322224,30.42,7 - Ludhiana (Punjab),19,7
2.0,RAVNEET SINGH BITTU,Bharatiya Janata Party,300927,355,301282,28.45,7 - Ludhiana (Punjab),19,7
3.0,ASHOK PRASHAR PAPPI,Aam Aadmi Party,236620,457,237077,22.38,7 - Ludhiana (Punjab),19,7
4.0,RANJIT SINGH DHILLON,Shiromani Akali Dal,90073,147,90220,8.52,7 - Ludhiana (Punjab),19,7
5.0,KAMALJIT SINGH BRAR,Independent,42462,38,42500,4.01,7 - Ludhiana (Punjab),19,7
6.0,AMRITPAL SINGH CHHANDRAN,Shiromani Akali Dal (Amritsar)(Simranjit Singh Mann),18199,42,18241,1.72,7 - Ludhiana (Punjab),19,7
7.0,DAVINDER SINGH RAMGARHIA,Bahujan Samaj Party,10365,29,10394,0.98,7 - Ludhiana (Punjab),19,7
8.0,NARESH DHINGAAN,Independent,2524,6,2530,0.24,7 - Ludhiana (Punjab),19,7
9.0,RAKESH KUMAR (RICKY),Sunahara Bharat Party,2091,-,2091,0.2,7 - Ludhiana (Punjab),19,7
10.0,ER. BALDEV RAJ KATNA (DEBI),Independent,2086,-,2086,0.2,7 - Ludhiana (Punjab),19,7
11.0,PRITPAL SINGH,Bahujan Dravida Party,1821,3,1824,0.17,7 - Ludhiana (Punjab),19,7
12.0,DR. PALWINDER KAUR,Independent,1766,2,1768,0.17,7 - Ludhiana (Punjab),19,7
13.0,SANJEEV KUMAR (SANJU),Independent,1567,-,1567,0.15,7 - Ludhiana (Punjab),19,7
14.0,RAJIV KUMAR MEHRA,Jan Sewa Driver Party,1516,2,1518,0.14,7 - Ludhiana (Punjab),19,7
15.0,BHUPINDER SINGH,Bharatheeya Jawan Kisan Party,1287,-,1287,0.12,7 - Ludhiana (Punjab),19,7
16.0,BALJIT SINGH,Independent,1137,1,1138,0.11,7 - Ludhiana (Punjab),19,7
17.0,VIPAN KUMAR BATRA,Independent,1041,-,1041,0.1,7 - Ludhiana (Punjab),19,7
18.0,AMANDEEP SINGH,Sehajdhari Sikh Party,981,6,987,0.09,7 - Ludhiana (Punjab),19,7
19.0,PARAMJIT SINGH,Independent,927,-,927,0.09,7 - Ludhiana (Punjab),19,7
20.0,BALVINDER SINGH BITTA,Independent,918,-,918,0.09,7 - Ludhiana (Punjab),19,7
21.0,SIMRANDEEP SINGH,Independent,911,1,912,0.09,7 - Ludhiana (Punjab),19,7
22.0,DEVINDER BHAGRIA,Hindustan Shakti Sena,859,1,860,0.08,7 - Ludhiana (Punjab),19,7
23.0,KANIYA LAL (DR. KISHAN KUMAR),Independent,820,-,820,0.08,7 - Ludhiana (Punjab),19,7
24.0,SUDHIR KUMAR TRIPATHI,Independent,770,-,770,0.07,7 - Ludhiana (Punjab),19,7
25.0,GURDEEP SINGH KAHLON,Independent,738,-,738,0.07,7 - Ludhiana (Punjab),19,7
26.0,DR. DEVINDER SINGH GILL,Aam Lok Party United,693,2,695,0.07,7 - Ludhiana (Punjab),19,7
27.0,KIRPAL SINGH KAPURI,Independent,621,-,621,0.06,7 - Ludhiana (Punjab),19,7
28.0,SANTOSH KUMAR,Bharatiya Inqalab Party,610,-,610,0.06,7 - Ludhiana (Punjab),19,7
29.0,KAMAL PAWAR,Independent,592,-,592,0.06,7 - Ludhiana (Punjab),19,7
30.0,RAVINDER PAL SINGH BABA JI BARGAR WALE,Independent,546,2,548,0.05,7 - Ludhiana (Punjab),19,7
31.0,GURMEET SINGH KHARAY,Independent,516,1,517,0.05,7 - Ludhiana (Punjab),19,7
32.0,RUPINDER KUMAR,Independent,467,-,467,0.04,7 - Ludhiana (Punjab),19,7
33.0,CHANDI,Independent,456,-,456,0.04,7 - Ludhiana (Punjab),19,7
34.0,BALDEV SINGH SUMAN,Independent,450,-,450,0.04,7 - Ludhiana (Punjab),19,7
35.0,JAI - PARKASH JAIN (TITU BANIYA),Independent,419,-,419,0.04,7 - Ludhiana (Punjab),19,7
36.0,SHIVAM YADAV,Global Republican Party,414,1,415,0.04,7 - Ludhiana (Punjab),19,7
37.0,HARVINDER KAUR,Samajik Sangharsh Party,413,6,419,0.04,7 - Ludhiana (Punjab),19,7
38.0,BHOLA SINGH,Independent,411,-,411,0.04,7 - Ludhiana (Punjab),19,7
39.0,DARSHAN SINGH DABA,Nationalist Justice Party,390,-,390,0.04,7 - Ludhiana (Punjab),19,7
40.0,KULDEEP KUMAR SHARMA,Independent,383,-,383,0.04,7 - Ludhiana (Punjab),19,7
41.0,VISHAL KUMAR ARORA,Independent,344,-,344,0.03,7 - Ludhiana (Punjab),19,7
42.0,KARNAIL SINGH,Independent,340,-,340,0.03,7 - Ludhiana (Punjab),19,7
43.0,RAJINDER GHAI,Independent,284,-,284,0.03,7 - Ludhiana (Punjab),19,7
44.0,NOTA,None of the Above,5040,36,5076,0.48,7 - Ludhiana (Punjab),19,7
,Total,,1057219,1938,1059157,,7 - Ludhiana (Punjab),19,7
1.0,AMAR SINGH,Indian National Congress,331324,1267,332591,34.14,8 - Fatehgarh Sahib (Punjab),19,8
2.0,GURPREET SINGH GP,Aam Aadmi Party,297439,950,298389,30.63,8 - Fatehgarh Sahib (Punjab),19,8
3.0,GEJJA RAM,Bharatiya Janata Party,127139,382,127521,13.09,8 - Fatehgarh Sahib (Punjab),19,8
4.0,BIKRAMJIT SINGH KHALSA,Shiromani Akali Dal,126461,269,126730,13.01,8 - Fatehgarh Sahib (Punjab),19,8
5.0,RAJ JATINDER SINGH,Shiromani Akali Dal (Amritsar)(Simranjit Singh Mann),43543,101,43644,4.48,8 - Fatehgarh Sahib (Punjab),19,8
6.0,KULWANT SINGH,Bahujan Samaj Party,20786,106,20892,2.14,8 - Fatehgarh Sahib (Punjab),19,8
7.0,PREM SINGH MOHANPUR,Independent,3784,8,3792,0.39,8 - Fatehgarh Sahib (Punjab),19,8
8.0,BAHAL SINGH,Aazad Samaj Party (Kanshi Ram),3097,7,3104,0.32,8 - Fatehgarh Sahib (Punjab),19,8
9.0,PARAMJIT SINGH,Independent,2159,8,2167,0.22,8 - Fatehgarh Sahib (Punjab),19,8
10.0,RULDA SINGH,Independent,1971,6,1977,0.2,8 - Fatehgarh Sahib (Punjab),19,8
11.0,PARKASH PETER,Independent,1463,2,1465,0.15,8 - Fatehgarh Sahib (Punjab),19,8
12.0,HARJINDER SINGH,Independent,1158,8,1166,0.12,8 - Fatehgarh Sahib (Punjab),19,8
13.0,KAMALJEET KAUR,Independent,888,11,899,0.09,8 - Fatehgarh Sahib (Punjab),19,8
14.0,HARGOBIND SINGH,Independent,722,9,731,0.08,8 - Fatehgarh Sahib (Punjab),19,8
15.0,NOTA,None of the Above,9097,91,9188,0.94,8 - Fatehgarh Sahib (Punjab),19,8
,Total,,971031,3225,974256,,8 - Fatehgarh Sahib (Punjab),19,8
1.0,SARABJEET SINGH KHALSA,Independent,296922,1140,298062,29.38,9 - Faridkot (Punjab),19,9
2.0,KARAMJIT SINGH ANMOL,Aam Aadmi Party,226676,1333,228009,22.48,9 - Faridkot (Punjab),19,9
3.0,AMARJIT KAUR SAHOKE,Indian National Congress,159352,1005,160357,15.81,9 - Faridkot (Punjab),19,9
4.0,RAJWINDER SINGH DHARAMKOT,Shiromani Akali Dal,137776,475,138251,13.63,9 - Faridkot (Punjab),19,9
5.0,HANS RAJ HANS,Bharatiya Janata Party,123007,526,123533,12.18,9 - Faridkot (Punjab),19,9
6.0,GURCHARAN SINGH MANN,Communist Party of India,14935,15,14950,1.47,9 - Faridkot (Punjab),19,9
7.0,GURBAKSH SINGH CHAUHAN,Bahujan Samaj Party,8129,81,8210,0.81,9 - Faridkot (Punjab),19,9
8.0,AVTAR SINGH SAHOTA,Independent,4155,5,4160,0.41,9 - Faridkot (Punjab),19,9
9.0,KIKKAR SINGH DHALIWAL,Independent,3514,3,3517,0.35,9 - Faridkot (Punjab),19,9
10.0,KARAM SINGH MALUKA,Independent,2859,3,2862,0.28,9 - Faridkot (Punjab),19,9
11.0,RUPINDER SINGH KOHARWALA,Nationalist Justice Party,2672,5,2677,0.26,9 - Faridkot (Punjab),19,9
12.0,BALDEV SINGH GAGRA,Shiromani Akali Dal (Amritsar)(Simranjit Singh Mann),2367,28,2395,0.24,9 - Faridkot (Punjab),19,9
13.0,NIRMAL SINGH RAJEANA,Independent,2287,2,2289,0.23,9 - Faridkot (Punjab),19,9
14.0,BADAL SINGH BHALOOR,Bhartiya Rashtriya Dal,2027,1,2028,0.2,9 - Faridkot (Punjab),19,9
15.0,RAJ KUMAR CHAUHAN,Independent,1958,3,1961,0.19,9 - Faridkot (Punjab),19,9
16.0,OM PARKASH BANKA,Independent,1947,3,1950,0.19,9 - Faridkot (Punjab),19,9
17.0,CAPTAIN BAHADUR SINGH,Independent,1632,8,1640,0.16,9 - Faridkot (Punjab),19,9
18.0,MEJOR SINGH BHATTI,Jan Sewa Driver Party,1605,7,1612,0.16,9 - Faridkot (Punjab),19,9
19.0,SUKHBIR SINGH BABBAL BHATTI,Rashtriya Republican Party,1526,4,1530,0.15,9 - Faridkot (Punjab),19,9
20.0,GURMEET SINGH,Independent,1419,1,1420,0.14,9 - Faridkot (Punjab),19,9
21.0,AMRIK SINGH,Independent,1411,3,1414,0.14,9 - Faridkot (Punjab),19,9
22.0,MANPREET SHANT,Independent,1376,1,1377,0.14,9 - Faridkot (Punjab),19,9
23.0,PREM LAL,Democratic Bharatiya Samaj Party,1165,-,1165,0.11,9 - Faridkot (Punjab),19,9
24.0,PARGAT SINGH RAJEANA,Apna Samaj Party,1128,3,1131,0.11,9 - Faridkot (Punjab),19,9
25.0,JASWANT RAI RAJORA,Independent,1042,5,1047,0.1,9 - Faridkot (Punjab),19,9
26.0,DR DEV INDER GAGALANI,Republican Party of India,1035,5,1040,0.1,9 - Faridkot (Punjab),19,9
27.0,PRITAM SINGH,Bahujan Mukti Party,927,12,939,0.09,9 - Faridkot (Punjab),19,9
28.0,KULWANT KAUR,Sanjhi Virasat Party,785,1,786,0.08,9 - Faridkot (Punjab),19,9
29.0,NOTA,None of the Above,4077,66,4143,0.41,9 - Faridkot (Punjab),19,9
,Total,,1009711,4744,1014455,,9 - Faridkot (Punjab),19,9
1.0,SHER SINGH GHUBAYA,Indian National Congress,264712,1914,266626,23.7,10 - Firozpur (Punjab),19,10
2.0,JAGDEEP SINGH KAKA BRAR,Aam Aadmi Party,261273,2111,263384,23.41,10 - Firozpur (Punjab),19,10
3.0,GURMIT SINGH SODHI,Bharatiya Janata Party,253841,1256,255097,22.67,10 - Firozpur (Punjab),19,10
4.0,NARDEV SINGH BOBBY MANN,Shiromani Akali Dal,252327,1318,253645,22.54,10 - Firozpur (Punjab),19,10
5.0,GURCHARAN SINGH BHULLAR,Shiromani Akali Dal (Amritsar)(Simranjit Singh Mann),15836,105,15941,1.42,10 - Firozpur (Punjab),19,10
6.0,FOJI ANGREJ SINGH WARWAL,Independent,9435,43,9478,0.84,10 - Firozpur (Punjab),19,10
7.0,SURINDER KAMBOJ,Bahujan Samaj Party,8347,86,8433,0.75,10 - Firozpur (Punjab),19,10
8.0,JASKARAN SINGH KAHAN SINGH WALA,Independent,6480,55,6535,0.58,10 - Firozpur (Punjab),19,10
9.0,SUKHDEV SINGH,Independent,4597,2,4599,0.41,10 - Firozpur (Punjab),19,10
10.0,SAHIL MONGA,Independent,3705,19,3724,0.33,10 - Firozpur (Punjab),19,10
11.0,PRITAM SINGH,Independent,3030,1,3031,0.27,10 - Firozpur (Punjab),19,10
12.0,GURPREET SINGH,Independent,2894,3,2897,0.26,10 - Firozpur (Punjab),19,10
13.0,ARWINDER SINGH,Independent,2556,14,2570,0.23,10 - Firozpur (Punjab),19,10
14.0,DEEPAK KUMAR DEEP DASHANAND,Independent,2435,1,2436,0.22,10 - Firozpur (Punjab),19,10
15.0,RAJ,Independent,2428,4,2432,0.22,10 - Firozpur (Punjab),19,10
16.0,PREM CHAND BOONGI,Punjab National Party,1944,3,1947,0.17,10 - Firozpur (Punjab),19,10
17.0,AJIT SINGH,Rashtriya Republican Party,1609,6,1615,0.14,10 - Firozpur (Punjab),19,10
18.0,SURINDER KUMAR BANSAL,Independent,1537,3,1540,0.14,10 - Firozpur (Punjab),19,10
19.0,HARPREET SINGH,Independent,1531,7,1538,0.14,10 - Firozpur (Punjab),19,10
20.0,KULDEEP SINGH,India Praja Bandhu Party,1484,6,1490,0.13,10 - Firozpur (Punjab),19,10
21.0,BALWINDER SINGH CHOHAN,Jan Sewa Driver Party,1366,1,1367,0.12,10 - Firozpur (Punjab),19,10
22.0,BALWINDER SINGH,Republican Party of India (Athawale),1364,-,1364,0.12,10 - Firozpur (Punjab),19,10
23.0,GURCHARAN SINGH,Independent,1338,4,1342,0.12,10 - Firozpur (Punjab),19,10
24.0,UMESH KUMAR,Independent,1319,1,1320,0.12,10 - Firozpur (Punjab),19,10
25.0,BALWANT SINGH SAMMEWALI,Nationalist Justice Party,1148,4,1152,0.1,10 - Firozpur (Punjab),19,10
26.0,MOHAN SINGH,Independent,1075,3,1078,0.1,10 - Firozpur (Punjab),19,10
27.0,JASKARAN SINGH SIDHU,Independent,970,1,971,0.09,10 - Firozpur (Punjab),19,10
28.0,JASWANT SINGH KHATRI,Independent,820,1,821,0.07,10 - Firozpur (Punjab),19,10
29.0,CHAMKAUR SINGH,Independent,638,4,642,0.06,10 - Firozpur (Punjab),19,10
30.0,NOTA,None of the Above,5895,205,6100,0.54,10 - Firozpur (Punjab),19,10
,Total,,1117934,7181,1125115,,10 - Firozpur (Punjab),19,10
1.0,HARSIMRAT KAUR BADAL,Shiromani Akali Dal,375019,1539,376558,32.71,11 - Bathinda (Punjab),19,11
2.0,GURMEET SINGH KHUDIAN,Aam Aadmi Party,325019,1883,326902,28.4,11 - Bathinda (Punjab),19,11
3.0,JEETMOHINDER SINGH SIDHU,Indian National Congress,200859,1152,202011,17.55,11 - Bathinda (Punjab),19,11
4.0,PARAMPAL KAUR SIDHU,Bharatiya Janata Party,110255,507,110762,9.62,11 - Bathinda (Punjab),19,11
5.0,LAKHVIR SINGH LAKHA SIDHANA,Shiromani Akali Dal (Amritsar)(Simranjit Singh Mann),84222,462,84684,7.36,11 - Bathinda (Punjab),19,11
6.0,NIKKA SINGH,Bahujan Samaj Party,12979,60,13039,1.13,11 - Bathinda (Punjab),19,11
7.0,JAGJIWAN BALLI,Independent,5480,4,5484,0.48,11 - Bathinda (Punjab),19,11
8.0,PARWINDER SINGH,Independent,4494,3,4497,0.39,11 - Bathinda (Punjab),19,11
9.0,PALA RAM,Independent,3428,7,3435,0.3,11 - Bathinda (Punjab),19,11
10.0,BHAGWANT SINGH SAMAON,Independent,3372,16,3388,0.29,11 - Bathinda (Punjab),19,11
11.0,GURMEET SINGH,Independent,3072,10,3082,0.27,11 - Bathinda (Punjab),19,11
12.0,JASVIR SINGH BATHINDA,Aazad Samaj Party (Kanshi Ram),3039,106,3145,0.27,11 - Bathinda (Punjab),19,11
13.0,GURPREET SINGH URF PREET GHAINT,Jan Sewa Driver Party,2619,9,2628,0.23,11 - Bathinda (Punjab),19,11
14.0,GURBARN SINGH,Independent,1618,9,1627,0.14,11 - Bathinda (Punjab),19,11
15.0,NAIB SINGH,Bharatheeya Jawan Kisan Party,1593,8,1601,0.14,11 - Bathinda (Punjab),19,11
16.0,KULWANT SINGH,Independent,1172,10,1182,0.1,11 - Bathinda (Punjab),19,11
17.0,AMANDEEP SINGH,Independent,1146,2,1148,0.1,11 - Bathinda (Punjab),19,11
18.0,POONAM RANI,Nationalist Justice Party,1060,4,1064,0.09,11 - Bathinda (Punjab),19,11
19.0,NOTA,None of the Above,4818,115,4933,0.43,11 - Bathinda (Punjab),19,11
,Total,,1145264,5906,1151170,,11 - Bathinda (Punjab),19,11
1.0,GURMEET SINGH MEET HAYER,Aam Aadmi Party,362791,1294,364085,36.06,12 - Sangrur (Punjab),19,12
2.0,SUKHPAL SINGH KHAIRA,Indian National Congress,190209,1316,191525,18.97,12 - Sangrur (Punjab),19,12
3.0,SIMRANJIT SINGH MANN,Shiromani Akali Dal (Amritsar)(Simranjit Singh Mann),186543,703,187246,18.55,12 - Sangrur (Punjab),19,12
4.0,ARVIND KHANNA,Bharatiya Janata Party,127781,472,128253,12.7,12 - Sangrur (Punjab),19,12
5.0,IQBAL SINGH JHUNDAN,Shiromani Akali Dal,62265,223,62488,6.19,12 - Sangrur (Punjab),19,12
6.0,MAKHAN SINGH,Bahujan Samaj Party,37604,127,37731,3.74,12 - Sangrur (Punjab),19,12
7.0,PARDEEP KUMAR,Apni Ekta Party,5131,8,5139,0.51,12 - Sangrur (Punjab),19,12
8.0,HARBHAJAN SINGH,Aazad Samaj Party (Kanshi Ram),3417,14,3431,0.34,12 - Sangrur (Punjab),19,12
9.0,SUKHWINDER SINGH,Independent,3225,-,3225,0.32,12 - Sangrur (Punjab),19,12
10.0,BALWINDER SINGH SEKHON,Independent,2562,10,2572,0.25,12 - Sangrur (Punjab),19,12
11.0,BALWINDER SINGH,Independent,2284,4,2288,0.23,12 - Sangrur (Punjab),19,12
12.0,JASWANT SINGH,Independent,2222,2,2224,0.22,12 - Sangrur (Punjab),19,12
13.0,PAPPU KUMAR,Independent,1826,1,1827,0.18,12 - Sangrur (Punjab),19,12
14.0,KRISHAN DEV,Punjab National Party,1803,12,1815,0.18,12 - Sangrur (Punjab),19,12
15.0,AMANPREET SINGH,Independent,1686,7,1693,0.17,12 - Sangrur (Punjab),19,12
16.0,RANGI KHAN,Aam Janta Party (India),1578,3,1581,0.16,12 - Sangrur (Punjab),19,12
17.0,JILE SINGH,Bhartiya Jan Samman Party,1546,2,1548,0.15,12 - Sangrur (Punjab),19,12
18.0,KAMAL KUMAR VERMA (BHASAUR),"Adarsh Janta Party,",1376,-,1376,0.14,12 - Sangrur (Punjab),19,12
19.0,CHANNVEER SINGH,Independent,1281,2,1283,0.13,12 - Sangrur (Punjab),19,12
20.0,JAGTAR SINGH,Nationalist Justice Party,1224,1,1225,0.12,12 - Sangrur (Punjab),19,12
21.0,VIJAY SYAL,Independent,1144,1,1145,0.11,12 - Sangrur (Punjab),19,12
22.0,HARPREET KAUR,India Greens Party,1095,10,1105,0.11,12 - Sangrur (Punjab),19,12
23.0,RAJA SINGH,Independent,1037,3,1040,0.1,12 - Sangrur (Punjab),19,12
24.0,NOTA,None of the Above,3773,47,3820,0.38,12 - Sangrur (Punjab),19,12
,Total,,1005403,4262,1009665,,12 - Sangrur (Punjab),19,12
1.0,DR DHARAMVIRA GANDHI,Indian National Congress,304672,944,305616,26.54,13 - Patiala (Punjab),19,13
2.0,DR BALBIR SINGH,Aam Aadmi Party,290085,700,290785,25.25,13 - Patiala (Punjab),19,13
3.0,PRENEET KAUR,Bharatiya Janata Party,288470,528,288998,25.09,13 - Patiala (Punjab),19,13
4.0,N K SHARMA,Shiromani Akali Dal,153780,198,153978,13.37,13 - Patiala (Punjab),19,13
5.0,PROF MOHINDER PAL SINGH,Shiromani Akali Dal (Amritsar)(Simranjit Singh Mann),47152,122,47274,4.1,13 - Patiala (Punjab),19,13
6.0,JAGJIT SINGH CHHARBAR,Bahujan Samaj Party,22334,66,22400,1.94,13 - Patiala (Punjab),19,13
7.0,ARVINDER KUMAR,Independent,3808,4,3812,0.33,13 - Patiala (Punjab),19,13
8.0,JAGDISH KUMAR,Independent,3236,3,3239,0.28,13 - Patiala (Punjab),19,13
9.0,SUKHVINDER SINGH,Independent,2885,9,2894,0.25,13 - Patiala (Punjab),19,13
10.0,JODH SINGH PARMAR KAULI,Independent,2795,-,2795,0.24,13 - Patiala (Punjab),19,13
11.0,DEVINDER RAJPUT,Bharatheeya Jawan Kisan Party,2302,9,2311,0.2,13 - Patiala (Punjab),19,13
12.0,NEERAJ KUMAR NANNA,Independent,2299,3,2302,0.2,13 - Patiala (Punjab),19,13
13.0,PARAMJIT SINGH S/O TARLOCHAN SINGH,Independent,2264,3,2267,0.2,13 - Patiala (Punjab),19,13
14.0,AMARJIT SINGH JAGDE RAHO,Jan Janwadi Party,1981,11,1992,0.17,13 - Patiala (Punjab),19,13
15.0,RANJIT SINGH,Akhil Bhartiya Parivar Party,1964,3,1967,0.17,13 - Patiala (Punjab),19,13
16.0,GURBACHAN SINGH,Independent,1589,5,1594,0.14,13 - Patiala (Punjab),19,13
17.0,PARAMJIT SINGH S/O BHAGWAN SINGH,Independent,1565,4,1569,0.14,13 - Patiala (Punjab),19,13
18.0,VISHAL SHARMA,Independent,1474,1,1475,0.13,13 - Patiala (Punjab),19,13
19.0,LABH SINGH PAL,Independent,1443,-,1443,0.13,13 - Patiala (Punjab),19,13
20.0,CHAMKILA SINGH,Independent,1225,3,1228,0.11,13 - Patiala (Punjab),19,13
21.0,KRISHAN KUMAR GABA,Hindustan Shakti Sena,1000,8,1008,0.09,13 - Patiala (Punjab),19,13
22.0,MANDEEP SINGH,Revolutionary Socialist Party,970,3,973,0.08,13 - Patiala (Punjab),19,13
23.0,MAKHAN SINGH,Independent,904,3,907,0.08,13 - Patiala (Punjab),19,13
24.0,DIMPLE,Independent,846,4,850,0.07,13 - Patiala (Punjab),19,13
25.0,BINDER KAUR,Independent,707,4,711,0.06,13 - Patiala (Punjab),19,13
26.0,MANOJ KUMAR,Independent,674,-,674,0.06,13 - Patiala (Punjab),19,13
27.0,NOTA,None of the Above,6641,40,6681,0.58,13 - Patiala (Punjab),19,13
,Total,,1149065,2678,1151743,,13 - Patiala (Punjab),19,13
1.0,KULDEEP INDORA,Indian National Congress,719896,6596,726492,51.4,1 - GANGANAGAR (Rajasthan),20,1
2.0,PRIYANKA BALAN MEGHWAL,Bharatiya Janata Party,632097,6242,638339,45.16,1 - GANGANAGAR (Rajasthan),20,1
3.0,DEVKARAN NAYAK,Bahujan Samaj Party,16090,212,16302,1.15,1 - GANGANAGAR (Rajasthan),20,1
4.0,RAJKUMAR,Independent,4350,25,4375,0.31,1 - GANGANAGAR (Rajasthan),20,1
5.0,KULWANT KAUR,Indian Peoples Green Party,4338,24,4362,0.31,1 - GANGANAGAR (Rajasthan),20,1
6.0,DAYA RAM,Independent,3285,434,3719,0.26,1 - GANGANAGAR (Rajasthan),20,1
7.0,RAJENDER KUMAR,Bhartiya Jan Samman Party,2383,60,2443,0.17,1 - GANGANAGAR (Rajasthan),20,1
8.0,KANA RAM,Independent,2248,18,2266,0.16,1 - GANGANAGAR (Rajasthan),20,1
9.0,MAJOR SINGH,Jai Hind Congress Party,2075,26,2101,0.15,1 - GANGANAGAR (Rajasthan),20,1
10.0,NOTA,None of the Above,12940,155,13095,0.93,1 - GANGANAGAR (Rajasthan),20,1
,Total,,1399702,13792,1413494,,1 - GANGANAGAR (Rajasthan),20,1
1.0,ARJUN RAM MEGHWAL,Bharatiya Janata Party,561240,5497,566737,50.68,2 - BIKANER (Rajasthan),20,2
2.0,GOVINDRAM MEGHWAL,Indian National Congress,506966,4060,511026,45.7,2 - BIKANER (Rajasthan),20,2
3.0,KHETA RAM,Bahujan Samaj Party,8249,50,8299,0.74,2 - BIKANER (Rajasthan),20,2
4.0,ATMA RAM GUJARATI,Independent,6267,14,6281,0.56,2 - BIKANER (Rajasthan),20,2
5.0,RATANI DEVI,Independent,3894,32,3926,0.35,2 - BIKANER (Rajasthan),20,2
6.0,SATYANARAYAN DEVRA,Independent,2958,8,2966,0.27,2 - BIKANER (Rajasthan),20,2
7.0,PUKHRAJ NAYAK,Independent,2621,54,2675,0.24,2 - BIKANER (Rajasthan),20,2
8.0,BABU LAL,Independent,2010,9,2019,0.18,2 - BIKANER (Rajasthan),20,2
9.0,GOPI CHAND MEGHWAL,Independent,1787,8,1795,0.16,2 - BIKANER (Rajasthan),20,2
10.0,NOTA,None of the Above,12431,127,12558,1.12,2 - BIKANER (Rajasthan),20,2
,Total,,1108423,9859,1118282,,2 - BIKANER (Rajasthan),20,2
1.0,RAHUL KASWAN,Indian National Congress,719352,8859,728211,51.12,3 - CHURU (Rajasthan),20,3
2.0,DEVENDRA JHAJHARIA,Bharatiya Janata Party,647891,7583,655474,46.01,3 - CHURU (Rajasthan),20,3
3.0,DEIRAM MEGHWAL,Bahujan Samaj Party,11145,126,11271,0.79,3 - CHURU (Rajasthan),20,3
4.0,RAMESH KUMAR,Independent,5720,4,5724,0.4,3 - CHURU (Rajasthan),20,3
5.0,GOMATI DHARAMPAL KATARIA,Bharat Rakshak Party (Democratic),4937,24,4961,0.35,3 - CHURU (Rajasthan),20,3
6.0,SUKHDEV,Independent,4550,9,4559,0.32,3 - CHURU (Rajasthan),20,3
7.0,RANVEER SINGH,Independent,1809,3,1812,0.13,3 - CHURU (Rajasthan),20,3
8.0,BISAN SINGH,Independent,1571,73,1644,0.12,3 - CHURU (Rajasthan),20,3
9.0,DAULAT RAM PENSIA,National Janmandal Party,1178,15,1193,0.08,3 - CHURU (Rajasthan),20,3
10.0,YUSUF ALI KHAN,Independent,1176,54,1230,0.09,3 - CHURU (Rajasthan),20,3
11.0,SHISHPAL SINGH RANA,Bheem Tribal Congress,671,4,675,0.05,3 - CHURU (Rajasthan),20,3
12.0,NIRANJAN SINGH RATHORE,Independent,648,20,668,0.05,3 - CHURU (Rajasthan),20,3
13.0,ASLAM LILGAR,Independent,558,9,567,0.04,3 - CHURU (Rajasthan),20,3
14.0,NOTA,None of the Above,6583,73,6656,0.47,3 - CHURU (Rajasthan),20,3
,Total,,1407789,16856,1424645,,3 - CHURU (Rajasthan),20,3
1.0,BRIJENDRA SINGH OLA,Indian National Congress,541203,11965,553168,49.44,4 - JHUNJHUNU (Rajasthan),20,4
2.0,SHUBHKARAN CHOUDHARY,Bharatiya Janata Party,523669,11264,534933,47.81,4 - JHUNJHUNU (Rajasthan),20,4
3.0,SHEKHAWAT RAJENDRA SINGH,Independent,7389,301,7690,0.69,4 - JHUNJHUNU (Rajasthan),20,4
4.0,BANSHIDHAR,Bahujan Samaj Party,6679,188,6867,0.61,4 - JHUNJHUNU (Rajasthan),20,4
5.0,DURGA PRASAD MEENA,Ambedkarite Party of India,5440,57,5497,0.49,4 - JHUNJHUNU (Rajasthan),20,4
6.0,ALTIF,Independent,2025,25,2050,0.18,4 - JHUNJHUNU (Rajasthan),20,4
7.0,SATYANARAYAN,Bheem Tribal Congress,1127,23,1150,0.1,4 - JHUNJHUNU (Rajasthan),20,4
8.0,HAZARI LAL,Bahujan Kranti Party (Marxwad-Ambedkarwad),922,18,940,0.08,4 - JHUNJHUNU (Rajasthan),20,4
9.0,NOTA,None of the Above,6454,178,6632,0.59,4 - JHUNJHUNU (Rajasthan),20,4
,Total,,1094908,24019,1118927,,4 - JHUNJHUNU (Rajasthan),20,4
1.0,AMRARAM,Communist Party of India (Marxist),645559,13741,659300,50.68,5 - SIKAR (Rajasthan),20,5
2.0,SUMEDHANAND SARASWATI,Bharatiya Janata Party,574740,11664,586404,45.08,5 - SIKAR (Rajasthan),20,5
3.0,SURESH PAREEK,Independent,10014,7,10021,0.77,5 - SIKAR (Rajasthan),20,5
4.0,AMARCHAND,Bahujan Samaj Party,8293,326,8619,0.66,5 - SIKAR (Rajasthan),20,5
5.0,VISHNU KUMAR NATRAJ,Independent,5796,7,5803,0.45,5 - SIKAR (Rajasthan),20,5
6.0,RAVINDRA SINGH SHEKHAWAT,Independent,5775,250,6025,0.46,5 - SIKAR (Rajasthan),20,5
7.0,ASHOK SEHRA,Ambedkarite Party of India,5333,49,5382,0.41,5 - SIKAR (Rajasthan),20,5
8.0,DHIRENDRA VERMA,Ummeed Party of India,2885,59,2944,0.23,5 - SIKAR (Rajasthan),20,5
9.0,MAHESH KUMAR,Independent,1962,94,2056,0.16,5 - SIKAR (Rajasthan),20,5
10.0,BENI PRASAD KAUSHIK (LATA),Rashtriya Sawarn Dal,1720,11,1731,0.13,5 - SIKAR (Rajasthan),20,5
11.0,RAMESH SHARMA,Bhartiya Party,1516,33,1549,0.12,5 - SIKAR (Rajasthan),20,5
12.0,VIJENDER MAHARIA,Bharatiya Yuva Jan Ekta Party,1421,30,1451,0.11,5 - SIKAR (Rajasthan),20,5
13.0,OM PRAKASH,Independent,1182,42,1224,0.09,5 - SIKAR (Rajasthan),20,5
14.0,BIRBALSINGH,Independent,1034,47,1081,0.08,5 - SIKAR (Rajasthan),20,5
15.0,NOTA,None of the Above,7081,185,7266,0.56,5 - SIKAR (Rajasthan),20,5
,Total,,1274311,26545,1300856,,5 - SIKAR (Rajasthan),20,5
1.0,RAO RAJENDRA SINGH,Bharatiya Janata Party,608189,9688,617877,48.96,6 - JAIPUR RURAL (Rajasthan),20,6
2.0,ANIL CHOPRA,Indian National Congress,602293,13969,616262,48.83,6 - JAIPUR RURAL (Rajasthan),20,6
3.0,HANUMAN SAHAY,Bahujan Samaj Party,3773,77,3850,0.31,6 - JAIPUR RURAL (Rajasthan),20,6
4.0,RAMSINGH KASANA,Independent,3701,6,3707,0.29,6 - JAIPUR RURAL (Rajasthan),20,6
5.0,DR DASHRATH HINUNIA,Ambedkarite Party of India,2669,12,2681,0.21,6 - JAIPUR RURAL (Rajasthan),20,6
6.0,KAHANVI BOHRA,Independent,1658,53,1711,0.14,6 - JAIPUR RURAL (Rajasthan),20,6
7.0,DR RAM ROOP MEENA ADVOCATE,Independent,1589,15,1604,0.13,6 - JAIPUR RURAL (Rajasthan),20,6
8.0,NEHA SINGH GURJAR,Independent,1378,29,1407,0.11,6 - JAIPUR RURAL (Rajasthan),20,6
9.0,PRAKASH KUMAR SHARMA,Independent,1033,7,1040,0.08,6 - JAIPUR RURAL (Rajasthan),20,6
10.0,AJAY BHAT,Republican Party of India (A),931,17,948,0.08,6 - JAIPUR RURAL (Rajasthan),20,6
11.0,DEVHANS,Independent,924,17,941,0.07,6 - JAIPUR RURAL (Rajasthan),20,6
12.0,DR OM SINGH MEENA SEHARA,Independent,676,58,734,0.06,6 - JAIPUR RURAL (Rajasthan),20,6
13.0,ADITYA PRAKASH SHARMA,Right to Recall Party,650,16,666,0.05,6 - JAIPUR RURAL (Rajasthan),20,6
14.0,YOGI JEETENDRA NATH ADVOCATE,Rashtriya Sawarn Dal,556,6,562,0.04,6 - JAIPUR RURAL (Rajasthan),20,6
15.0,ADVOCATE HARI KISHAN TIWARI,Bheem Tribal Congress,541,4,545,0.04,6 - JAIPUR RURAL (Rajasthan),20,6
16.0,NOTA,None of the Above,7405,114,7519,0.6,6 - JAIPUR RURAL (Rajasthan),20,6
,Total,,1237966,24088,1262054,,6 - JAIPUR RURAL (Rajasthan),20,6
1.0,MANJU SHARMA,Bharatiya Janata Party,878643,8207,886850,60.61,7 - JAIPUR (Rajasthan),20,7
2.0,PRATAP SINGH KHACHARIYAWAS,Indian National Congress,549424,5659,555083,37.93,7 - JAIPUR (Rajasthan),20,7
3.0,RAJESH TANWAR,Bahujan Samaj Party,3420,41,3461,0.24,7 - JAIPUR (Rajasthan),20,7
4.0,HARI NARAYAN MEENA,Independent,2193,9,2202,0.15,7 - JAIPUR (Rajasthan),20,7
5.0,RAJEEV ROLIWAL,Independent,962,8,970,0.07,7 - JAIPUR (Rajasthan),20,7
6.0,YOGESH SHARMA,Independent,811,5,816,0.06,7 - JAIPUR (Rajasthan),20,7
7.0,NARENDER SHARMA,Rashtriya Sanatan Party,665,4,669,0.05,7 - JAIPUR (Rajasthan),20,7
8.0,KULDEEP SINGH,Socialist Unity Centre Of India (COMMUNIST),605,10,615,0.04,7 - JAIPUR (Rajasthan),20,7
9.0,DR. ASEEM VERMA,Independent,562,10,572,0.04,7 - JAIPUR (Rajasthan),20,7
10.0,PRADEEP VERMA,Indian Peoples Green Party,445,3,448,0.03,7 - JAIPUR (Rajasthan),20,7
11.0,ADVOCATE HARI KISHAN TIWARI,Bheem Tribal Congress,384,16,400,0.03,7 - JAIPUR (Rajasthan),20,7
12.0,SHASHANK SINGH ARYA,Right to Recall Party,372,21,393,0.03,7 - JAIPUR (Rajasthan),20,7
13.0,TRILOK TIWARI,Rashtriya Samta Vikas Party,344,7,351,0.02,7 - JAIPUR (Rajasthan),20,7
14.0,NOTA,None of the Above,10280,148,10428,0.71,7 - JAIPUR (Rajasthan),20,7
,Total,,1449110,14148,1463258,,7 - JAIPUR (Rajasthan),20,7
1.0,BHUPENDER YADAV,Bharatiya Janata Party,624110,7882,631992,50.42,8 - ALWAR (Rajasthan),20,8
2.0,LALIT YADAV,Indian National Congress,575964,7746,583710,46.57,8 - ALWAR (Rajasthan),20,8
3.0,FAZAL HUSSAIN,Bahujan Samaj Party,19178,109,19287,1.54,8 - ALWAR (Rajasthan),20,8
4.0,PARDEEP KUMAR,Sarv Samaj Party,4339,23,4362,0.35,8 - ALWAR (Rajasthan),20,8
5.0,VIVEK JAIN,Independent,2429,9,2438,0.19,8 - ALWAR (Rajasthan),20,8
6.0,RAMBABU SHARMA,Independent,2207,25,2232,0.18,8 - ALWAR (Rajasthan),20,8
7.0,AMIT GUPTA,Independent,1366,23,1389,0.11,8 - ALWAR (Rajasthan),20,8
8.0,CHHAGAN LAL,Independent,1291,36,1327,0.11,8 - ALWAR (Rajasthan),20,8
9.0,VISHVNATH KHINCHI,Hindustan Janta Party,862,17,879,0.07,8 - ALWAR (Rajasthan),20,8
10.0,NOTA,None of the Above,5727,95,5822,0.46,8 - ALWAR (Rajasthan),20,8
,Total,,1237473,15965,1253438,,8 - ALWAR (Rajasthan),20,8
1.0,SANJNA JATAV,Indian National Congress,572808,7082,579890,51.18,9 - BHARATPUR (Rajasthan),20,9
2.0,RAMSWAROOP KOLI,Bharatiya Janata Party,519269,8638,527907,46.59,9 - BHARATPUR (Rajasthan),20,9
3.0,ANJILA JATAV,Bahujan Samaj Party,9298,210,9508,0.84,9 - BHARATPUR (Rajasthan),20,9
4.0,ANEETA,Independent,5027,92,5119,0.45,9 - BHARATPUR (Rajasthan),20,9
5.0,PURUSHOTTAM LAL,Independent,2730,17,2747,0.24,9 - BHARATPUR (Rajasthan),20,9
6.0,PUSHPENDAR KUMAR,Independent,2374,12,2386,0.21,9 - BHARATPUR (Rajasthan),20,9
7.0,NOTA,None of the Above,5344,99,5443,0.48,9 - BHARATPUR (Rajasthan),20,9
,Total,,1116850,16150,1133000,,9 - BHARATPUR (Rajasthan),20,9
1.0,BHAJAN LAL JATAV,Indian National Congress,525379,4632,530011,53.64,10 - KARAULI-DHOLPUR (Rajasthan),20,10
2.0,INDU DEVI,Bharatiya Janata Party,426798,4268,431066,43.62,10 - KARAULI-DHOLPUR (Rajasthan),20,10
3.0,VIKRAM SINGH,Bahujan Samaj Party,14005,107,14112,1.43,10 - KARAULI-DHOLPUR (Rajasthan),20,10
4.0,RAMKHILADI DHOVI,Independent,5426,47,5473,0.55,10 - KARAULI-DHOLPUR (Rajasthan),20,10
5.0,NOTA,None of the Above,7402,58,7460,0.75,10 - KARAULI-DHOLPUR (Rajasthan),20,10
,Total,,979010,9112,988122,,10 - KARAULI-DHOLPUR (Rajasthan),20,10
1.0,MURARI LAL MEENA,Indian National Congress,636868,9398,646266,60.24,11 - DAUSA (Rajasthan),20,11
2.0,KANHAIYA LAL MEENA,Bharatiya Janata Party,404309,4617,408926,38.12,11 - DAUSA (Rajasthan),20,11
3.0,SONU DHANKA,Bahujan Samaj Party,6752,45,6797,0.63,11 - DAUSA (Rajasthan),20,11
4.0,"DR. RAM ROOP MEENA, ADVOCATE",Independent,2701,20,2721,0.25,11 - DAUSA (Rajasthan),20,11
5.0,MOHAN LAL MEENA,Independent,2164,14,2178,0.2,11 - DAUSA (Rajasthan),20,11
6.0,NOTA,None of the Above,5789,57,5846,0.54,11 - DAUSA (Rajasthan),20,11
,Total,,1058583,14151,1072734,,11 - DAUSA (Rajasthan),20,11
1.0,HARISH CHANDRA MEENA,Indian National Congress,617137,6626,623763,50.85,12 - TONK-SAWAI MADHOPUR (Rajasthan),20,12
2.0,SUKHBIR SINGH JAUNAPURIA,Bharatiya Janata Party,553309,5505,558814,45.56,12 - TONK-SAWAI MADHOPUR (Rajasthan),20,12
3.0,PRAHALAD MALI,Bahujan Samaj Party,13089,55,13144,1.07,12 - TONK-SAWAI MADHOPUR (Rajasthan),20,12
4.0,GANESH MEENA,Indian Peoples Green Party,7425,8,7433,0.61,12 - TONK-SAWAI MADHOPUR (Rajasthan),20,12
5.0,MAKHAN LAL MEENA,Independent,3314,10,3324,0.27,12 - TONK-SAWAI MADHOPUR (Rajasthan),20,12
6.0,JASRAM MEENA,Independent,3044,1,3045,0.25,12 - TONK-SAWAI MADHOPUR (Rajasthan),20,12
7.0,VIJENDRA,Aazad Samaj Party (Kanshi Ram),2669,28,2697,0.22,12 - TONK-SAWAI MADHOPUR (Rajasthan),20,12
8.0,GIRRAJ PRASAD MEENA,Independent,2512,9,2521,0.21,12 - TONK-SAWAI MADHOPUR (Rajasthan),20,12
9.0,JAGDISH PRASAD MEENA,Bharat Adivasi Party,1366,7,1373,0.11,12 - TONK-SAWAI MADHOPUR (Rajasthan),20,12
10.0,DULI CHAND SAINI,Rajasthan Raj Party,1253,11,1264,0.1,12 - TONK-SAWAI MADHOPUR (Rajasthan),20,12
11.0,JAGDISH PRASAD SHARMA,Bheem Tribal Congress,1023,6,1029,0.08,12 - TONK-SAWAI MADHOPUR (Rajasthan),20,12
12.0,NOTA,None of the Above,8105,72,8177,0.67,12 - TONK-SAWAI MADHOPUR (Rajasthan),20,12
,Total,,1214246,12338,1226584,,12 - TONK-SAWAI MADHOPUR (Rajasthan),20,12
1.0,BHAGIRATH CHOUDHARY,Bharatiya Janata Party,741151,6311,747462,62.23,13 - AJMER (Rajasthan),20,13
2.0,RAMCHANDRA CHOUDHARY,Indian National Congress,413685,3786,417471,34.76,13 - AJMER (Rajasthan),20,13
3.0,RAMDEV,Bahujan Samaj Party,4896,48,4944,0.41,13 - AJMER (Rajasthan),20,13
4.0,SURENDRA SINGH RANAVAT,Independent,4348,25,4373,0.36,13 - AJMER (Rajasthan),20,13
5.0,MUKESH GENA,Bharatiya Yuva Jan Ekta Party,3187,9,3196,0.27,13 - AJMER (Rajasthan),20,13
6.0,JITENDRA BOYAT,Aazad Samaj Party (Kanshi Ram),2608,25,2633,0.22,13 - AJMER (Rajasthan),20,13
7.0,SATYANARAYAN MALI,Independent,2409,11,2420,0.2,13 - AJMER (Rajasthan),20,13
8.0,VISHRAM BABU,Independent,1517,7,1524,0.13,13 - AJMER (Rajasthan),20,13
9.0,SHABUDADIN,National Future Party,1190,7,1197,0.1,13 - AJMER (Rajasthan),20,13
10.0,YUSUF,Independent,988,12,1000,0.08,13 - AJMER (Rajasthan),20,13
11.0,PREM LATA,Independent,988,167,1155,0.1,13 - AJMER (Rajasthan),20,13
12.0,BHAWARLAL SONI,Independent,868,70,938,0.08,13 - AJMER (Rajasthan),20,13
13.0,RAMLAL,Akhil Bhartiya Aamjan Party,807,11,818,0.07,13 - AJMER (Rajasthan),20,13
14.0,DAYA MOHAN GARG,Independent,644,2,646,0.05,13 - AJMER (Rajasthan),20,13
15.0,NOTA,None of the Above,11290,112,11402,0.95,13 - AJMER (Rajasthan),20,13
,Total,,1190576,10603,1201179,,13 - AJMER (Rajasthan),20,13
1.0,HANUMAN BENIWAL,Rashtriya Loktantrik Party,591460,5495,596955,48.2,14 - NAGAUR (Rajasthan),20,14
2.0,JYOTI MIRDHA,Bharatiya Janata Party,550304,4426,554730,44.79,14 - NAGAUR (Rajasthan),20,14
3.0,DR ASHOK CHOUDHARY,Abhinav Rajasthan Party,26251,43,26294,2.12,14 - NAGAUR (Rajasthan),20,14
4.0,DR. GAJENDRA SINGH RATHORE,Bahujan Samaj Party,23551,457,24008,1.94,14 - NAGAUR (Rajasthan),20,14
5.0,RAJKUMAR JAT,Independent,8219,13,8232,0.66,14 - NAGAUR (Rajasthan),20,14
6.0,HARI RAM,Independent,7610,16,7626,0.62,14 - NAGAUR (Rajasthan),20,14
7.0,PREMRAJ KHARDIYA,Independent,4504,8,4512,0.36,14 - NAGAUR (Rajasthan),20,14
8.0,AMEEN KHAN,Independent,4439,24,4463,0.36,14 - NAGAUR (Rajasthan),20,14
9.0,HANUMAN SINGH KALVI,Rashtriya Janshakti Party (Secular),2862,20,2882,0.23,14 - NAGAUR (Rajasthan),20,14
10.0,NOTA,None of the Above,8711,60,8771,0.71,14 - NAGAUR (Rajasthan),20,14
,Total,,1227911,10562,1238473,,14 - NAGAUR (Rajasthan),20,14
1.0,P. P. CHAUDHARY,Bharatiya Janata Party,750568,6821,757389,55.94,15 - PALI (Rajasthan),20,15
2.0,SANGEETA BENIWAL,Indian National Congress,505754,6284,512038,37.82,15 - PALI (Rajasthan),20,15
3.0,LAL SINGH DEWASI,Independent,18848,154,19002,1.4,15 - PALI (Rajasthan),20,15
4.0,HUKAM SINGH,Independent,16835,262,17097,1.26,15 - PALI (Rajasthan),20,15
5.0,MAHENDRA REGAR,Bahujan Samaj Party,11054,47,11101,0.82,15 - PALI (Rajasthan),20,15
6.0,JEEVARAM RANA,Bharat Adivasi Party,8325,22,8347,0.62,15 - PALI (Rajasthan),20,15
7.0,SHRAWAN RAM DEWASI,Independent,5585,8,5593,0.41,15 - PALI (Rajasthan),20,15
8.0,MUKESH SAINI,Independent,2471,52,2523,0.19,15 - PALI (Rajasthan),20,15
9.0,BASTIRAM,Indian Peoples Green Party,1570,16,1586,0.12,15 - PALI (Rajasthan),20,15
10.0,BHIYARAM,Independent,1335,10,1345,0.1,15 - PALI (Rajasthan),20,15
11.0,ANAND KUMAR PARIHAR,Independent,1327,8,1335,0.1,15 - PALI (Rajasthan),20,15
12.0,KESARAM,Independent,1327,18,1345,0.1,15 - PALI (Rajasthan),20,15
13.0,DEEPAK BAMNIYA,Independent,1256,32,1288,0.1,15 - PALI (Rajasthan),20,15
14.0,NOTA,None of the Above,13763,90,13853,1.02,15 - PALI (Rajasthan),20,15
,Total,,1340018,13824,1353842,,15 - PALI (Rajasthan),20,15
1.0,GAJENDRA SINGH SHEKHAWAT,Bharatiya Janata Party,722978,7078,730056,52.76,16 - JODHPUR (Rajasthan),20,16
2.0,KARAN SINGH UCHIYARDA,Indian National Congress,608228,6151,614379,44.4,16 - JODHPUR (Rajasthan),20,16
3.0,SUNIL KUMAR PAREEK,Independent,7424,5,7429,0.54,16 - JODHPUR (Rajasthan),20,16
4.0,MANJU MEGHWAL,Bahujan Samaj Party,6347,48,6395,0.46,16 - JODHPUR (Rajasthan),20,16
5.0,ANANDARAM URF ANAND CHAUHAN,Aazad Samaj Party (Kanshi Ram),3662,18,3680,0.27,16 - JODHPUR (Rajasthan),20,16
6.0,SUNIL BHANDARI,Independent,3236,2,3238,0.23,16 - JODHPUR (Rajasthan),20,16
7.0,VISHEK VISHNOI,Independent,1718,32,1750,0.13,16 - JODHPUR (Rajasthan),20,16
8.0,SHIVA RAM,Independent,1191,4,1195,0.09,16 - JODHPUR (Rajasthan),20,16
9.0,LIKHAMA RAM,Independent,1123,2,1125,0.08,16 - JODHPUR (Rajasthan),20,16
10.0,NARESH KANDARA,Independent,1007,20,1027,0.07,16 - JODHPUR (Rajasthan),20,16
11.0,SATYANARAYAN,Bharatiya Sampuran Krantikari Party,776,6,782,0.06,16 - JODHPUR (Rajasthan),20,16
12.0,PAPPU DAN,Right to Recall Party,650,4,654,0.05,16 - JODHPUR (Rajasthan),20,16
13.0,SHAHNAZ BANO,Dalit Kranti Dal,546,1,547,0.04,16 - JODHPUR (Rajasthan),20,16
14.0,RAM DAYAL BISHNOI,Rashtriya Janshakti Party (Secular),491,12,503,0.04,16 - JODHPUR (Rajasthan),20,16
15.0,BHOM SINGH,Indian Peoples Green Party,483,4,487,0.04,16 - JODHPUR (Rajasthan),20,16
16.0,NOTA,None of the Above,10511,80,10591,0.77,16 - JODHPUR (Rajasthan),20,16
,Total,,1370371,13467,1383838,,16 - JODHPUR (Rajasthan),20,16
1.0,UMMEDA RAM BENIWAL,Indian National Congress,699122,5554,704676,41.74,17 - BARMER (Rajasthan),20,17
2.0,RAVINDRA SINGH BHATI,Independent,581865,4635,586500,34.74,17 - BARMER (Rajasthan),20,17
3.0,KAILASH CHOUDHARY,Bharatiya Janata Party,284527,2206,286733,16.99,17 - BARMER (Rajasthan),20,17
4.0,TARARAM MEHNA,Independent,49768,189,49957,2.96,17 - BARMER (Rajasthan),20,17
5.0,PRATAPA RAM,Independent,8282,36,8318,0.49,17 - BARMER (Rajasthan),20,17
6.0,HANIPH,Independent,7755,5,7760,0.46,17 - BARMER (Rajasthan),20,17
7.0,LEELA RAM,Bahujan Samaj Party,7557,28,7585,0.45,17 - BARMER (Rajasthan),20,17
8.0,PRABHU RAM,Aazad Samaj Party (Kanshi Ram),6381,15,6396,0.38,17 - BARMER (Rajasthan),20,17
9.0,RAMA RAM,Independent,6031,10,6041,0.36,17 - BARMER (Rajasthan),20,17
10.0,POPAT LAL,Independent,3117,42,3159,0.19,17 - BARMER (Rajasthan),20,17
11.0,DEVILAL JAIN,Independent,3016,7,3023,0.18,17 - BARMER (Rajasthan),20,17
12.0,NOTA,None of the Above,17893,10,17903,1.06,17 - BARMER (Rajasthan),20,17
,Total,,1675314,12737,1688051,,17 - BARMER (Rajasthan),20,17
1.0,LUMBARAM,Bharatiya Janata Party,793705,3078,796783,54.91,18 - JALORE (Rajasthan),20,18
2.0,VAIBHAV GEHLOT,Indian National Congress,592204,3036,595240,41.02,18 - JALORE (Rajasthan),20,18
3.0,OTARAM,Bharat Adivasi Party,10077,32,10109,0.7,18 - JALORE (Rajasthan),20,18
4.0,SHAKUR,Independent,9866,6,9872,0.68,18 - JALORE (Rajasthan),20,18
5.0,MOTI LAL,Aazad Samaj Party (Kanshi Ram),4579,7,4586,0.32,18 - JALORE (Rajasthan),20,18
6.0,RAMESH KUMAR BHANDARI,Independent,3909,1,3910,0.27,18 - JALORE (Rajasthan),20,18
7.0,DEVARAM,Independent,3126,8,3134,0.22,18 - JALORE (Rajasthan),20,18
8.0,KALURAM MEGHWAL,Independent,2258,5,2263,0.16,18 - JALORE (Rajasthan),20,18
9.0,DINESH SINGH,Independent,2094,11,2105,0.15,18 - JALORE (Rajasthan),20,18
10.0,TIKMA RAM BHATI,Bheem Tribal Congress,1653,7,1660,0.11,18 - JALORE (Rajasthan),20,18
11.0,DALARAM,Independent,1493,15,1508,0.1,18 - JALORE (Rajasthan),20,18
12.0,FOJARAM,Indian Peoples Green Party,1493,4,1497,0.1,18 - JALORE (Rajasthan),20,18
13.0,NOTA,None of the Above,18439,20,18459,1.27,18 - JALORE (Rajasthan),20,18
,Total,,1444896,6230,1451126,,18 - JALORE (Rajasthan),20,18
1.0,MANNA LAL RAWAT,Bharatiya Janata Party,732757,5529,738286,49.27,19 - UDAIPUR (Rajasthan),20,19
2.0,TARACHAND MEENA,Indian National Congress,473167,3511,476678,31.81,19 - UDAIPUR (Rajasthan),20,19
3.0,PRAKASH CHAND,Bharat Adivasi Party,215390,1748,217138,14.49,19 - UDAIPUR (Rajasthan),20,19
4.0,DALPAT RAM GARASIA,Bahujan Samaj Party,14427,33,14460,0.97,19 - UDAIPUR (Rajasthan),20,19
5.0,DR. SAVITA KUMARI AHARI,Independent,8130,32,8162,0.54,19 - UDAIPUR (Rajasthan),20,19
6.0,PRABHULAL MEENA,Independent,7972,24,7996,0.53,19 - UDAIPUR (Rajasthan),20,19
7.0,RAJENDRA KUMAR MEENA,Indian Peoples Green Party,6752,25,6777,0.45,19 - UDAIPUR (Rajasthan),20,19
8.0,KANJI LAL DAMOR,Independent,5912,19,5931,0.4,19 - UDAIPUR (Rajasthan),20,19
9.0,NOTA,None of the Above,22848,100,22948,1.53,19 - UDAIPUR (Rajasthan),20,19
,Total,,1487355,11021,1498376,,19 - UDAIPUR (Rajasthan),20,19
1.0,RAJ KUMAR ROAT,Bharat Adivasi Party,815430,5401,820831,50.15,20 - BANSWARA (Rajasthan),20,20
2.0,MAHENDRAJEETSINGH MALVIYA,Bharatiya Janata Party,568589,5188,573777,35.05,20 - BANSWARA (Rajasthan),20,20
3.0,RAJKUMAR S/O HIRALAL,Independent,74551,47,74598,4.56,20 - BANSWARA (Rajasthan),20,20
4.0,ARVIND SITA DAMOR,Indian National Congress,60917,294,61211,3.74,20 - BANSWARA (Rajasthan),20,20
5.0,RAJKUMAR S/O PREMJI,Independent,41742,48,41790,2.55,20 - BANSWARA (Rajasthan),20,20
6.0,BANSHILAL AHARI,Independent,17884,12,17896,1.09,20 - BANSWARA (Rajasthan),20,20
7.0,SHANKARLAL BAMANIYA,Indian Peoples Green Party,17169,19,17188,1.05,20 - BANSWARA (Rajasthan),20,20
8.0,DILEEP KUMAR MEENA,Bahujan Samaj Party,8573,18,8591,0.52,20 - BANSWARA (Rajasthan),20,20
9.0,NOTA,None of the Above,20892,78,20970,1.28,20 - BANSWARA (Rajasthan),20,20
,Total,,1625747,11105,1636852,,20 - BANSWARA (Rajasthan),20,20
1.0,CHANDRA PRAKASH JOSHI,Bharatiya Janata Party,882334,5868,888202,59.26,21 - CHITTORGARH (Rajasthan),20,21
2.0,ANJANA UDAILAL,Indian National Congress,495177,3148,498325,33.25,21 - CHITTORGARH (Rajasthan),20,21
3.0,BHIL ADIVASI MANGILAL NANAMA,Bharat Adivasi Party,42243,568,42811,2.86,21 - CHITTORGARH (Rajasthan),20,21
4.0,RAMESHWAR LAL BAIRWA (INDORA),Independent,9536,3,9539,0.64,21 - CHITTORGARH (Rajasthan),20,21
5.0,KUMAWAT RAMESH CHANDRA,Independent,8834,8,8842,0.59,21 - CHITTORGARH (Rajasthan),20,21
6.0,MEGHWAL RADHESHYAM,Bahujan Samaj Party,8578,35,8613,0.57,21 - CHITTORGARH (Rajasthan),20,21
7.0,SHYAM LAL MEGHWAL,Independent,7901,6,7907,0.53,21 - CHITTORGARH (Rajasthan),20,21
8.0,BAPU LAL ANJANA,Independent,7837,9,7846,0.52,21 - CHITTORGARH (Rajasthan),20,21
9.0,PRAKASH DHAKAR,Ekam Sanatan Bharat Dal,3915,10,3925,0.26,21 - CHITTORGARH (Rajasthan),20,21
10.0,PRATAP SINGH,Independent,3342,5,3347,0.22,21 - CHITTORGARH (Rajasthan),20,21
11.0,AZAD PRAKASH CHANDRA MEGHWAL,Akhil Bharatiya Congress Dal (Ambedkar),2764,13,2777,0.19,21 - CHITTORGARH (Rajasthan),20,21
12.0,JOGENDRA SINGH HODA,Independent,2294,8,2302,0.15,21 - CHITTORGARH (Rajasthan),20,21
13.0,GAJENDRA,Independent,1637,7,1644,0.11,21 - CHITTORGARH (Rajasthan),20,21
14.0,KALYAN SINGH BHATI,Independent,1544,18,1562,0.1,21 - CHITTORGARH (Rajasthan),20,21
15.0,MAHAVIR PRASAD KUMAWAT,Right to Recall Party,1539,10,1549,0.1,21 - CHITTORGARH (Rajasthan),20,21
16.0,KAMAL,Independent,1490,8,1498,0.1,21 - CHITTORGARH (Rajasthan),20,21
17.0,MOHAMMAD WAHID KHAN,Pehchan People’s Party,1216,12,1228,0.08,21 - CHITTORGARH (Rajasthan),20,21
18.0,SITA RAM AHIR,Vishva Shakti Party,1203,23,1226,0.08,21 - CHITTORGARH (Rajasthan),20,21
19.0,NOTA,None of the Above,5518,72,5590,0.37,21 - CHITTORGARH (Rajasthan),20,21
,Total,,1488902,9831,1498733,,21 - CHITTORGARH (Rajasthan),20,21
1.0,MAHIMA KUMARI MEWAR,Bharatiya Janata Party,775243,5960,781203,64.4,22 - RAJSAMAND (Rajasthan),20,22
2.0,DR. DAMODAR GURJAR,Indian National Congress,385359,3621,388980,32.06,22 - RAJSAMAND (Rajasthan),20,22
3.0,RAMAKISHAN BHADU,Bahujan Samaj Party,9097,38,9135,0.75,22 - RAJSAMAND (Rajasthan),20,22
4.0,NEERU RAM KAPRI,Independent,7820,11,7831,0.65,22 - RAJSAMAND (Rajasthan),20,22
5.0,DHARAM SINGH RAWAT,Independent,3993,60,4053,0.33,22 - RAJSAMAND (Rajasthan),20,22
6.0,NARAYAN SONI,Independent,3367,7,3374,0.28,22 - RAJSAMAND (Rajasthan),20,22
7.0,GHANSHYAM SINGH,Bhartiya Jan Adhikar Party,1917,23,1940,0.16,22 - RAJSAMAND (Rajasthan),20,22
8.0,JITENDRA KUMAR KHATIK,Independent,1802,13,1815,0.15,22 - RAJSAMAND (Rajasthan),20,22
9.0,DR. ARPIT CHHAJER,Independent,1235,9,1244,0.1,22 - RAJSAMAND (Rajasthan),20,22
10.0,PRAMOD KUMAR VERMA,Bheem Tribal Congress,1134,10,1144,0.09,22 - RAJSAMAND (Rajasthan),20,22
11.0,NOTA,None of the Above,12339,72,12411,1.02,22 - RAJSAMAND (Rajasthan),20,22
,Total,,1203306,9824,1213130,,22 - RAJSAMAND (Rajasthan),20,22
1.0,DAMODAR AGARWAL,Bharatiya Janata Party,803193,4447,807640,61.92,23 - BHILWARA (Rajasthan),20,23
2.0,C P JOSHI,Indian National Congress,449528,3506,453034,34.73,23 - BHILWARA (Rajasthan),20,23
3.0,RAMESHWAR LAL BAIRWA,Bahujan Samaj Party,8243,40,8283,0.64,23 - BHILWARA (Rajasthan),20,23
4.0,RAJESH PATNI,Independent,8013,5,8018,0.61,23 - BHILWARA (Rajasthan),20,23
5.0,JAYKISHAN,Viro Ke Vir Indian Party,4061,23,4084,0.31,23 - BHILWARA (Rajasthan),20,23
6.0,MOTILAL SINGHANIA,Independent,3871,16,3887,0.3,23 - BHILWARA (Rajasthan),20,23
7.0,NARAYAN LAL JAT,Independent,1643,41,1684,0.13,23 - BHILWARA (Rajasthan),20,23
8.0,PAWAN KUMAR SHARMA,Right to Recall Party,1609,8,1617,0.12,23 - BHILWARA (Rajasthan),20,23
9.0,ANURAG AROT,Independent,1406,19,1425,0.11,23 - BHILWARA (Rajasthan),20,23
10.0,VIJAY KUMAR SONI,Bhartiya Garib Vikas Kalyan Party,1340,7,1347,0.1,23 - BHILWARA (Rajasthan),20,23
11.0,NOTA,None of the Above,13337,39,13376,1.03,23 - BHILWARA (Rajasthan),20,23
,Total,,1296244,8151,1304395,,23 - BHILWARA (Rajasthan),20,23
1.0,OM BIRLA,Bharatiya Janata Party,744396,6100,750496,50.03,24 - KOTA (Rajasthan),20,24
2.0,PRAHLAD GUNJAL,Indian National Congress,702623,5899,708522,47.23,24 - KOTA (Rajasthan),20,24
3.0,DHANRAJ YADAV,Bahujan Samaj Party,7547,28,7575,0.5,24 - KOTA (Rajasthan),20,24
4.0,ASHISH YOGI,Ekam Sanatan Bharat Dal,5756,19,5775,0.38,24 - KOTA (Rajasthan),20,24
5.0,LAKSHMICHAND,Independent,3890,2,3892,0.26,24 - KOTA (Rajasthan),20,24
6.0,SATYENDRA KUMAR JAIN,Independent,2520,1,2521,0.17,24 - KOTA (Rajasthan),20,24
7.0,RAMNATH MEHRA,Independent,2407,15,2422,0.16,24 - KOTA (Rajasthan),20,24
8.0,MOINUDDIN,Independent,1854,6,1860,0.12,24 - KOTA (Rajasthan),20,24
9.0,BHANWAR KUMAR RAWAL,Independent,1102,29,1131,0.08,24 - KOTA (Rajasthan),20,24
10.0,BALDEV SINGH FOJI,Bharatheeya Jawan Kisan Party,1066,3,1069,0.07,24 - KOTA (Rajasthan),20,24
11.0,TARUN GOCHAR,Right to Recall Party,992,8,1000,0.07,24 - KOTA (Rajasthan),20,24
12.0,KAILASHI ANIL JAIN,Independent,990,4,994,0.07,24 - KOTA (Rajasthan),20,24
13.0,KAMAL KUMAR BAIRWA,Independent,965,49,1014,0.07,24 - KOTA (Rajasthan),20,24
14.0,ABDUL ASIF,Independent,860,5,865,0.06,24 - KOTA (Rajasthan),20,24
15.0,OM PRAKASH SHAKYAWAL,Independent,757,3,760,0.05,24 - KOTA (Rajasthan),20,24
16.0,NOTA,None of the Above,10176,85,10261,0.68,24 - KOTA (Rajasthan),20,24
,Total,,1487901,12256,1500157,,24 - KOTA (Rajasthan),20,24
1.0,DUSHYANT SINGH,Bharatiya Janata Party,861850,3526,865376,60.88,25 - JHALAWAR-BARAN (Rajasthan),20,25
2.0,URMILA JAIN “BHAYA”,Indian National Congress,492342,2045,494387,34.78,25 - JHALAWAR-BARAN (Rajasthan),20,25
3.0,CHANDRA SINGH KIRAD,Bahujan Samaj Party,12252,33,12285,0.86,25 - JHALAWAR-BARAN (Rajasthan),20,25
4.0,RAVI RAJ SINGH,Independent,10231,43,10274,0.72,25 - JHALAWAR-BARAN (Rajasthan),20,25
5.0,BHUVANESH KUMAR,Right to Recall Party,9324,21,9345,0.66,25 - JHALAWAR-BARAN (Rajasthan),20,25
6.0,BABULAL,Independent,7668,24,7692,0.54,25 - JHALAWAR-BARAN (Rajasthan),20,25
7.0,PANKAJ PAJANTORIVALA,Independent,5927,18,5945,0.42,25 - JHALAWAR-BARAN (Rajasthan),20,25
8.0,NOTA,None of the Above,15958,69,16027,1.13,25 - JHALAWAR-BARAN (Rajasthan),20,25
,Total,,1415552,5779,1421331,,25 - JHALAWAR-BARAN (Rajasthan),20,25
1.0,INDRA HANG SUBBA,Sikkim Krantikari Morcha,156836,7560,164396,42.71,1 - Sikkim (Sikkim),21,1
2.0,BHARAT BASNETT,Citizen Action Party-Sikkim,78666,4900,83566,21.71,1 - Sikkim (Sikkim),21,1
3.0,PREM DAS RAI,Sikkim Democratic Front,75464,1707,77171,20.05,1 - Sikkim (Sikkim),21,1
4.0,LATEN TSHERING SHERPA,Independent,20197,1066,21263,5.52,1 - Sikkim (Sikkim),21,1
5.0,DINESH CHANDRA NEPAL,Bharatiya Janata Party,18788,247,19035,4.95,1 - Sikkim (Sikkim),21,1
6.0,SAMBHU CHETTRI,Independent,4682,8,4690,1.22,1 - Sikkim (Sikkim),21,1
7.0,KHARGA BHADUR RAI,Sikkim Republican Party,4591,208,4799,1.25,1 - Sikkim (Sikkim),21,1
8.0,GOPAL CHETTRI,Indian National Congress,2190,51,2241,0.58,1 - Sikkim (Sikkim),21,1
9.0,NAWIN KIRAN PRADHAN,Independent,1121,45,1166,0.3,1 - Sikkim (Sikkim),21,1
10.0,RAVI CHANDRA RAI,Independent,1077,46,1123,0.29,1 - Sikkim (Sikkim),21,1
11.0,BEENA RAI,Independent,1066,59,1125,0.29,1 - Sikkim (Sikkim),21,1
12.0,SHYAMAL PAL,Independent,735,5,740,0.19,1 - Sikkim (Sikkim),21,1
13.0,RUDRA MANI PRADHAN,Independent,512,7,519,0.13,1 - Sikkim (Sikkim),21,1
14.0,MADHUKAR DHAKAL,Independent,511,21,532,0.14,1 - Sikkim (Sikkim),21,1
15.0,NOTA,None of the Above,2433,94,2527,0.66,1 - Sikkim (Sikkim),21,1
,Total,,368869,16024,384893,,1 - Sikkim (Sikkim),21,1
1.0,Sasikanth Senthil,Indian National Congress,794608,2348,796956,56.21,1 - TIRUVALLUR (Tamil Nadu),22,1
2.0,"Balaganapathy, V. Pon",Bharatiya Janata Party,224042,759,224801,15.86,1 - TIRUVALLUR (Tamil Nadu),22,1
3.0,"Nallathambi, K.",Desiya Murpokku Dravida Kazhagam,223550,354,223904,15.79,1 - TIRUVALLUR (Tamil Nadu),22,1
4.0,"Jagadesh Chander, M.",Naam Tamilar Katchi,120620,218,120838,8.52,1 - TIRUVALLUR (Tamil Nadu),22,1
5.0,"Tamizhmadhi, D.",Bahujan Samaj Party,13772,38,13810,0.97,1 - TIRUVALLUR (Tamil Nadu),22,1
6.0,"Ashok Priyadarshan, S.",Desiya Makkal Sakthi Katchi,2937,9,2946,0.21,1 - TIRUVALLUR (Tamil Nadu),22,1
7.0,Malathi,Naadaalum Makkal Katchi,2829,24,2853,0.2,1 - TIRUVALLUR (Tamil Nadu),22,1
8.0,"Mani, E.",Independent,2745,7,2752,0.19,1 - TIRUVALLUR (Tamil Nadu),22,1
9.0,"Devandhran, M.",Anna MGR Dravida Makkal Kalgam,2001,7,2008,0.14,1 - TIRUVALLUR (Tamil Nadu),22,1
10.0,"Manimaran, V.",Independent,1921,1,1922,0.14,1 - TIRUVALLUR (Tamil Nadu),22,1
11.0,"Balakrishnan, K.",Independent,1685,5,1690,0.12,1 - TIRUVALLUR (Tamil Nadu),22,1
12.0,"Bharathidasan, S.S.",Independent,1619,12,1631,0.12,1 - TIRUVALLUR (Tamil Nadu),22,1
13.0,"Shakthivel, A.J.",Independent,1605,8,1613,0.11,1 - TIRUVALLUR (Tamil Nadu),22,1
14.0,"Sivasankaran, V.",Independent,1105,5,1110,0.08,1 - TIRUVALLUR (Tamil Nadu),22,1
15.0,NOTA,None of the Above,18908,70,18978,1.34,1 - TIRUVALLUR (Tamil Nadu),22,1
,Total,,1413947,3865,1417812,,1 - TIRUVALLUR (Tamil Nadu),22,1
1.0,DR.KALANIDHI VEERASWAMY,Dravida Munnetra Kazhagam,495733,1600,497333,55.11,2 - CHENNAI NORTH (Tamil Nadu),22,2
2.0,R. MANOHAR,All India Anna Dravida Munnetra Kazhagam,157631,480,158111,17.52,2 - CHENNAI NORTH (Tamil Nadu),22,2
3.0,R.C. PAUL KANAGARAJ,Bharatiya Janata Party,112628,690,113318,12.56,2 - CHENNAI NORTH (Tamil Nadu),22,2
4.0,AMUDINI,Naam Tamilar Katchi,95715,239,95954,10.63,2 - CHENNAI NORTH (Tamil Nadu),22,2
5.0,SARAH FATHIMA,Independent,5899,24,5923,0.66,2 - CHENNAI NORTH (Tamil Nadu),22,2
6.0,E. IQBAL,Bahujan Samaj Party,3471,15,3486,0.39,2 - CHENNAI NORTH (Tamil Nadu),22,2
7.0,MOORTHY. V,Independent,3131,6,3137,0.35,2 - CHENNAI NORTH (Tamil Nadu),22,2
8.0,SURIYAMUTHU,Independent,976,2,978,0.11,2 - CHENNAI NORTH (Tamil Nadu),22,2
9.0,C. SENAPATHI,Independent,850,-,850,0.09,2 - CHENNAI NORTH (Tamil Nadu),22,2
10.0,DILLI GANESH. E,Independent,735,1,736,0.08,2 - CHENNAI NORTH (Tamil Nadu),22,2
11.0,U. VENKATESH,Independent,709,5,714,0.08,2 - CHENNAI NORTH (Tamil Nadu),22,2
12.0,M. ZION RAJ,Independent,696,1,697,0.08,2 - CHENNAI NORTH (Tamil Nadu),22,2
13.0,A. AJITHKUMAR,Thakkam Katchi,671,2,673,0.07,2 - CHENNAI NORTH (Tamil Nadu),22,2
14.0,J. SEBASTIN,Socialist Unity Centre Of India (COMMUNIST),586,2,588,0.07,2 - CHENNAI NORTH (Tamil Nadu),22,2
15.0,AKSHAY,Naadaalum Makkal Katchi,563,3,566,0.06,2 - CHENNAI NORTH (Tamil Nadu),22,2
16.0,B. BALAMURUGAN,Independent,485,3,488,0.05,2 - CHENNAI NORTH (Tamil Nadu),22,2
17.0,K.PALANIAPPAN,Independent,460,2,462,0.05,2 - CHENNAI NORTH (Tamil Nadu),22,2
18.0,R. SENTHIL KUMAR,Independent,457,-,457,0.05,2 - CHENNAI NORTH (Tamil Nadu),22,2
19.0,MATHANKUMAR. G,Independent,390,-,390,0.04,2 - CHENNAI NORTH (Tamil Nadu),22,2
20.0,P. JAYASELAN,Independent,386,-,386,0.04,2 - CHENNAI NORTH (Tamil Nadu),22,2
21.0,M. KOLANJI,Independent,361,1,362,0.04,2 - CHENNAI NORTH (Tamil Nadu),22,2
22.0,B. ZAKIR HUSSAIN,Independent,354,1,355,0.04,2 - CHENNAI NORTH (Tamil Nadu),22,2
23.0,P. UMADEVI,Independent,346,-,346,0.04,2 - CHENNAI NORTH (Tamil Nadu),22,2
24.0,K.C.JAYAPRAKASH,Independent,334,-,334,0.04,2 - CHENNAI NORTH (Tamil Nadu),22,2
25.0,C. SRIDHAR,Independent,307,-,307,0.03,2 - CHENNAI NORTH (Tamil Nadu),22,2
26.0,T. MANOHARAN,Independent,293,-,293,0.03,2 - CHENNAI NORTH (Tamil Nadu),22,2
27.0,K. SAMPATH,Independent,268,1,269,0.03,2 - CHENNAI NORTH (Tamil Nadu),22,2
28.0,D. SRINIVASAN,Independent,260,1,261,0.03,2 - CHENNAI NORTH (Tamil Nadu),22,2
29.0,S. RAVIKUMAR,Republican Party of India (Sivaraj),258,1,259,0.03,2 - CHENNAI NORTH (Tamil Nadu),22,2
30.0,T. KAVIYARASU,Independent,250,2,252,0.03,2 - CHENNAI NORTH (Tamil Nadu),22,2
31.0,SATHISH. B,Independent,245,1,246,0.03,2 - CHENNAI NORTH (Tamil Nadu),22,2
32.0,R.VINAYAGAMOORTHY,Independent,206,-,206,0.02,2 - CHENNAI NORTH (Tamil Nadu),22,2
33.0,D. KABILAN,Independent,203,6,209,0.02,2 - CHENNAI NORTH (Tamil Nadu),22,2
34.0,P. MARIMUTHU,Independent,171,1,172,0.02,2 - CHENNAI NORTH (Tamil Nadu),22,2
35.0,V.MADHAN MOHAN,Independent,163,-,163,0.02,2 - CHENNAI NORTH (Tamil Nadu),22,2
36.0,NOTA,None of the Above,13139,69,13208,1.46,2 - CHENNAI NORTH (Tamil Nadu),22,2
,Total,,899330,3159,902489,,2 - CHENNAI NORTH (Tamil Nadu),22,2
1.0,T.SUMATHY (ALIAS) THAMIZHACHI THANGAPANDIAN,Dravida Munnetra Kazhagam,515307,1321,516628,47.0,3 - CHENNAI SOUTH (Tamil Nadu),22,3
2.0,DR.TAMILISAI SOUNDARARAJAN,Bharatiya Janata Party,289229,1454,290683,26.44,3 - CHENNAI SOUTH (Tamil Nadu),22,3
3.0,DR.J.JAYAVARDHAN,All India Anna Dravida Munnetra Kazhagam,172108,383,172491,15.69,3 - CHENNAI SOUTH (Tamil Nadu),22,3
4.0,S.TAMILCHELVI,Naam Tamilar Katchi,83821,151,83972,7.64,3 - CHENNAI SOUTH (Tamil Nadu),22,3
5.0,M.G.RAMU,Jebamani Janata,3526,8,3534,0.32,3 - CHENNAI SOUTH (Tamil Nadu),22,3
6.0,M.AZARUTHEEN,Independent,1808,4,1812,0.16,3 - CHENNAI SOUTH (Tamil Nadu),22,3
7.0,G.P. ROBERT,Bahujan Samaj Party,1596,3,1599,0.15,3 - CHENNAI SOUTH (Tamil Nadu),22,3
8.0,R.RAVICHANDRAN,Independent,835,-,835,0.08,3 - CHENNAI SOUTH (Tamil Nadu),22,3
9.0,S.MANIMARAN,Independent,803,-,803,0.07,3 - CHENNAI SOUTH (Tamil Nadu),22,3
10.0,FARMER JAYARAMAN. S.K.J,Desiya Makkal Sakthi Katchi,790,2,792,0.07,3 - CHENNAI SOUTH (Tamil Nadu),22,3
11.0,A.K.D. ELLAPPAN,Mahathma Makkal Munnetra Kazhakam,761,-,761,0.07,3 - CHENNAI SOUTH (Tamil Nadu),22,3
12.0,K.KANNAN,Independent,625,-,625,0.06,3 - CHENNAI SOUTH (Tamil Nadu),22,3
13.0,BALAJI. G. MANGADU,Aravor Munnetra Kazhagam,588,1,589,0.05,3 - CHENNAI SOUTH (Tamil Nadu),22,3
14.0,KUTTIMANI. S,Veerath Thiyagi Viswanathadoss Thozhilalarkal Katchi,565,-,565,0.05,3 - CHENNAI SOUTH (Tamil Nadu),22,3
15.0,R.KANCHANA,Tamizhaga Murpokku Makkal Katchi,565,1,566,0.05,3 - CHENNAI SOUTH (Tamil Nadu),22,3
16.0,SASI REKHA,Naadaalum Makkal Katchi,557,2,559,0.05,3 - CHENNAI SOUTH (Tamil Nadu),22,3
17.0,P. SATHEESH KUMAR,Independent,520,1,521,0.05,3 - CHENNAI SOUTH (Tamil Nadu),22,3
18.0,P.SEKAR,Thakkam Katchi,435,-,435,0.04,3 - CHENNAI SOUTH (Tamil Nadu),22,3
19.0,R.YOGESHWARAN,Independent,425,1,426,0.04,3 - CHENNAI SOUTH (Tamil Nadu),22,3
20.0,J. SATHISH,Independent,418,-,418,0.04,3 - CHENNAI SOUTH (Tamil Nadu),22,3
21.0,V.P. RAVIKKARAN,Independent,372,1,373,0.03,3 - CHENNAI SOUTH (Tamil Nadu),22,3
22.0,A.PONNUDURAI,Independent,362,-,362,0.03,3 - CHENNAI SOUTH (Tamil Nadu),22,3
23.0,N.V.DAMODARAN,National Maha Sabha Party,341,2,343,0.03,3 - CHENNAI SOUTH (Tamil Nadu),22,3
24.0,M.MUNUSWAMY,Viro Ke Vir Indian Party,326,4,330,0.03,3 - CHENNAI SOUTH (Tamil Nadu),22,3
25.0,KARTHIK MURTHY,Independent,312,3,315,0.03,3 - CHENNAI SOUTH (Tamil Nadu),22,3
26.0,V.P.SURESH,Independent,288,1,289,0.03,3 - CHENNAI SOUTH (Tamil Nadu),22,3
27.0,E.RAMESH,Independent,270,-,270,0.02,3 - CHENNAI SOUTH (Tamil Nadu),22,3
28.0,R.BALAJI,Independent,264,-,264,0.02,3 - CHENNAI SOUTH (Tamil Nadu),22,3
29.0,DINESH KUMAR. B,Independent,253,-,253,0.02,3 - CHENNAI SOUTH (Tamil Nadu),22,3
30.0,A.BABU,Independent,246,-,246,0.02,3 - CHENNAI SOUTH (Tamil Nadu),22,3
31.0,DAYALAN. R,Independent,241,1,242,0.02,3 - CHENNAI SOUTH (Tamil Nadu),22,3
32.0,VIJIRATHINAM. M,Independent,237,-,237,0.02,3 - CHENNAI SOUTH (Tamil Nadu),22,3
33.0,V.SIVAKUMAR,Independent,217,-,217,0.02,3 - CHENNAI SOUTH (Tamil Nadu),22,3
34.0,MURUGAN. P,Independent,182,-,182,0.02,3 - CHENNAI SOUTH (Tamil Nadu),22,3
35.0,G.RAMESHBABU,Independent,178,1,179,0.02,3 - CHENNAI SOUTH (Tamil Nadu),22,3
36.0,S.RAJASEKARAN,Independent,177,1,178,0.02,3 - CHENNAI SOUTH (Tamil Nadu),22,3
37.0,N.NARAYANASWAMY,Independent,175,-,175,0.02,3 - CHENNAI SOUTH (Tamil Nadu),22,3
38.0,R.DEVENDRAN,Independent,167,1,168,0.02,3 - CHENNAI SOUTH (Tamil Nadu),22,3
39.0,PARTHIBAN. S,Independent,165,1,166,0.02,3 - CHENNAI SOUTH (Tamil Nadu),22,3
40.0,I. DAVIDSINGH,Independent,150,1,151,0.01,3 - CHENNAI SOUTH (Tamil Nadu),22,3
41.0,E RAVENDRAN,Independent,114,-,114,0.01,3 - CHENNAI SOUTH (Tamil Nadu),22,3
42.0,NOTA,None of the Above,15607,46,15653,1.42,3 - CHENNAI SOUTH (Tamil Nadu),22,3
,Total,,1095926,3395,1099321,,3 - CHENNAI SOUTH (Tamil Nadu),22,3
1.0,DAYANIDHI MARAN,Dravida Munnetra Kazhagam,412286,1562,413848,56.65,4 - CHENNAI CENTRAL (Tamil Nadu),22,4
2.0,VINOJ,Bharatiya Janata Party,168059,1100,169159,23.16,4 - CHENNAI CENTRAL (Tamil Nadu),22,4
3.0,B. PARTHASARATHY,Desiya Murpokku Dravida Kazhagam,71772,244,72016,9.86,4 - CHENNAI CENTRAL (Tamil Nadu),22,4
4.0,DR.R.KARTHIKEYAN,Naam Tamilar Katchi,45865,166,46031,6.3,4 - CHENNAI CENTRAL (Tamil Nadu),22,4
5.0,ANBAZHAGAN.G,Independent,3175,11,3186,0.44,4 - CHENNAI CENTRAL (Tamil Nadu),22,4
6.0,DILAVAR ALI,Tipu Sultan Party,2536,10,2546,0.35,4 - CHENNAI CENTRAL (Tamil Nadu),22,4
7.0,SAMARAN,Bahujan Samaj Party,2132,15,2147,0.29,4 - CHENNAI CENTRAL (Tamil Nadu),22,4
8.0,L.KASINATHAN,Independent,1059,1,1060,0.15,4 - CHENNAI CENTRAL (Tamil Nadu),22,4
9.0,AGNI AALVAR,Independent,783,4,787,0.11,4 - CHENNAI CENTRAL (Tamil Nadu),22,4
10.0,C.S.KARNAN,Anti Corruption Dynamic Party,750,11,761,0.1,4 - CHENNAI CENTRAL (Tamil Nadu),22,4
11.0,M.L.RAVI,Desiya Makkal Sakthi Katchi,690,6,696,0.1,4 - CHENNAI CENTRAL (Tamil Nadu),22,4
12.0,S.KANDASAMY,Independent,595,1,596,0.08,4 - CHENNAI CENTRAL (Tamil Nadu),22,4
13.0,DHAYANIDHI SURESH,Independent,565,2,567,0.08,4 - CHENNAI CENTRAL (Tamil Nadu),22,4
14.0,S.SATHISH KUMAR,Independent,526,1,527,0.07,4 - CHENNAI CENTRAL (Tamil Nadu),22,4
15.0,P.ARJUNAN,Independent,502,7,509,0.07,4 - CHENNAI CENTRAL (Tamil Nadu),22,4
16.0,S.SATHISH KUMAR,Independent,500,1,501,0.07,4 - CHENNAI CENTRAL (Tamil Nadu),22,4
17.0,G.OMPRAKASH,Independent,486,2,488,0.07,4 - CHENNAI CENTRAL (Tamil Nadu),22,4
18.0,V.V.TAMILARASAN,Independent,386,3,389,0.05,4 - CHENNAI CENTRAL (Tamil Nadu),22,4
19.0,UDAYA KUMAR.V,Independent,382,-,382,0.05,4 - CHENNAI CENTRAL (Tamil Nadu),22,4
20.0,B.PARTHASARATHY,Independent,377,3,380,0.05,4 - CHENNAI CENTRAL (Tamil Nadu),22,4
21.0,K.CHANDRASEKAR,Naadaalum Makkal Katchi,373,-,373,0.05,4 - CHENNAI CENTRAL (Tamil Nadu),22,4
22.0,N.RAMAN,Tamilnadu Makkal Nalvazhvu Periyakkam,311,3,314,0.04,4 - CHENNAI CENTRAL (Tamil Nadu),22,4
23.0,R.MINNAL RAJ,Independent,310,-,310,0.04,4 - CHENNAI CENTRAL (Tamil Nadu),22,4
24.0,R.VIJAY,Independent,268,-,268,0.04,4 - CHENNAI CENTRAL (Tamil Nadu),22,4
25.0,A.SELVA KUMAR,Thakkam Katchi,265,5,270,0.04,4 - CHENNAI CENTRAL (Tamil Nadu),22,4
26.0,M.NAGARAJ,Independent,254,-,254,0.03,4 - CHENNAI CENTRAL (Tamil Nadu),22,4
27.0,J.NAGARAJ,Independent,238,3,241,0.03,4 - CHENNAI CENTRAL (Tamil Nadu),22,4
28.0,SENTHILKUMAR,Chennai Youth Party,222,1,223,0.03,4 - CHENNAI CENTRAL (Tamil Nadu),22,4
29.0,RANJITHKUMAR.S,Independent,215,-,215,0.03,4 - CHENNAI CENTRAL (Tamil Nadu),22,4
30.0,RAVI BALARAMAN,Independent,182,1,183,0.03,4 - CHENNAI CENTRAL (Tamil Nadu),22,4
31.0,MANJUNATHA.R,Independent,159,-,159,0.02,4 - CHENNAI CENTRAL (Tamil Nadu),22,4
32.0,NOTA,None of the Above,11082,81,11163,1.53,4 - CHENNAI CENTRAL (Tamil Nadu),22,4
,Total,,727305,3244,730549,,4 - CHENNAI CENTRAL (Tamil Nadu),22,4
1.0,T R BAALU,Dravida Munnetra Kazhagam,755671,2940,758611,52.65,5 - SRIPERUMBUDUR (Tamil Nadu),22,5
2.0,G PREMKUMAR,All India Anna Dravida Munnetra Kazhagam,270549,1033,271582,18.85,5 - SRIPERUMBUDUR (Tamil Nadu),22,5
3.0,V N VENUGOPAL,Tamil Maanila Congress (Moopanar),209183,927,210110,14.58,5 - SRIPERUMBUDUR (Tamil Nadu),22,5
4.0,V RAVICHANDRAN,Naam Tamilar Katchi,139931,302,140233,9.73,5 - SRIPERUMBUDUR (Tamil Nadu),22,5
5.0,K PRABAKARAN,Bahujan Samaj Party,8115,74,8189,0.57,5 - SRIPERUMBUDUR (Tamil Nadu),22,5
6.0,M S ARUMUGAM,Independent,3695,4,3699,0.26,5 - SRIPERUMBUDUR (Tamil Nadu),22,5
7.0,V SUDHAVALLI,Aravor Munnetra Kazhagam,3659,35,3694,0.26,5 - SRIPERUMBUDUR (Tamil Nadu),22,5
8.0,S AMBETHKUMAR,Mahathma Makkal Munnetra Kazhakam,2211,9,2220,0.15,5 - SRIPERUMBUDUR (Tamil Nadu),22,5
9.0,M ASHOK KUMAR,Independent,1696,8,1704,0.12,5 - SRIPERUMBUDUR (Tamil Nadu),22,5
10.0,S SIVAKUMAR,Veerath Thiyagi Viswanathadoss Thozhilalarkal Katchi,1349,3,1352,0.09,5 - SRIPERUMBUDUR (Tamil Nadu),22,5
11.0,AYODHI LAKSHMANAN,Independent,1255,4,1259,0.09,5 - SRIPERUMBUDUR (Tamil Nadu),22,5
12.0,S CHITTIBABU,Naadaalum Makkal Katchi,1238,3,1241,0.09,5 - SRIPERUMBUDUR (Tamil Nadu),22,5
13.0,C ARAVIND,Desiya Makkal Sakthi Katchi,959,11,970,0.07,5 - SRIPERUMBUDUR (Tamil Nadu),22,5
14.0,GOPI DEEPAK,Independent,878,5,883,0.06,5 - SRIPERUMBUDUR (Tamil Nadu),22,5
15.0,KARTHIK KUMAR P C,Independent,866,1,867,0.06,5 - SRIPERUMBUDUR (Tamil Nadu),22,5
16.0,J MOHANRAJ,Jebamani Janata,817,5,822,0.06,5 - SRIPERUMBUDUR (Tamil Nadu),22,5
17.0,DR S PRAVEEN,Independent,791,8,799,0.06,5 - SRIPERUMBUDUR (Tamil Nadu),22,5
18.0,I MOHAMED YASEEN,Thakkam Katchi,668,1,669,0.05,5 - SRIPERUMBUDUR (Tamil Nadu),22,5
19.0,K PALANIYAPPAN,Tamizhaga Murpokku Makkal Katchi,613,4,617,0.04,5 - SRIPERUMBUDUR (Tamil Nadu),22,5
20.0,S PRABHU,Independent,513,1,514,0.04,5 - SRIPERUMBUDUR (Tamil Nadu),22,5
21.0,P BASKARAN,Independent,493,1,494,0.03,5 - SRIPERUMBUDUR (Tamil Nadu),22,5
22.0,P HARIDAS,Independent,458,2,460,0.03,5 - SRIPERUMBUDUR (Tamil Nadu),22,5
23.0,C A JAYARAMAN,Independent,445,2,447,0.03,5 - SRIPERUMBUDUR (Tamil Nadu),22,5
24.0,G RAMKUMAR,Independent,426,-,426,0.03,5 - SRIPERUMBUDUR (Tamil Nadu),22,5
25.0,N MANIKKAM,Independent,402,1,403,0.03,5 - SRIPERUMBUDUR (Tamil Nadu),22,5
26.0,M PREMKUMAR,Independent,393,1,394,0.03,5 - SRIPERUMBUDUR (Tamil Nadu),22,5
27.0,S MUNIKUMAR,Samaniya Makkal Nala Katchi,393,1,394,0.03,5 - SRIPERUMBUDUR (Tamil Nadu),22,5
28.0,M SARAVANAN,Independent,385,-,385,0.03,5 - SRIPERUMBUDUR (Tamil Nadu),22,5
29.0,A JINNA MOHAMMED,Independent,382,6,388,0.03,5 - SRIPERUMBUDUR (Tamil Nadu),22,5
30.0,S SIVARAMAN,Independent,340,3,343,0.02,5 - SRIPERUMBUDUR (Tamil Nadu),22,5
31.0,C PREMKUMAR,Independent,313,3,316,0.02,5 - SRIPERUMBUDUR (Tamil Nadu),22,5
32.0,NOTA,None of the Above,26294,156,26450,1.84,5 - SRIPERUMBUDUR (Tamil Nadu),22,5
,Total,,1435381,5554,1440935,,5 - SRIPERUMBUDUR (Tamil Nadu),22,5
1.0,SELVAM. G,Dravida Munnetra Kazhagam,582978,3066,586044,46.53,6 - KANCHEEPURAM (Tamil Nadu),22,6
2.0,RAJASEKAR. E,All India Anna Dravida Munnetra Kazhagam,362991,1580,364571,28.94,6 - KANCHEEPURAM (Tamil Nadu),22,6
3.0,JOTHI. V,Pattali Makkal Katchi,163792,1139,164931,13.09,6 - KANCHEEPURAM (Tamil Nadu),22,6
4.0,SANTHOSH KUMAR. V,Naam Tamilar Katchi,109858,414,110272,8.75,6 - KANCHEEPURAM (Tamil Nadu),22,6
5.0,ILAYARAJA. S,Bahujan Samaj Party,5243,21,5264,0.42,6 - KANCHEEPURAM (Tamil Nadu),22,6
6.0,VENKATESAN. K,Independent,2798,9,2807,0.22,6 - KANCHEEPURAM (Tamil Nadu),22,6
7.0,NARESH BHARATHI. S,Independent,2499,12,2511,0.2,6 - KANCHEEPURAM (Tamil Nadu),22,6
8.0,ELANGOVAN. M,Independent,1874,7,1881,0.15,6 - KANCHEEPURAM (Tamil Nadu),22,6
9.0,SURYA. A,Independent,1673,29,1702,0.14,6 - KANCHEEPURAM (Tamil Nadu),22,6
10.0,RAMESH. S,Independent,1317,1,1318,0.1,6 - KANCHEEPURAM (Tamil Nadu),22,6
11.0,SELVAM. T,Independent,1295,17,1312,0.1,6 - KANCHEEPURAM (Tamil Nadu),22,6
12.0,NOTA,None of the Above,16811,154,16965,1.35,6 - KANCHEEPURAM (Tamil Nadu),22,6
,Total,,1253129,6449,1259578,,6 - KANCHEEPURAM (Tamil Nadu),22,6
1.0,S JAGATHRATCHAKAN,Dravida Munnetra Kazhagam,560578,2638,563216,48.39,7 - ARAKKONAM (Tamil Nadu),22,7
2.0,L VIJAYAN,All India Anna Dravida Munnetra Kazhagam,255343,1314,256657,22.05,7 - ARAKKONAM (Tamil Nadu),22,7
3.0,K BALU,Pattali Makkal Katchi,200614,1711,202325,17.38,7 - ARAKKONAM (Tamil Nadu),22,7
4.0,S AFSHIA NASRIN,Naam Tamilar Katchi,97985,959,98944,8.5,7 - ARAKKONAM (Tamil Nadu),22,7
5.0,D PANDIYAN,Bahujan Samaj Party,6135,77,6212,0.53,7 - ARAKKONAM (Tamil Nadu),22,7
6.0,A PALANI,Independent,3855,11,3866,0.33,7 - ARAKKONAM (Tamil Nadu),22,7
7.0,K MANIGANDAN,Independent,2045,4,2049,0.18,7 - ARAKKONAM (Tamil Nadu),22,7
8.0,INDU W,Tamil Manila Murpokku Dravida Kazhagam,1872,66,1938,0.17,7 - ARAKKONAM (Tamil Nadu),22,7
9.0,DR A V NARENDRAN,Independent,1711,11,1722,0.15,7 - ARAKKONAM (Tamil Nadu),22,7
10.0,M VIJAYAN,Independent,1674,4,1678,0.14,7 - ARAKKONAM (Tamil Nadu),22,7
11.0,M BALU,Independent,1557,4,1561,0.13,7 - ARAKKONAM (Tamil Nadu),22,7
12.0,SHETTU S,Independent,1556,5,1561,0.13,7 - ARAKKONAM (Tamil Nadu),22,7
13.0,V BABU,United Republican Party of India,1351,15,1366,0.12,7 - ARAKKONAM (Tamil Nadu),22,7
14.0,M THULASIRAMAN,Independent,1046,7,1053,0.09,7 - ARAKKONAM (Tamil Nadu),22,7
15.0,D JANAKIRAMAN,Independent,831,6,837,0.07,7 - ARAKKONAM (Tamil Nadu),22,7
16.0,S SURESH KUMAR,Independent,828,7,835,0.07,7 - ARAKKONAM (Tamil Nadu),22,7
17.0,R VINOTH,Veerath Thiyagi Viswanathadoss Thozhilalarkal Katchi,819,2,821,0.07,7 - ARAKKONAM (Tamil Nadu),22,7
18.0,V VINAYAGAM,Independent,727,2,729,0.06,7 - ARAKKONAM (Tamil Nadu),22,7
19.0,VIJAYAN K,All India Jananayaka Makkal Kazhagam,624,9,633,0.05,7 - ARAKKONAM (Tamil Nadu),22,7
20.0,SHANAVAS J,Independent,580,3,583,0.05,7 - ARAKKONAM (Tamil Nadu),22,7
21.0,V KRISHNANANDAN,Anna MGR Dravida Makkal Kalgam,568,14,582,0.05,7 - ARAKKONAM (Tamil Nadu),22,7
22.0,A JAYACHANDRAN,Independent,534,4,538,0.05,7 - ARAKKONAM (Tamil Nadu),22,7
23.0,N SUGUMAR,Independent,424,8,432,0.04,7 - ARAKKONAM (Tamil Nadu),22,7
24.0,M VIJAY,Independent,416,11,427,0.04,7 - ARAKKONAM (Tamil Nadu),22,7
25.0,G SUDHAKAR,Independent,367,13,380,0.03,7 - ARAKKONAM (Tamil Nadu),22,7
26.0,K VENKATESAN,Independent,261,3,264,0.02,7 - ARAKKONAM (Tamil Nadu),22,7
27.0,NOTA,None of the Above,12423,190,12613,1.08,7 - ARAKKONAM (Tamil Nadu),22,7
,Total,,1156724,7098,1163822,,7 - ARAKKONAM (Tamil Nadu),22,7
1.0,DM KATHIR ANAND,Dravida Munnetra Kazhagam,566435,2257,568692,50.35,8 - VELLORE (Tamil Nadu),22,8
2.0,AC SHANMUGAM,Bharatiya Janata Party,350956,2034,352990,31.25,8 - VELLORE (Tamil Nadu),22,8
3.0,DR S PASUPATHI,All India Anna Dravida Munnetra Kazhagam,116964,718,117682,10.42,8 - VELLORE (Tamil Nadu),22,8
4.0,D MAHESH ANAND,Naam Tamilar Katchi,52707,577,53284,4.72,8 - VELLORE (Tamil Nadu),22,8
5.0,A NATARAJAN,Bharatiya Praja Aikyata Party,3982,23,4005,0.35,8 - VELLORE (Tamil Nadu),22,8
6.0,SHANMUGAVELU,Independent,3570,6,3576,0.32,8 - VELLORE (Tamil Nadu),22,8
7.0,MANSOOR ALI KHAN,Independent,2769,35,2804,0.25,8 - VELLORE (Tamil Nadu),22,8
8.0,SYED ALI D,Independent,2121,3,2124,0.19,8 - VELLORE (Tamil Nadu),22,8
9.0,P SHANMUGAM,Independent,2037,2,2039,0.18,8 - VELLORE (Tamil Nadu),22,8
10.0,NAGARAJ P,Independent,1948,11,1959,0.17,8 - VELLORE (Tamil Nadu),22,8
11.0,K JAYAMANI,Bahujan Samaj Party,1684,18,1702,0.15,8 - VELLORE (Tamil Nadu),22,8
12.0,D SARAVANAN,Independent,1497,-,1497,0.13,8 - VELLORE (Tamil Nadu),22,8
13.0,MP SHANMUGAM,Independent,859,9,868,0.08,8 - VELLORE (Tamil Nadu),22,8
14.0,N SIVAKUMAR,Independent,701,-,701,0.06,8 - VELLORE (Tamil Nadu),22,8
15.0,AFROSE,Independent,672,1,673,0.06,8 - VELLORE (Tamil Nadu),22,8
16.0,A BEEMARAO MILINTHAR,United Republican Party of India,667,3,670,0.06,8 - VELLORE (Tamil Nadu),22,8
17.0,DR S JAYARAJ,Independent,659,2,661,0.06,8 - VELLORE (Tamil Nadu),22,8
18.0,K SHANMUGAM,Independent,601,15,616,0.05,8 - VELLORE (Tamil Nadu),22,8
19.0,V KALIAPERUMAL,Ganasangam Party of India,594,6,600,0.05,8 - VELLORE (Tamil Nadu),22,8
20.0,G SHANMUGAM,Independent,560,12,572,0.05,8 - VELLORE (Tamil Nadu),22,8
21.0,PP JAYAPRAKASH,Independent,455,6,461,0.04,8 - VELLORE (Tamil Nadu),22,8
22.0,PASUPATHI,Independent,407,8,415,0.04,8 - VELLORE (Tamil Nadu),22,8
23.0,S WILLIAM SATHYARAJ,Tamil Manila Murpokku Dravida Kazhagam,373,4,377,0.03,8 - VELLORE (Tamil Nadu),22,8
24.0,M BABU,Independent,303,3,306,0.03,8 - VELLORE (Tamil Nadu),22,8
25.0,B JAGAN,Independent,282,3,285,0.03,8 - VELLORE (Tamil Nadu),22,8
26.0,AHMED RAASHID PALLIMIRA,Independent,271,2,273,0.02,8 - VELLORE (Tamil Nadu),22,8
27.0,SHANMUGASUNDARAM,Independent,250,1,251,0.02,8 - VELLORE (Tamil Nadu),22,8
28.0,C MADHAVAN,Independent,201,1,202,0.02,8 - VELLORE (Tamil Nadu),22,8
29.0,T JOHNSON,Independent,174,-,174,0.02,8 - VELLORE (Tamil Nadu),22,8
30.0,E RAJKUMAR,Independent,129,4,133,0.01,8 - VELLORE (Tamil Nadu),22,8
31.0,C RAMACHANDHIRAN,Independent,128,2,130,0.01,8 - VELLORE (Tamil Nadu),22,8
32.0,NOTA,None of the Above,8669,67,8736,0.77,8 - VELLORE (Tamil Nadu),22,8
,Total,,1123625,5833,1129458,,8 - VELLORE (Tamil Nadu),22,8
1.0,GOPINATH K,Indian National Congress,491131,1752,492883,42.27,9 - KRISHNAGIRI (Tamil Nadu),22,9
2.0,JAYAPRAKASH V,All India Anna Dravida Munnetra Kazhagam,299300,1097,300397,25.76,9 - KRISHNAGIRI (Tamil Nadu),22,9
3.0,NARASIMHAN C,Bharatiya Janata Party,212859,1266,214125,18.36,9 - KRISHNAGIRI (Tamil Nadu),22,9
4.0,VIDHYA RANI,Naam Tamilar Katchi,106260,823,107083,9.18,9 - KRISHNAGIRI (Tamil Nadu),22,9
5.0,ARUMUGAM M,Bharatiya Praja Aikyata Party,6118,36,6154,0.53,9 - KRISHNAGIRI (Tamil Nadu),22,9
6.0,DR.SHANMUGAM .A.R,Independent,5577,6,5583,0.48,9 - KRISHNAGIRI (Tamil Nadu),22,9
7.0,ESHWARAN C,Independent,4126,2,4128,0.35,9 - KRISHNAGIRI (Tamil Nadu),22,9
8.0,TAMILSELVAN S,Bahujan Samaj Party,3665,33,3698,0.32,9 - KRISHNAGIRI (Tamil Nadu),22,9
9.0,SWAMINATHAN T G,Aravor Munnetra Kazhagam,1969,9,1978,0.17,9 - KRISHNAGIRI (Tamil Nadu),22,9
10.0,MANI K,Chennai Youth Party,1964,8,1972,0.17,9 - KRISHNAGIRI (Tamil Nadu),22,9
11.0,SRINIVASAN K,Independent,1619,2,1621,0.14,9 - KRISHNAGIRI (Tamil Nadu),22,9
12.0,VENKATESHKUMAR M,Independent,1585,5,1590,0.14,9 - KRISHNAGIRI (Tamil Nadu),22,9
13.0,ALBERT FRANCIS XAVIER S,Independent,1422,1,1423,0.12,9 - KRISHNAGIRI (Tamil Nadu),22,9
14.0,SARAVANAKUMAR A,Independent,1163,6,1169,0.1,9 - KRISHNAGIRI (Tamil Nadu),22,9
15.0,ANAND KUMAR A,Independent,1157,3,1160,0.1,9 - KRISHNAGIRI (Tamil Nadu),22,9
16.0,SUBRAMANI M,Tamilar Makkal Katchi,1156,39,1195,0.1,9 - KRISHNAGIRI (Tamil Nadu),22,9
17.0,ANNADURAI K,Independent,1154,6,1160,0.1,9 - KRISHNAGIRI (Tamil Nadu),22,9
18.0,MAHARAJAN G,Independent,991,4,995,0.09,9 - KRISHNAGIRI (Tamil Nadu),22,9
19.0,JAGADHEESAN C,Viro Ke Vir Indian Party,897,3,900,0.08,9 - KRISHNAGIRI (Tamil Nadu),22,9
20.0,VIJAYAKUMAR K P,Anaithu India Makkal Katchi,891,46,937,0.08,9 - KRISHNAGIRI (Tamil Nadu),22,9
21.0,DEEKSHITH M,Karunaadu Party,817,7,824,0.07,9 - KRISHNAGIRI (Tamil Nadu),22,9
22.0,RAMESH A,Independent,816,3,819,0.07,9 - KRISHNAGIRI (Tamil Nadu),22,9
23.0,RAJESHWARI B.H.,Independent,793,6,799,0.07,9 - KRISHNAGIRI (Tamil Nadu),22,9
24.0,CHANDRAMOHAN K.M.,Independent,789,3,792,0.07,9 - KRISHNAGIRI (Tamil Nadu),22,9
25.0,DEVAPPA Y,Independent,717,7,724,0.06,9 - KRISHNAGIRI (Tamil Nadu),22,9
26.0,VEERASAMY C,Independent,656,4,660,0.06,9 - KRISHNAGIRI (Tamil Nadu),22,9
27.0,YUVARAJ K P U,Independent,402,3,405,0.03,9 - KRISHNAGIRI (Tamil Nadu),22,9
28.0,NOTA,None of the Above,10893,89,10982,0.94,9 - KRISHNAGIRI (Tamil Nadu),22,9
,Total,,1160887,5269,1166156,,9 - KRISHNAGIRI (Tamil Nadu),22,9
1.0,MANI. A.,Dravida Munnetra Kazhagam,429301,3366,432667,34.67,10 - DHARMAPURI (Tamil Nadu),22,10
2.0,SOWMIYA ANBUMANI,Pattali Makkal Katchi,408445,2922,411367,32.97,10 - DHARMAPURI (Tamil Nadu),22,10
3.0,ASOKAN. R. DR.,All India Anna Dravida Munnetra Kazhagam,291590,2039,293629,23.53,10 - DHARMAPURI (Tamil Nadu),22,10
4.0,ABINAYA,Naam Tamilar Katchi,64576,805,65381,5.24,10 - DHARMAPURI (Tamil Nadu),22,10
5.0,THANGAVEL. K.,Dhesiya Makkal Kazhagam,7323,8,7331,0.59,10 - DHARMAPURI (Tamil Nadu),22,10
6.0,THIRUMURUGAN. P.,Independent,5668,3,5671,0.45,10 - DHARMAPURI (Tamil Nadu),22,10
7.0,HARI. R.,Bahujan Samaj Party,3128,38,3166,0.25,10 - DHARMAPURI (Tamil Nadu),22,10
8.0,SOWMIYA,Independent,3001,27,3028,0.24,10 - DHARMAPURI (Tamil Nadu),22,10
9.0,ELAYARANI. P.,Ganasangam Party of India,2301,14,2315,0.19,10 - DHARMAPURI (Tamil Nadu),22,10
10.0,ARUMUGAM. M.,Independent,2274,16,2290,0.18,10 - DHARMAPURI (Tamil Nadu),22,10
11.0,AGNI AALVAR,Independent,1643,8,1651,0.13,10 - DHARMAPURI (Tamil Nadu),22,10
12.0,PALANI. K.,Independent,1441,9,1450,0.12,10 - DHARMAPURI (Tamil Nadu),22,10
13.0,MANI. R.,Independent,1029,4,1033,0.08,10 - DHARMAPURI (Tamil Nadu),22,10
14.0,ASHOKAN. M.,Independent,1024,2,1026,0.08,10 - DHARMAPURI (Tamil Nadu),22,10
15.0,ALAGARASAN. R.,Independent,899,1,900,0.07,10 - DHARMAPURI (Tamil Nadu),22,10
16.0,SUNDHARAMOORTHY. M.,Independent,797,3,800,0.06,10 - DHARMAPURI (Tamil Nadu),22,10
17.0,MANI. C.,Independent,706,4,710,0.06,10 - DHARMAPURI (Tamil Nadu),22,10
18.0,PARTHASARATHI,Tamilar Makkal Katchi,698,11,709,0.06,10 - DHARMAPURI (Tamil Nadu),22,10
19.0,PADMARAJAN. K. DR.,Independent,649,8,657,0.05,10 - DHARMAPURI (Tamil Nadu),22,10
20.0,MANIVASAGAM. C.,Independent,648,3,651,0.05,10 - DHARMAPURI (Tamil Nadu),22,10
21.0,ASOKAN. G.,Independent,609,2,611,0.05,10 - DHARMAPURI (Tamil Nadu),22,10
22.0,AYYAKANNU,Independent,583,3,586,0.05,10 - DHARMAPURI (Tamil Nadu),22,10
23.0,JAGANATHAN. A.,Independent,551,2,553,0.04,10 - DHARMAPURI (Tamil Nadu),22,10
24.0,MANI. S.,Independent,451,1,452,0.04,10 - DHARMAPURI (Tamil Nadu),22,10
25.0,NOTA,None of the Above,9093,105,9198,0.74,10 - DHARMAPURI (Tamil Nadu),22,10
,Total,,1238428,9404,1247832,,10 - DHARMAPURI (Tamil Nadu),22,10
1.0,"ANNADURAI, C.N.",Dravida Munnetra Kazhagam,543857,3522,547379,47.75,11 - TIRUVANNAMALAI (Tamil Nadu),22,11
2.0,KALIYAPERUMAL M,All India Anna Dravida Munnetra Kazhagam,311384,2064,313448,27.34,11 - TIRUVANNAMALAI (Tamil Nadu),22,11
3.0,"ASUVATHAMAN, A.",Bharatiya Janata Party,154736,1914,156650,13.67,11 - TIRUVANNAMALAI (Tamil Nadu),22,11
4.0,"RAMESHBABU, R.",Naam Tamilar Katchi,83148,721,83869,7.32,11 - TIRUVANNAMALAI (Tamil Nadu),22,11
5.0,"KALIAPERUMAL, M.",Independent,5704,9,5713,0.5,11 - TIRUVANNAMALAI (Tamil Nadu),22,11
6.0,"BENNYRAJAN, C.J.",Bharatiya Praja Aikyata Party,4703,107,4810,0.42,11 - TIRUVANNAMALAI (Tamil Nadu),22,11
7.0,"KALIYAPERUMAL, A.",Independent,3402,5,3407,0.3,11 - TIRUVANNAMALAI (Tamil Nadu),22,11
8.0,"MOHANRAJA, V.M.",Bahujan Samaj Party,2615,22,2637,0.23,11 - TIRUVANNAMALAI (Tamil Nadu),22,11
9.0,CAPTAIN GOWTHAM,Independent,1823,19,1842,0.16,11 - TIRUVANNAMALAI (Tamil Nadu),22,11
10.0,"UDHAYAKUMAR, P.S.",Independent,1246,5,1251,0.11,11 - TIRUVANNAMALAI (Tamil Nadu),22,11
11.0,"ANNADURAI, S.",Independent,1165,7,1172,0.1,11 - TIRUVANNAMALAI (Tamil Nadu),22,11
12.0,"KOTHANDABANI, B.",Independent,963,2,965,0.08,11 - TIRUVANNAMALAI (Tamil Nadu),22,11
13.0,"SELVAM , K.",Veerath Thiyagi Viswanathadoss Thozhilalarkal Katchi,945,9,954,0.08,11 - TIRUVANNAMALAI (Tamil Nadu),22,11
14.0,"KALASTHIRI, S.",All India Uzhavargal Uzhaippalargal Katchi,934,16,950,0.08,11 - TIRUVANNAMALAI (Tamil Nadu),22,11
15.0,"VIJAYAKUMAR, S.",Independent,928,6,934,0.08,11 - TIRUVANNAMALAI (Tamil Nadu),22,11
16.0,"JAGANNATHAN, R.",Independent,857,7,864,0.08,11 - TIRUVANNAMALAI (Tamil Nadu),22,11
17.0,"SENTHAMIL SELVAN, M.",Independent,848,8,856,0.07,11 - TIRUVANNAMALAI (Tamil Nadu),22,11
18.0,"AGNI SELVARASU, J.",Naadaalum Makkal Katchi,759,18,777,0.07,11 - TIRUVANNAMALAI (Tamil Nadu),22,11
19.0,"SATHIYAMOORTHY, S.",Makkal Nala Kazhagam,716,20,736,0.06,11 - TIRUVANNAMALAI (Tamil Nadu),22,11
20.0,"ANNADURAI, S.",Independent,642,6,648,0.06,11 - TIRUVANNAMALAI (Tamil Nadu),22,11
21.0,"SUB MAJOR SETTU, M.",Viro Ke Vir Indian Party,636,22,658,0.06,11 - TIRUVANNAMALAI (Tamil Nadu),22,11
22.0,"SANKAR, S.",Independent,569,9,578,0.05,11 - TIRUVANNAMALAI (Tamil Nadu),22,11
23.0,"ANNADURAI, A.",Independent,482,34,516,0.05,11 - TIRUVANNAMALAI (Tamil Nadu),22,11
24.0,"NALLASIVAM, M.",Independent,426,3,429,0.04,11 - TIRUVANNAMALAI (Tamil Nadu),22,11
25.0,"PALANI , T.N.",Independent,413,1,414,0.04,11 - TIRUVANNAMALAI (Tamil Nadu),22,11
26.0,"POONGODY, A.",Independent,412,5,417,0.04,11 - TIRUVANNAMALAI (Tamil Nadu),22,11
27.0,"VIMAL, V.",Independent,341,1,342,0.03,11 - TIRUVANNAMALAI (Tamil Nadu),22,11
28.0,"THANGARAJ, P.",Independent,291,4,295,0.03,11 - TIRUVANNAMALAI (Tamil Nadu),22,11
29.0,"RAMESH , T.P.",Independent,280,1,281,0.02,11 - TIRUVANNAMALAI (Tamil Nadu),22,11
30.0,"NAKKEERAN , A.",Independent,260,5,265,0.02,11 - TIRUVANNAMALAI (Tamil Nadu),22,11
31.0,DEEPAMMAL SUNDARI,Independent,252,7,259,0.02,11 - TIRUVANNAMALAI (Tamil Nadu),22,11
32.0,NOTA,None of the Above,11527,430,11957,1.04,11 - TIRUVANNAMALAI (Tamil Nadu),22,11
,Total,,1137264,9009,1146273,,11 - TIRUVANNAMALAI (Tamil Nadu),22,11
1.0,THARANIVENTHAN M S,Dravida Munnetra Kazhagam,497083,3016,500099,43.86,12 - ARANI (Tamil Nadu),22,12
2.0,"GAJENDRAN, G.V.",All India Anna Dravida Munnetra Kazhagam,289650,1683,291333,25.55,12 - ARANI (Tamil Nadu),22,12
3.0,DR GANESH KUMAR A ME PHD,Pattali Makkal Katchi,234538,2033,236571,20.75,12 - ARANI (Tamil Nadu),22,12
4.0,"BAKIYALAKSHMI, K.",Naam Tamilar Katchi,65981,759,66740,5.85,12 - ARANI (Tamil Nadu),22,12
5.0,"MANIGANDAN, V.",Independent,4787,21,4808,0.42,12 - ARANI (Tamil Nadu),22,12
6.0,"GANESH KUMAR, U.",Independent,3809,3,3812,0.33,12 - ARANI (Tamil Nadu),22,12
7.0,DURAI M,Bahujan Samaj Party,3635,50,3685,0.32,12 - ARANI (Tamil Nadu),22,12
8.0,"GAJENDRAN, J.",Independent,3393,7,3400,0.3,12 - ARANI (Tamil Nadu),22,12
9.0,"KARVANNAN, K.",Independent,3032,4,3036,0.27,12 - ARANI (Tamil Nadu),22,12
10.0,"GAJENDIRAN, E.",Independent,2612,1,2613,0.23,12 - ARANI (Tamil Nadu),22,12
11.0,"KOTTAI VENKATESAN, M.",Independent,1893,15,1908,0.17,12 - ARANI (Tamil Nadu),22,12
12.0,"SENTHIL KUMAR, D.",Independent,1469,6,1475,0.13,12 - ARANI (Tamil Nadu),22,12
13.0,"SEKAR, N.",Independent,1397,3,1400,0.12,12 - ARANI (Tamil Nadu),22,12
14.0,SAKTHIVEL A,Thakkam Katchi,1174,12,1186,0.1,12 - ARANI (Tamil Nadu),22,12
15.0,"GANESH, P.",Independent,978,2,980,0.09,12 - ARANI (Tamil Nadu),22,12
16.0,NAGARAJAN P,Veerath Thiyagi Viswanathadoss Thozhilalarkal Katchi,921,6,927,0.08,12 - ARANI (Tamil Nadu),22,12
17.0,CAPTAIN SETTU M,Viro Ke Vir Indian Party,881,41,922,0.08,12 - ARANI (Tamil Nadu),22,12
18.0,"JAISANKAR, M.",Independent,836,4,840,0.07,12 - ARANI (Tamil Nadu),22,12
19.0,EZHIL ARASU M,Independent,741,12,753,0.07,12 - ARANI (Tamil Nadu),22,12
20.0,BABU N,Independent,669,5,674,0.06,12 - ARANI (Tamil Nadu),22,12
21.0,"DURUGAN, M.",United Republican Party of India,596,8,604,0.05,12 - ARANI (Tamil Nadu),22,12
22.0,MOHMMAD SIDDIQ M H,Independent,525,3,528,0.05,12 - ARANI (Tamil Nadu),22,12
23.0,"DHARANI, D.",Independent,466,2,468,0.04,12 - ARANI (Tamil Nadu),22,12
24.0,"MANAVALAN, A.",Anna MGR Dravida Makkal Kalgam,433,47,480,0.04,12 - ARANI (Tamil Nadu),22,12
25.0,"ARUL, M.",Independent,429,81,510,0.04,12 - ARANI (Tamil Nadu),22,12
26.0,"MURUGESAN, D.",Independent,398,5,403,0.04,12 - ARANI (Tamil Nadu),22,12
27.0,"ELLAPPAN, R.",Independent,375,3,378,0.03,12 - ARANI (Tamil Nadu),22,12
28.0,"FEROZKHAN, A.",Independent,295,3,298,0.03,12 - ARANI (Tamil Nadu),22,12
29.0,"DHAMODHARAN, G.",Independent,237,5,242,0.02,12 - ARANI (Tamil Nadu),22,12
30.0,NOTA,None of the Above,9084,104,9188,0.81,12 - ARANI (Tamil Nadu),22,12
,Total,,1132317,7944,1140261,,12 - ARANI (Tamil Nadu),22,12
1.0,RAVIKUMAR. D,Viduthalai Chiruthaigal Katchi,474230,2803,477033,41.39,13 - VILUPPURAM (Tamil Nadu),22,13
2.0,BHAGYARAJ. J,All India Anna Dravida Munnetra Kazhagam,404503,1827,406330,35.25,13 - VILUPPURAM (Tamil Nadu),22,13
3.0,MURALI SANKAR. S,Pattali Makkal Katchi,180020,1862,181882,15.78,13 - VILUPPURAM (Tamil Nadu),22,13
4.0,KALANCHIYAM. M,Naam Tamilar Katchi,56766,476,57242,4.97,13 - VILUPPURAM (Tamil Nadu),22,13
5.0,KARUNCHIRUTHAI KALIYAMURTHY. K,Bahujan Samaj Party,3883,37,3920,0.34,13 - VILUPPURAM (Tamil Nadu),22,13
6.0,ARUMUGAM. M,United Republican Party of India,3487,17,3504,0.3,13 - VILUPPURAM (Tamil Nadu),22,13
7.0,DHARMA. K,Independent,2375,7,2382,0.21,13 - VILUPPURAM (Tamil Nadu),22,13
8.0,VIVEKANANDHAN. E,Independent,1945,8,1953,0.17,13 - VILUPPURAM (Tamil Nadu),22,13
9.0,ARASAN. K,Independent,1835,7,1842,0.16,13 - VILUPPURAM (Tamil Nadu),22,13
10.0,VIGNESVARAN. R,Independent,1643,13,1656,0.14,13 - VILUPPURAM (Tamil Nadu),22,13
11.0,SURESH. S,Independent,1374,23,1397,0.12,13 - VILUPPURAM (Tamil Nadu),22,13
12.0,PERIYAN. A,Independent,1041,8,1049,0.09,13 - VILUPPURAM (Tamil Nadu),22,13
13.0,GUNASEKARAN. K,Independent,960,3,963,0.08,13 - VILUPPURAM (Tamil Nadu),22,13
14.0,VIJAYAN. A,Independent,859,2,861,0.07,13 - VILUPPURAM (Tamil Nadu),22,13
15.0,NAGARAJ. A,Independent,669,5,674,0.06,13 - VILUPPURAM (Tamil Nadu),22,13
16.0,SURESH. K,Independent,592,6,598,0.05,13 - VILUPPURAM (Tamil Nadu),22,13
17.0,SATHIYARAJ. N,Independent,412,3,415,0.04,13 - VILUPPURAM (Tamil Nadu),22,13
18.0,NOTA,None of the Above,8874,92,8966,0.78,13 - VILUPPURAM (Tamil Nadu),22,13
,Total,,1145468,7199,1152667,,13 - VILUPPURAM (Tamil Nadu),22,13
1.0,MALAIYARASAN D,Dravida Munnetra Kazhagam,558346,3243,561589,44.94,14 - KALLAKURICHI (Tamil Nadu),22,14
2.0,KUMARAGURU R,All India Anna Dravida Munnetra Kazhagam,505577,2228,507805,40.64,14 - KALLAKURICHI (Tamil Nadu),22,14
3.0,JAGADESAN A,Naam Tamilar Katchi,73098,554,73652,5.89,14 - KALLAKURICHI (Tamil Nadu),22,14
4.0,DEVADASS RAMASAMY,Pattali Makkal Katchi,70633,657,71290,5.71,14 - KALLAKURICHI (Tamil Nadu),22,14
5.0,PRABU C,Independent,4268,7,4275,0.34,14 - KALLAKURICHI (Tamil Nadu),22,14
6.0,BALAKRISHNAN P,Independent,3468,1,3469,0.28,14 - KALLAKURICHI (Tamil Nadu),22,14
7.0,JEEVANRAJ N,Bahujan Samaj Party,3075,21,3096,0.25,14 - KALLAKURICHI (Tamil Nadu),22,14
8.0,MAYILAMPARAI MARI A,Independent,2891,1,2892,0.23,14 - KALLAKURICHI (Tamil Nadu),22,14
9.0,NATTANMAI GUNASEKARANA A.S,Anna Makkal Katchi,2497,8,2505,0.2,14 - KALLAKURICHI (Tamil Nadu),22,14
10.0,KUMARAGURU N,Independent,2226,1,2227,0.18,14 - KALLAKURICHI (Tamil Nadu),22,14
11.0,MURUGESAN M,Independent,2223,2,2225,0.18,14 - KALLAKURICHI (Tamil Nadu),22,14
12.0,SUBRAMANIAN R K,Independent,868,4,872,0.07,14 - KALLAKURICHI (Tamil Nadu),22,14
13.0,ARUL INIYAN A,Independent,772,12,784,0.06,14 - KALLAKURICHI (Tamil Nadu),22,14
14.0,VENKATRAMAN J,Naadaalum Makkal Katchi,687,4,691,0.06,14 - KALLAKURICHI (Tamil Nadu),22,14
15.0,KAMALAKANNAN M,Independent,629,1,630,0.05,14 - KALLAKURICHI (Tamil Nadu),22,14
16.0,GOVINDARAJ S R,Independent,533,25,558,0.04,14 - KALLAKURICHI (Tamil Nadu),22,14
17.0,PALANIYAMMAL S,Desiya Makkal Sakthi Katchi,533,15,548,0.04,14 - KALLAKURICHI (Tamil Nadu),22,14
18.0,SIGAMANI A,Independent,515,27,542,0.04,14 - KALLAKURICHI (Tamil Nadu),22,14
19.0,RAJASEKAR K,Independent,501,10,511,0.04,14 - KALLAKURICHI (Tamil Nadu),22,14
20.0,JAYABAL PM,Independent,473,3,476,0.04,14 - KALLAKURICHI (Tamil Nadu),22,14
21.0,RAJAMANICKAM C,Independent,398,1,399,0.03,14 - KALLAKURICHI (Tamil Nadu),22,14
22.0,NOTA,None of the Above,8351,181,8532,0.68,14 - KALLAKURICHI (Tamil Nadu),22,14
,Total,,1242562,7006,1249568,,14 - KALLAKURICHI (Tamil Nadu),22,14
1.0,SELVAGANAPATHI T M,Dravida Munnetra Kazhagam,562022,4063,566085,43.38,15 - SALEM (Tamil Nadu),22,15
2.0,VIGNESH P,All India Anna Dravida Munnetra Kazhagam,492958,2770,495728,37.99,15 - SALEM (Tamil Nadu),22,15
3.0,ANNADURAI N,Pattali Makkal Katchi,125829,1310,127139,9.74,15 - SALEM (Tamil Nadu),22,15
4.0,DR MANOJKUMAR G,Naam Tamilar Katchi,75636,571,76207,5.84,15 - SALEM (Tamil Nadu),22,15
5.0,BHALAJI M,Independent,3437,4,3441,0.26,15 - SALEM (Tamil Nadu),22,15
6.0,MURALI S,Bahujan Samaj Party,3333,39,3372,0.26,15 - SALEM (Tamil Nadu),22,15
7.0,PALANIVEL K,Independent,2853,3,2856,0.22,15 - SALEM (Tamil Nadu),22,15
8.0,JEGANNATHAN A,Independent,2384,27,2411,0.18,15 - SALEM (Tamil Nadu),22,15
9.0,RAJA S,Independent,1442,14,1456,0.11,15 - SALEM (Tamil Nadu),22,15
10.0,MUTHUSAMY S,Independent,1193,4,1197,0.09,15 - SALEM (Tamil Nadu),22,15
11.0,ER PRABAKARAN S,Independent,1151,4,1155,0.09,15 - SALEM (Tamil Nadu),22,15
12.0,SHANMUGAM G,Independent,1144,3,1147,0.09,15 - SALEM (Tamil Nadu),22,15
13.0,SANTHALINGAM C,Independent,1079,19,1098,0.08,15 - SALEM (Tamil Nadu),22,15
14.0,SUTHARSANAM S,Aravor Munnetra Kazhagam,1030,6,1036,0.08,15 - SALEM (Tamil Nadu),22,15
15.0,AMBEDKAR C,Ambedkarite Party of India,944,17,961,0.07,15 - SALEM (Tamil Nadu),22,15
16.0,RAMACHANDRAN C,Dhesiya Makkal Kazhagam,748,10,758,0.06,15 - SALEM (Tamil Nadu),22,15
17.0,GOVINDHAN A,Independent,686,7,693,0.05,15 - SALEM (Tamil Nadu),22,15
18.0,MANICKAM R,Ulzaipali Makkal Katchy,533,4,537,0.04,15 - SALEM (Tamil Nadu),22,15
19.0,AHAMED SHAHJAHAN M,Independent,453,13,466,0.04,15 - SALEM (Tamil Nadu),22,15
20.0,INTHRAJITHKUPTHA G,Independent,425,7,432,0.03,15 - SALEM (Tamil Nadu),22,15
21.0,RAMASUNDARAM D,Independent,419,3,422,0.03,15 - SALEM (Tamil Nadu),22,15
22.0,KARUNAKARAN M,Independent,359,18,377,0.03,15 - SALEM (Tamil Nadu),22,15
23.0,RAJA A,Independent,329,3,332,0.03,15 - SALEM (Tamil Nadu),22,15
24.0,VIGNESH M,Independent,324,4,328,0.03,15 - SALEM (Tamil Nadu),22,15
25.0,JOTHILINGAM M,Independent,314,2,316,0.02,15 - SALEM (Tamil Nadu),22,15
26.0,NOTA,None of the Above,14677,217,14894,1.14,15 - SALEM (Tamil Nadu),22,15
,Total,,1295702,9142,1304844,,15 - SALEM (Tamil Nadu),22,15
1.0,MATHESWARAN V S,Dravida Munnetra Kazhagam,457695,4341,462036,40.31,16 - NAMAKKAL (Tamil Nadu),22,16
2.0,TAMILMANI S,All India Anna Dravida Munnetra Kazhagam,429358,3566,432924,37.77,16 - NAMAKKAL (Tamil Nadu),22,16
3.0,DR RAMALINGAM K P,Bharatiya Janata Party,103577,1113,104690,9.13,16 - NAMAKKAL (Tamil Nadu),22,16
4.0,KANIMOZHI G,Naam Tamilar Katchi,94895,682,95577,8.34,16 - NAMAKKAL (Tamil Nadu),22,16
5.0,DEEPAN CHAKKRAVARTHI S,Independent,3546,33,3579,0.31,16 - NAMAKKAL (Tamil Nadu),22,16
6.0,RAJENDRAN C,Viduthalai Kalam Katchi,2592,7,2599,0.23,16 - NAMAKKAL (Tamil Nadu),22,16
7.0,NATARAJAN M,Independent,2565,23,2588,0.23,16 - NAMAKKAL (Tamil Nadu),22,16
8.0,RAMESH T,Ahimsa Socialist Party,2412,9,2421,0.21,16 - NAMAKKAL (Tamil Nadu),22,16
9.0,EZHIL SELVAN P,Tamilaga Makkal Thannurimai Katchi,2149,16,2165,0.19,16 - NAMAKKAL (Tamil Nadu),22,16
10.0,RAMAN V,Bahujan Samaj Party,2137,20,2157,0.19,16 - NAMAKKAL (Tamil Nadu),22,16
11.0,UTHAYAKUMAR P,Independent,1899,2,1901,0.17,16 - NAMAKKAL (Tamil Nadu),22,16
12.0,KANDASAMY A M,Independent,1510,4,1514,0.13,16 - NAMAKKAL (Tamil Nadu),22,16
13.0,RAMASAMY P,Independent,1338,12,1350,0.12,16 - NAMAKKAL (Tamil Nadu),22,16
14.0,KARTHI S,Independent,1332,2,1334,0.12,16 - NAMAKKAL (Tamil Nadu),22,16
15.0,RAMESH T R,Independent,1317,8,1325,0.12,16 - NAMAKKAL (Tamil Nadu),22,16
16.0,SATHEESH G,Independent,1284,8,1292,0.11,16 - NAMAKKAL (Tamil Nadu),22,16
17.0,RAMASAMY N,Independent,1243,7,1250,0.11,16 - NAMAKKAL (Tamil Nadu),22,16
18.0,MADHESWARAN V,Independent,1144,3,1147,0.1,16 - NAMAKKAL (Tamil Nadu),22,16
19.0,DR GURUNATHAN S,Independent,1048,23,1071,0.09,16 - NAMAKKAL (Tamil Nadu),22,16
20.0,KARTHIKEYAN S,Independent,918,2,920,0.08,16 - NAMAKKAL (Tamil Nadu),22,16
21.0,NALLATHAMBI P,Independent,769,1,770,0.07,16 - NAMAKKAL (Tamil Nadu),22,16
22.0,EASWARAMOORTHY M,Independent,758,10,768,0.07,16 - NAMAKKAL (Tamil Nadu),22,16
23.0,BALAJICHEZHIAN P,Independent,716,3,719,0.06,16 - NAMAKKAL (Tamil Nadu),22,16
24.0,RAVIKUMAR P,Ganasangam Party of India,633,4,637,0.06,16 - NAMAKKAL (Tamil Nadu),22,16
25.0,NAVEEN K,Independent,633,2,635,0.06,16 - NAMAKKAL (Tamil Nadu),22,16
26.0,DURAIRAJ C,Independent,590,2,592,0.05,16 - NAMAKKAL (Tamil Nadu),22,16
27.0,ARULMANI M,Independent,564,4,568,0.05,16 - NAMAKKAL (Tamil Nadu),22,16
28.0,THIYAGARAJAN R,Samaniya Makkal Nala Katchi,527,1,528,0.05,16 - NAMAKKAL (Tamil Nadu),22,16
29.0,VENNILA S,Independent,520,8,528,0.05,16 - NAMAKKAL (Tamil Nadu),22,16
30.0,KALIANNAN S,Independent,496,1,497,0.04,16 - NAMAKKAL (Tamil Nadu),22,16
31.0,KANDASAMY P,Independent,475,5,480,0.04,16 - NAMAKKAL (Tamil Nadu),22,16
32.0,MANIKKAM S,Ulzaipali Makkal Katchy,439,3,442,0.04,16 - NAMAKKAL (Tamil Nadu),22,16
33.0,MOORTHI J,Independent,385,4,389,0.03,16 - NAMAKKAL (Tamil Nadu),22,16
34.0,TAMILMANI A,Independent,352,2,354,0.03,16 - NAMAKKAL (Tamil Nadu),22,16
35.0,SELVARAJ K R,Independent,301,2,303,0.03,16 - NAMAKKAL (Tamil Nadu),22,16
36.0,SAKTHIVEL S,Independent,298,1,299,0.03,16 - NAMAKKAL (Tamil Nadu),22,16
37.0,NETAJIKAVIARASU V,Independent,287,1,288,0.03,16 - NAMAKKAL (Tamil Nadu),22,16
38.0,SIVAKUMAR V,Independent,244,2,246,0.02,16 - NAMAKKAL (Tamil Nadu),22,16
39.0,MOORTHY V,Independent,220,2,222,0.02,16 - NAMAKKAL (Tamil Nadu),22,16
40.0,GOPAL P,Independent,214,-,214,0.02,16 - NAMAKKAL (Tamil Nadu),22,16
41.0,NOTA,None of the Above,12736,248,12984,1.13,16 - NAMAKKAL (Tamil Nadu),22,16
,Total,,1136116,10187,1146303,,16 - NAMAKKAL (Tamil Nadu),22,16
1.0,K E PRAKASH,Dravida Munnetra Kazhagam,558849,3490,562339,51.43,17 - ERODE (Tamil Nadu),22,17
2.0,ASHOK KUMAR,All India Anna Dravida Munnetra Kazhagam,323751,2022,325773,29.79,17 - ERODE (Tamil Nadu),22,17
3.0,KARMEGAN M,Naam Tamilar Katchi,82332,464,82796,7.57,17 - ERODE (Tamil Nadu),22,17
4.0,P VIJAYAKUMAR,Tamil Maanila Congress (Moopanar),77319,592,77911,7.13,17 - ERODE (Tamil Nadu),22,17
5.0,P ESWARAN,Bahujan Samaj Party,5161,62,5223,0.48,17 - ERODE (Tamil Nadu),22,17
6.0,T V R AMIRTHALINGAM,Independent,4118,31,4149,0.38,17 - ERODE (Tamil Nadu),22,17
7.0,KEERTHANA M,Independent,3775,24,3799,0.35,17 - ERODE (Tamil Nadu),22,17
8.0,J GOPALAKRISHNAN,Independent,1949,6,1955,0.18,17 - ERODE (Tamil Nadu),22,17
9.0,S ANANTHI,Independent,1683,3,1686,0.15,17 - ERODE (Tamil Nadu),22,17
10.0,PRASATH CHITRARASU,Independent,1629,11,1640,0.15,17 - ERODE (Tamil Nadu),22,17
11.0,RAVICHANDRAN L,Independent,1378,2,1380,0.13,17 - ERODE (Tamil Nadu),22,17
12.0,P RAJENDRAN,Independent,973,3,976,0.09,17 - ERODE (Tamil Nadu),22,17
13.0,P KUPPUSAMY,Ulzaipali Makkal Katchy,945,5,950,0.09,17 - ERODE (Tamil Nadu),22,17
14.0,M SHANMUGAM,Independent,768,4,772,0.07,17 - ERODE (Tamil Nadu),22,17
15.0,R KUMARESAN,Independent,744,7,751,0.07,17 - ERODE (Tamil Nadu),22,17
16.0,N ASHOK KUMAR,Independent,689,1,690,0.06,17 - ERODE (Tamil Nadu),22,17
17.0,DHANALAKSHMI V,Naadaalum Makkal Katchi,675,4,679,0.06,17 - ERODE (Tamil Nadu),22,17
18.0,A T MUNUSAMY,Samaniya Makkal Nala Katchi,611,5,616,0.06,17 - ERODE (Tamil Nadu),22,17
19.0,K MAATHAN,Ganasangam Party of India,609,9,618,0.06,17 - ERODE (Tamil Nadu),22,17
20.0,B DHARMARAJ,Anti Corruption Dynamic Party,597,4,601,0.05,17 - ERODE (Tamil Nadu),22,17
21.0,ARUMUGA AC KANNAN,Independent,547,2,549,0.05,17 - ERODE (Tamil Nadu),22,17
22.0,M SABARINATHAN,Independent,525,6,531,0.05,17 - ERODE (Tamil Nadu),22,17
23.0,R DHANDAPANI,Veerath Thiyagi Viswanathadoss Thozhilalarkal Katchi,502,2,504,0.05,17 - ERODE (Tamil Nadu),22,17
24.0,R KUMAR,Anna Puratchi Thalaivar Amma Dravida Munnetra Kazhagam,424,8,432,0.04,17 - ERODE (Tamil Nadu),22,17
25.0,R.MINNALMURUGESH,Independent,413,2,415,0.04,17 - ERODE (Tamil Nadu),22,17
26.0,K K VADUGANATHAN,Independent,398,1,399,0.04,17 - ERODE (Tamil Nadu),22,17
27.0,G MYLSAMY,Independent,301,-,301,0.03,17 - ERODE (Tamil Nadu),22,17
28.0,MYLVAKANAN D -,Independent,276,3,279,0.03,17 - ERODE (Tamil Nadu),22,17
29.0,M PRABAKARAN,Independent,274,2,276,0.03,17 - ERODE (Tamil Nadu),22,17
30.0,NARENDRANATH,Independent,272,-,272,0.02,17 - ERODE (Tamil Nadu),22,17
31.0,K SENTHIL KUMAR,Independent,177,1,178,0.02,17 - ERODE (Tamil Nadu),22,17
32.0,NOTA,None of the Above,13742,241,13983,1.28,17 - ERODE (Tamil Nadu),22,17
,Total,,1086406,7017,1093423,,17 - ERODE (Tamil Nadu),22,17
1.0,"SUBBARAYAN, K.",Communist Party of India,470195,2544,472739,41.38,18 - TIRUPPUR (Tamil Nadu),22,18
2.0,"ARUNACHALAM, P.",All India Anna Dravida Munnetra Kazhagam,345326,1485,346811,30.35,18 - TIRUPPUR (Tamil Nadu),22,18
3.0,"MURUGANANDAM, A.P.",Bharatiya Janata Party,184066,1256,185322,16.22,18 - TIRUPPUR (Tamil Nadu),22,18
4.0,"SEETHALAKSHMI, M.K.",Naam Tamilar Katchi,95250,476,95726,8.38,18 - TIRUPPUR (Tamil Nadu),22,18
5.0,"VELUSAMY, A.",Independent,7089,36,7125,0.62,18 - TIRUPPUR (Tamil Nadu),22,18
6.0,"PALANI, V.",Bahujan Samaj Party,6013,41,6054,0.53,18 - TIRUPPUR (Tamil Nadu),22,18
7.0,"SATHISHKUMAR, N.",Independent,2315,21,2336,0.2,18 - TIRUPPUR (Tamil Nadu),22,18
8.0,"JANARTHANAM, P.",Tamilaga Makkal Thannurimai Katchi,1861,7,1868,0.16,18 - TIRUPPUR (Tamil Nadu),22,18
9.0,"KANNAN, M.",Independent,1752,13,1765,0.15,18 - TIRUPPUR (Tamil Nadu),22,18
10.0,"SENGUTTUVAN, M.R.",Independent,1560,7,1567,0.14,18 - TIRUPPUR (Tamil Nadu),22,18
11.0,"SUBRAMANI, N.",Independent,1341,9,1350,0.12,18 - TIRUPPUR (Tamil Nadu),22,18
12.0,"MALARVIZHI, G.",Rashtriya Samaj Paksha,1311,14,1325,0.12,18 - TIRUPPUR (Tamil Nadu),22,18
13.0,"KARTHIKEYAN, P.",Independent,810,14,824,0.07,18 - TIRUPPUR (Tamil Nadu),22,18
14.0,NOTA,None of the Above,17554,183,17737,1.55,18 - TIRUPPUR (Tamil Nadu),22,18
,Total,,1136443,6106,1142549,,18 - TIRUPPUR (Tamil Nadu),22,18
1.0,RAJA A,Dravida Munnetra Kazhagam,470729,2483,473212,46.44,19 - NILGIRIS (Tamil Nadu),22,19
2.0,DR MURUGAN L,Bharatiya Janata Party,231111,1516,232627,22.83,19 - NILGIRIS (Tamil Nadu),22,19
3.0,LOGESH TAMILSELVAN D,All India Anna Dravida Munnetra Kazhagam,219417,813,220230,21.61,19 - NILGIRIS (Tamil Nadu),22,19
4.0,JAYAKUMAR A,Naam Tamilar Katchi,58588,233,58821,5.77,19 - NILGIRIS (Tamil Nadu),22,19
5.0,VIJAYAKUMAR D,Independent,4805,3,4808,0.47,19 - NILGIRIS (Tamil Nadu),22,19
6.0,GANESHAMOORTHI A,Bahujan Samaj Party,3015,18,3033,0.3,19 - NILGIRIS (Tamil Nadu),22,19
7.0,BADRAN M,Ganasangam Party of India,2406,19,2425,0.24,19 - NILGIRIS (Tamil Nadu),22,19
8.0,SELVAN N,Independent,2038,16,2054,0.2,19 - NILGIRIS (Tamil Nadu),22,19
9.0,DHANABAL R,Independent,1906,22,1928,0.19,19 - NILGIRIS (Tamil Nadu),22,19
10.0,JAYANTHI M,Ambedkarite Party of India,1539,17,1556,0.15,19 - NILGIRIS (Tamil Nadu),22,19
11.0,MURUGAN Y,Independent,1408,5,1413,0.14,19 - NILGIRIS (Tamil Nadu),22,19
12.0,MURUGESAN,Independent,1057,2,1059,0.1,19 - NILGIRIS (Tamil Nadu),22,19
13.0,MALARMANNAN M,Samaniya Makkal Nala Katchi,813,7,820,0.08,19 - NILGIRIS (Tamil Nadu),22,19
14.0,SATHISH M,Independent,734,6,740,0.07,19 - NILGIRIS (Tamil Nadu),22,19
15.0,KRISHNA KUMAR,Independent,588,27,615,0.06,19 - NILGIRIS (Tamil Nadu),22,19
16.0,ANBHUGURU V,Independent,560,5,565,0.06,19 - NILGIRIS (Tamil Nadu),22,19
17.0,NOTA,None of the Above,12902,98,13000,1.28,19 - NILGIRIS (Tamil Nadu),22,19
,Total,,1013616,5290,1018906,,19 - NILGIRIS (Tamil Nadu),22,19
1.0,GANAPATHY RAJKUMAR P,Dravida Munnetra Kazhagam,565428,2772,568200,41.39,20 - COIMBATORE (Tamil Nadu),22,20
2.0,ANNAMALAI K,Bharatiya Janata Party,447608,2524,450132,32.79,20 - COIMBATORE (Tamil Nadu),22,20
3.0,SINGAI G RAMACHANDRAN,All India Anna Dravida Munnetra Kazhagam,235603,887,236490,17.23,20 - COIMBATORE (Tamil Nadu),22,20
4.0,KALAMANI JAGANATHAN,Naam Tamilar Katchi,82387,270,82657,6.02,20 - COIMBATORE (Tamil Nadu),22,20
5.0,VELMURUGAN K,Bahujan Samaj Party,2364,11,2375,0.17,20 - COIMBATORE (Tamil Nadu),22,20
6.0,SANJAYKUMAR S,Independent,1787,2,1789,0.13,20 - COIMBATORE (Tamil Nadu),22,20
7.0,ANNADURAI R,Independent,1767,5,1772,0.13,20 - COIMBATORE (Tamil Nadu),22,20
8.0,SURESH M,Independent,1472,2,1474,0.11,20 - COIMBATORE (Tamil Nadu),22,20
9.0,GOPALAKRISHNAN S,Independent,1196,3,1199,0.09,20 - COIMBATORE (Tamil Nadu),22,20
10.0,RAGHUL GANDHI K,Hindustan Janta Party,1170,6,1176,0.09,20 - COIMBATORE (Tamil Nadu),22,20
11.0,KARTHICK T,Independent,1070,3,1073,0.08,20 - COIMBATORE (Tamil Nadu),22,20
12.0,RAJKUMAR M,Independent,1067,1,1068,0.08,20 - COIMBATORE (Tamil Nadu),22,20
13.0,RAJKUMAR,Independent,1010,3,1013,0.07,20 - COIMBATORE (Tamil Nadu),22,20
14.0,RAJKUMAR G,Independent,888,4,892,0.06,20 - COIMBATORE (Tamil Nadu),22,20
15.0,SHANMUGAM K,Independent,881,1,882,0.06,20 - COIMBATORE (Tamil Nadu),22,20
16.0,KRISHNAN V,Independent,722,4,726,0.05,20 - COIMBATORE (Tamil Nadu),22,20
17.0,RAMACHANDRAN M,Independent,663,-,663,0.05,20 - COIMBATORE (Tamil Nadu),22,20
18.0,RAJAMANICKAM N,Independent,626,3,629,0.05,20 - COIMBATORE (Tamil Nadu),22,20
19.0,RAJKUMAR G B,Independent,607,4,611,0.04,20 - COIMBATORE (Tamil Nadu),22,20
20.0,KUMAR A,Ganasangam Party of India,548,3,551,0.04,20 - COIMBATORE (Tamil Nadu),22,20
21.0,SANGEETHA R,Naadaalum Makkal Katchi,491,1,492,0.04,20 - COIMBATORE (Tamil Nadu),22,20
22.0,RICHARD VINCENT,Viro Ke Vir Indian Party,489,3,492,0.04,20 - COIMBATORE (Tamil Nadu),22,20
23.0,SURIYAKUMAR K,Independent,443,4,447,0.03,20 - COIMBATORE (Tamil Nadu),22,20
24.0,ARUNKANTH V,Independent,432,6,438,0.03,20 - COIMBATORE (Tamil Nadu),22,20
25.0,ANANDHAKUMAR S,Rashtriya Samaj Paksha,417,2,419,0.03,20 - COIMBATORE (Tamil Nadu),22,20
26.0,RAMACHANDRAN R,Independent,368,1,369,0.03,20 - COIMBATORE (Tamil Nadu),22,20
27.0,MUTHUSAMY P P,Independent,368,1,369,0.03,20 - COIMBATORE (Tamil Nadu),22,20
28.0,PALANISAMYRAAJ M,Independent,313,3,316,0.02,20 - COIMBATORE (Tamil Nadu),22,20
29.0,PUSHPANANTHAM V,Tamizhaga Murpokku Makkal Katchi,303,2,305,0.02,20 - COIMBATORE (Tamil Nadu),22,20
30.0,DINESH K,Independent,284,1,285,0.02,20 - COIMBATORE (Tamil Nadu),22,20
31.0,PREMKUMAR P,Independent,281,2,283,0.02,20 - COIMBATORE (Tamil Nadu),22,20
32.0,RAVICHANDRAN,Independent,271,1,272,0.02,20 - COIMBATORE (Tamil Nadu),22,20
33.0,DURAISAMY A,Independent,263,3,266,0.02,20 - COIMBATORE (Tamil Nadu),22,20
34.0,ZAHIR HUSSAIN,Independent,259,1,260,0.02,20 - COIMBATORE (Tamil Nadu),22,20
35.0,BOOBALAN,Independent,252,1,253,0.02,20 - COIMBATORE (Tamil Nadu),22,20
36.0,NOORMUHAMAD A,Independent,232,2,234,0.02,20 - COIMBATORE (Tamil Nadu),22,20
37.0,PASUPATHI S,Independent,170,3,173,0.01,20 - COIMBATORE (Tamil Nadu),22,20
38.0,NOTA,None of the Above,11677,111,11788,0.86,20 - COIMBATORE (Tamil Nadu),22,20
,Total,,1366177,6656,1372833,,20 - COIMBATORE (Tamil Nadu),22,20
1.0,ESWARASAMY K,Dravida Munnetra Kazhagam,530742,2635,533377,47.37,21 - POLLACHI (Tamil Nadu),22,21
2.0,KARTHIKEYAN A,All India Anna Dravida Munnetra Kazhagam,280230,1105,281335,24.98,21 - POLLACHI (Tamil Nadu),22,21
3.0,VASANTHARAJAN K,Bharatiya Janata Party,221945,1409,223354,19.84,21 - POLLACHI (Tamil Nadu),22,21
4.0,SURESHKUMAR N,Naam Tamilar Katchi,57962,234,58196,5.17,21 - POLLACHI (Tamil Nadu),22,21
5.0,PRAKASH P,Independent,2834,17,2851,0.25,21 - POLLACHI (Tamil Nadu),22,21
6.0,BENJAMINKIRUBAKARAN J,Bahujan Samaj Party,2267,17,2284,0.2,21 - POLLACHI (Tamil Nadu),22,21
7.0,VASANTHAKUMAR T,Independent,2186,4,2190,0.19,21 - POLLACHI (Tamil Nadu),22,21
8.0,RAMASAMY K,Independent,1816,9,1825,0.16,21 - POLLACHI (Tamil Nadu),22,21
9.0,ESWARASAMY K,Independent,1775,15,1790,0.16,21 - POLLACHI (Tamil Nadu),22,21
10.0,GOPALAKRISHNAN M,New Generation People’s Party,1127,6,1133,0.1,21 - POLLACHI (Tamil Nadu),22,21
11.0,KALIMUTHU S,Independent,976,5,981,0.09,21 - POLLACHI (Tamil Nadu),22,21
12.0,KARTHIKEYAN D,Independent,600,19,619,0.05,21 - POLLACHI (Tamil Nadu),22,21
13.0,NOOR MUHAMAD A,Independent,599,6,605,0.05,21 - POLLACHI (Tamil Nadu),22,21
14.0,KARTHIKEYAN P,Independent,548,19,567,0.05,21 - POLLACHI (Tamil Nadu),22,21
15.0,KARTHIKEYAN D,Independent,433,2,435,0.04,21 - POLLACHI (Tamil Nadu),22,21
16.0,NOTA,None of the Above,14399,104,14503,1.29,21 - POLLACHI (Tamil Nadu),22,21
,Total,,1120439,5606,1126045,,21 - POLLACHI (Tamil Nadu),22,21
1.0,SACHITHANANTHAM R,Communist Party of India (Marxist),667391,2758,670149,58.29,22 - DINDIGUL (Tamil Nadu),22,22
2.0,MOHAMED MUBARAK M A,All India Anna Dravida Munnetra Kazhagam,225492,836,226328,19.69,22 - DINDIGUL (Tamil Nadu),22,22
3.0,THILGABAMA M,Pattali Makkal Katchi,111013,1490,112503,9.79,22 - DINDIGUL (Tamil Nadu),22,22
4.0,KAILAI RAJAN D,Naam Tamilar Katchi,96891,954,97845,8.51,22 - DINDIGUL (Tamil Nadu),22,22
5.0,RAJKUMAR R,Independent,4410,6,4416,0.38,22 - DINDIGUL (Tamil Nadu),22,22
6.0,NATCHIMUTHU S,Bahujan Samaj Party,4231,53,4284,0.37,22 - DINDIGUL (Tamil Nadu),22,22
7.0,DINESHKUMAR S,All India Youth Development Party,2411,23,2434,0.21,22 - DINDIGUL (Tamil Nadu),22,22
8.0,MURUGESAN (A) VISHNU MURUGESAN C,Independent,2004,4,2008,0.17,22 - DINDIGUL (Tamil Nadu),22,22
9.0,ANGUCHAMY M,Independent,1286,4,1290,0.11,22 - DINDIGUL (Tamil Nadu),22,22
10.0,SURESH K,Independent,1254,3,1257,0.11,22 - DINDIGUL (Tamil Nadu),22,22
11.0,ARUMUGAM R,Independent,1078,11,1089,0.09,22 - DINDIGUL (Tamil Nadu),22,22
12.0,SABARINATH S,Independent,1001,10,1011,0.09,22 - DINDIGUL (Tamil Nadu),22,22
13.0,ANBUROSE D,Independent,997,15,1012,0.09,22 - DINDIGUL (Tamil Nadu),22,22
14.0,PALANISAMY K,Independent,941,8,949,0.08,22 - DINDIGUL (Tamil Nadu),22,22
15.0,SATHISH KANNA G T,Independent,914,12,926,0.08,22 - DINDIGUL (Tamil Nadu),22,22
16.0,NOTA,None of the Above,21860,260,22120,1.92,22 - DINDIGUL (Tamil Nadu),22,22
,Total,,1143174,6447,1149621,,22 - DINDIGUL (Tamil Nadu),22,22
1.0,JOTHIMANI. S,Indian National Congress,531829,3077,534906,47.25,23 - KARUR (Tamil Nadu),22,23
2.0,THANGAVEL. L,All India Anna Dravida Munnetra Kazhagam,366209,1881,368090,32.52,23 - KARUR (Tamil Nadu),22,23
3.0,SENTHILNATHAN. V.V,Bharatiya Janata Party,101517,965,102482,9.05,23 - KARUR (Tamil Nadu),22,23
4.0,KARUPPAIYA. R,Naam Tamilar Katchi,86962,541,87503,7.73,23 - KARUR (Tamil Nadu),22,23
5.0,SANKARAN. S,Bahujan Samaj Party,2665,15,2680,0.24,23 - KARUR (Tamil Nadu),22,23
6.0,SAKTHIVEL. R,Independent,2391,22,2413,0.21,23 - KARUR (Tamil Nadu),22,23
7.0,ABILAZAN. N,Independent,1916,5,1921,0.17,23 - KARUR (Tamil Nadu),22,23
8.0,KARTHIKPERUMAL. R,Independent,1808,1,1809,0.16,23 - KARUR (Tamil Nadu),22,23
9.0,KATHIRAVAN. P,Independent,1445,3,1448,0.13,23 - KARUR (Tamil Nadu),22,23
10.0,KARUNAMOORTHY. S,Independent,1278,-,1278,0.11,23 - KARUR (Tamil Nadu),22,23
11.0,MOHAMED NAZEEM. S,Independent,938,-,938,0.08,23 - KARUR (Tamil Nadu),22,23
12.0,PALANISAMY. N.A,Independent,934,-,934,0.08,23 - KARUR (Tamil Nadu),22,23
13.0,SHANMUGAM. N,Samaniya Makkal Nala Katchi,924,5,929,0.08,23 - KARUR (Tamil Nadu),22,23
14.0,KALAIRAJ. K,Independent,809,2,811,0.07,23 - KARUR (Tamil Nadu),22,23
15.0,JOTHIMANI. A.K,Independent,805,3,808,0.07,23 - KARUR (Tamil Nadu),22,23
16.0,KANNAN. T,Independent,782,6,788,0.07,23 - KARUR (Tamil Nadu),22,23
17.0,JOTHIMANI. S,Independent,774,6,780,0.07,23 - KARUR (Tamil Nadu),22,23
18.0,SATHASIVAM. R,Independent,728,1,729,0.06,23 - KARUR (Tamil Nadu),22,23
19.0,MANIKANDAN. K,Independent,685,-,685,0.06,23 - KARUR (Tamil Nadu),22,23
20.0,KOSAMALAR. P,Independent,641,3,644,0.06,23 - KARUR (Tamil Nadu),22,23
21.0,MURUGESAN. K,Ganasangam Party of India,628,2,630,0.06,23 - KARUR (Tamil Nadu),22,23
22.0,MAHESWARAN. A,Independent,589,1,590,0.05,23 - KARUR (Tamil Nadu),22,23
23.0,REGIS THIYAGARAJAN. V.G.A,Independent,570,2,572,0.05,23 - KARUR (Tamil Nadu),22,23
24.0,VINCENT. F,Anti Corruption Dynamic Party,510,5,515,0.05,23 - KARUR (Tamil Nadu),22,23
25.0,NATRAYAN. R,Independent,503,-,503,0.04,23 - KARUR (Tamil Nadu),22,23
26.0,BANUMATHY. S,Independent,494,2,496,0.04,23 - KARUR (Tamil Nadu),22,23
27.0,UMADEVI. S,Independent,452,1,453,0.04,23 - KARUR (Tamil Nadu),22,23
28.0,VARADAN. M,Independent,428,1,429,0.04,23 - KARUR (Tamil Nadu),22,23
29.0,MURALI. M,Independent,417,-,417,0.04,23 - KARUR (Tamil Nadu),22,23
30.0,SAKTHIVEL. N,Independent,414,1,415,0.04,23 - KARUR (Tamil Nadu),22,23
31.0,BABU. G,Independent,387,-,387,0.03,23 - KARUR (Tamil Nadu),22,23
32.0,JAFAR ALI. A,Independent,368,3,371,0.03,23 - KARUR (Tamil Nadu),22,23
33.0,PRABHU. G,Independent,354,-,354,0.03,23 - KARUR (Tamil Nadu),22,23
34.0,PALANIVEL. P,Independent,350,-,350,0.03,23 - KARUR (Tamil Nadu),22,23
35.0,ANBAZHAGAN. T,Independent,338,1,339,0.03,23 - KARUR (Tamil Nadu),22,23
36.0,MURUGESAN. P,Independent,327,-,327,0.03,23 - KARUR (Tamil Nadu),22,23
37.0,SOWMIYA. R,Independent,307,3,310,0.03,23 - KARUR (Tamil Nadu),22,23
38.0,SATHISHKUMAR. S,Independent,304,2,306,0.03,23 - KARUR (Tamil Nadu),22,23
39.0,DHURAIYARASAN. P,Independent,273,2,275,0.02,23 - KARUR (Tamil Nadu),22,23
40.0,VINOTH KUMAR. N,Independent,273,3,276,0.02,23 - KARUR (Tamil Nadu),22,23
41.0,SATHIS KUMAR. C,Independent,258,9,267,0.02,23 - KARUR (Tamil Nadu),22,23
42.0,THIRUGNANAM. M,Independent,253,5,258,0.02,23 - KARUR (Tamil Nadu),22,23
43.0,SATHISH. P,Independent,241,3,244,0.02,23 - KARUR (Tamil Nadu),22,23
44.0,MAHAMUNI. A,Independent,213,-,213,0.02,23 - KARUR (Tamil Nadu),22,23
45.0,RAJAPANDIAN. K,Independent,207,2,209,0.02,23 - KARUR (Tamil Nadu),22,23
46.0,JOTHIVEL. A,Independent,206,-,206,0.02,23 - KARUR (Tamil Nadu),22,23
47.0,BASKARAN. N,Independent,205,-,205,0.02,23 - KARUR (Tamil Nadu),22,23
48.0,PUSHPARAJ. N,Independent,199,-,199,0.02,23 - KARUR (Tamil Nadu),22,23
49.0,NARENDRAKUMAR. G,Independent,197,-,197,0.02,23 - KARUR (Tamil Nadu),22,23
50.0,PRASANTH. S,Independent,194,-,194,0.02,23 - KARUR (Tamil Nadu),22,23
51.0,SUBASH MALAYALAM. T,Independent,186,-,186,0.02,23 - KARUR (Tamil Nadu),22,23
52.0,NAGESVARAN. P,Independent,185,-,185,0.02,23 - KARUR (Tamil Nadu),22,23
53.0,DANIYA. P,Independent,165,-,165,0.01,23 - KARUR (Tamil Nadu),22,23
54.0,SIVAKUMAR. V,Independent,150,1,151,0.01,23 - KARUR (Tamil Nadu),22,23
55.0,NOTA,None of the Above,8174,101,8275,0.73,23 - KARUR (Tamil Nadu),22,23
,Total,,1125359,6686,1132045,,23 - KARUR (Tamil Nadu),22,23
1.0,DURAI VAIKO,Marumalarchi Dravida Munnetra Kazhagam,538877,3336,542213,51.35,24 - TIRUCHIRAPPALLI (Tamil Nadu),22,24
2.0,KARUPPAIAH. P,All India Anna Dravida Munnetra Kazhagam,227445,1674,229119,21.7,24 - TIRUCHIRAPPALLI (Tamil Nadu),22,24
3.0,RAJESSH. T,Naam Tamilar Katchi,106752,706,107458,10.18,24 - TIRUCHIRAPPALLI (Tamil Nadu),22,24
4.0,SENTHILNATHAN. P,Amma Makkal Munnettra Kazagam,99561,1186,100747,9.54,24 - TIRUCHIRAPPALLI (Tamil Nadu),22,24
5.0,SELVARAJ. S,Independent,14781,15,14796,1.4,24 - TIRUCHIRAPPALLI (Tamil Nadu),22,24
6.0,DAMODARAN. S,Independent,5138,28,5166,0.49,24 - TIRUCHIRAPPALLI (Tamil Nadu),22,24
7.0,ALLIMUTHU. M,Bahujan Samaj Party,4353,78,4431,0.42,24 - TIRUCHIRAPPALLI (Tamil Nadu),22,24
8.0,RAJENDRAN. S,Independent,3489,10,3499,0.33,24 - TIRUCHIRAPPALLI (Tamil Nadu),22,24
9.0,JEEVANANTHAM. M,Independent,2879,73,2952,0.28,24 - TIRUCHIRAPPALLI (Tamil Nadu),22,24
10.0,SAKTHIVEL,Anna Puratchi Thalaivar Amma Dravida Munnetra Kazhagam,2587,59,2646,0.25,24 - TIRUCHIRAPPALLI (Tamil Nadu),22,24
11.0,KARUPPIAH. S,Independent,2156,15,2171,0.21,24 - TIRUCHIRAPPALLI (Tamil Nadu),22,24
12.0,BACKIYARAJ VELLAISAMY,Naadaalum Makkal Katchi,2120,163,2283,0.22,24 - TIRUCHIRAPPALLI (Tamil Nadu),22,24
13.0,SATHIS KUMAR. S,Independent,2048,4,2052,0.19,24 - TIRUCHIRAPPALLI (Tamil Nadu),22,24
14.0,KAVITHA. S,Independent,1719,17,1736,0.16,24 - TIRUCHIRAPPALLI (Tamil Nadu),22,24
15.0,NAGARAJAN. M,Independent,1656,8,1664,0.16,24 - TIRUCHIRAPPALLI (Tamil Nadu),22,24
16.0,GOVINDARASU. P,Independent,1562,4,1566,0.15,24 - TIRUCHIRAPPALLI (Tamil Nadu),22,24
17.0,ANBIN AMUDHAN. R,Independent,1492,6,1498,0.14,24 - TIRUCHIRAPPALLI (Tamil Nadu),22,24
18.0,DURAIRAJ. A,Independent,1455,8,1463,0.14,24 - TIRUCHIRAPPALLI (Tamil Nadu),22,24
19.0,SASIKUMAR. P,Independent,1346,6,1352,0.13,24 - TIRUCHIRAPPALLI (Tamil Nadu),22,24
20.0,PANNEERSELVAM. P,Independent,1255,8,1263,0.12,24 - TIRUCHIRAPPALLI (Tamil Nadu),22,24
21.0,DURAI. S,Independent,1198,4,1202,0.11,24 - TIRUCHIRAPPALLI (Tamil Nadu),22,24
22.0,ANAND SELVARAJ,Independent,1172,6,1178,0.11,24 - TIRUCHIRAPPALLI (Tamil Nadu),22,24
23.0,SANKAR. R,Independent,1162,4,1166,0.11,24 - TIRUCHIRAPPALLI (Tamil Nadu),22,24
24.0,AMBIVENKATESAN,Independent,972,6,978,0.09,24 - TIRUCHIRAPPALLI (Tamil Nadu),22,24
25.0,DURAI. T,Independent,877,3,880,0.08,24 - TIRUCHIRAPPALLI (Tamil Nadu),22,24
26.0,SATHYAMURTHY. T,Independent,826,8,834,0.08,24 - TIRUCHIRAPPALLI (Tamil Nadu),22,24
27.0,VIJAYAKUMAR. P,Independent,797,5,802,0.08,24 - TIRUCHIRAPPALLI (Tamil Nadu),22,24
28.0,PERIYASAMY. V,Independent,771,3,774,0.07,24 - TIRUCHIRAPPALLI (Tamil Nadu),22,24
29.0,AKILA. M,Independent,742,5,747,0.07,24 - TIRUCHIRAPPALLI (Tamil Nadu),22,24
30.0,ROJA RAMANI. S,Anna MGR Dravida Makkal Kalgam,738,39,777,0.07,24 - TIRUCHIRAPPALLI (Tamil Nadu),22,24
31.0,RAJENDRAN. P,Independent,674,1,675,0.06,24 - TIRUCHIRAPPALLI (Tamil Nadu),22,24
32.0,MANIKANDARAJ. S,Independent,601,7,608,0.06,24 - TIRUCHIRAPPALLI (Tamil Nadu),22,24
33.0,MURUGESAN. P,Independent,494,3,497,0.05,24 - TIRUCHIRAPPALLI (Tamil Nadu),22,24
34.0,JOSEPH. L,Samaniya Makkal Nala Katchi,482,9,491,0.05,24 - TIRUCHIRAPPALLI (Tamil Nadu),22,24
35.0,MUTHURAJA. T,Independent,428,3,431,0.04,24 - TIRUCHIRAPPALLI (Tamil Nadu),22,24
36.0,NOTA,None of the Above,13560,289,13849,1.31,24 - TIRUCHIRAPPALLI (Tamil Nadu),22,24
,Total,,1048165,7799,1055964,,24 - TIRUCHIRAPPALLI (Tamil Nadu),22,24
1.0,ARUN NEHRU,Dravida Munnetra Kazhagam,598003,5206,603209,53.42,25 - PERAMBALUR (Tamil Nadu),22,25
2.0,CHANDRAMOHAN N D,All India Anna Dravida Munnetra Kazhagam,212495,1607,214102,18.96,25 - PERAMBALUR (Tamil Nadu),22,25
3.0,PAARIVENDHAR T R,Bharatiya Janata Party,160606,1260,161866,14.33,25 - PERAMBALUR (Tamil Nadu),22,25
4.0,THENMOZHI R,Naam Tamilar Katchi,112200,892,113092,10.02,25 - PERAMBALUR (Tamil Nadu),22,25
5.0,MANI S,Independent,3950,1,3951,0.35,25 - PERAMBALUR (Tamil Nadu),22,25
6.0,MADHU R,Independent,3498,10,3508,0.31,25 - PERAMBALUR (Tamil Nadu),22,25
7.0,RENGARAJ S,Independent,3251,22,3273,0.29,25 - PERAMBALUR (Tamil Nadu),22,25
8.0,ELANGOVAN R,Bahujan Samaj Party,3033,26,3059,0.27,25 - PERAMBALUR (Tamil Nadu),22,25
9.0,VASUDEVAN A,Independent,1355,7,1362,0.12,25 - PERAMBALUR (Tamil Nadu),22,25
10.0,ARUN NEHRU,Independent,1280,19,1299,0.12,25 - PERAMBALUR (Tamil Nadu),22,25
11.0,LAKSHMANAN,Independent,1087,-,1087,0.1,25 - PERAMBALUR (Tamil Nadu),22,25
12.0,PARY T,Independent,1077,4,1081,0.1,25 - PERAMBALUR (Tamil Nadu),22,25
13.0,ANANDARAJU R,Independent,1009,6,1015,0.09,25 - PERAMBALUR (Tamil Nadu),22,25
14.0,JAYAKUMAR K,Samaniya Makkal Nala Katchi,1003,3,1006,0.09,25 - PERAMBALUR (Tamil Nadu),22,25
15.0,TAMILSELVAN M,Independent,872,6,878,0.08,25 - PERAMBALUR (Tamil Nadu),22,25
16.0,THANGAMANI K,Independent,868,5,873,0.08,25 - PERAMBALUR (Tamil Nadu),22,25
17.0,P K AMMAN G SIVAKUMAR,Independent,740,15,755,0.07,25 - PERAMBALUR (Tamil Nadu),22,25
18.0,EBINESAN M,Independent,731,17,748,0.07,25 - PERAMBALUR (Tamil Nadu),22,25
19.0,MURUGANANTHAM T,Independent,730,3,733,0.06,25 - PERAMBALUR (Tamil Nadu),22,25
20.0,SUDHAKAR S,Independent,550,5,555,0.05,25 - PERAMBALUR (Tamil Nadu),22,25
21.0,SAMBATH D,Independent,530,2,532,0.05,25 - PERAMBALUR (Tamil Nadu),22,25
22.0,MUTHUKUMAR,Independent,467,2,469,0.04,25 - PERAMBALUR (Tamil Nadu),22,25
23.0,VEERAMALAI K,Independent,449,2,451,0.04,25 - PERAMBALUR (Tamil Nadu),22,25
24.0,NOTA,None of the Above,10075,247,10322,0.91,25 - PERAMBALUR (Tamil Nadu),22,25
,Total,,1119859,9367,1129226,,25 - PERAMBALUR (Tamil Nadu),22,25
1.0,M.K. VISHNUPRASAD,Indian National Congress,450401,4652,455053,44.11,26 - CUDDALORE (Tamil Nadu),22,26
2.0,P. SIVAKOZHUNDU,Desiya Murpokku Dravida Kazhagam,267707,1450,269157,26.09,26 - CUDDALORE (Tamil Nadu),22,26
3.0,THANKAR BACHAN,Pattali Makkal Katchi,202372,2872,205244,19.9,26 - CUDDALORE (Tamil Nadu),22,26
4.0,V. MANIVASAGAN,Naam Tamilar Katchi,56863,561,57424,5.57,26 - CUDDALORE (Tamil Nadu),22,26
5.0,S. ARIVUDAINAMBI,Anti Corruption Dynamic Party,6479,21,6500,0.63,26 - CUDDALORE (Tamil Nadu),22,26
6.0,A. BALAJI,Independent,5440,10,5450,0.53,26 - CUDDALORE (Tamil Nadu),22,26
7.0,V.THANIGAISELVAN,Bahujan Samaj Party,3917,54,3971,0.38,26 - CUDDALORE (Tamil Nadu),22,26
8.0,K. MAYAKRISHNAN,Veerath Thiyagi Viswanathadoss Thozhilalarkal Katchi,3696,6,3702,0.36,26 - CUDDALORE (Tamil Nadu),22,26
9.0,SU.VA. DHATSHANAMOORTHY,Independent,3414,5,3419,0.33,26 - CUDDALORE (Tamil Nadu),22,26
10.0,S. RAMALINGAM,Independent,3208,8,3216,0.31,26 - CUDDALORE (Tamil Nadu),22,26
11.0,G. PICHAMUTHU,Independent,2186,8,2194,0.21,26 - CUDDALORE (Tamil Nadu),22,26
12.0,R. ANANDHI,Independent,1677,19,1696,0.16,26 - CUDDALORE (Tamil Nadu),22,26
13.0,S. CHAKKARAVARTHY,Independent,1484,4,1488,0.14,26 - CUDDALORE (Tamil Nadu),22,26
14.0,R. SRINIVASAN,Independent,1352,11,1363,0.13,26 - CUDDALORE (Tamil Nadu),22,26
15.0,V. DAKSHANAAMURTHY,Independent,1276,10,1286,0.12,26 - CUDDALORE (Tamil Nadu),22,26
16.0,THANGA MURUGAN,Desiya Makkal Sakthi Katchi,1030,6,1036,0.1,26 - CUDDALORE (Tamil Nadu),22,26
17.0,R. RAJASEKAR,Independent,701,11,712,0.07,26 - CUDDALORE (Tamil Nadu),22,26
18.0,R. PRAKASH,Independent,694,6,700,0.07,26 - CUDDALORE (Tamil Nadu),22,26
19.0,S. RAJAMOHAN,Independent,659,1,660,0.06,26 - CUDDALORE (Tamil Nadu),22,26
20.0,NOTA,None of the Above,7084,208,7292,0.71,26 - CUDDALORE (Tamil Nadu),22,26
,Total,,1021640,9923,1031563,,26 - CUDDALORE (Tamil Nadu),22,26
1.0,THIRUMAAVALAVAN THOL,Viduthalai Chiruthaigal Katchi,501851,3233,505084,43.28,27 - CHIDAMBARAM (Tamil Nadu),22,27
2.0,CHANDRAHASAN M,All India Anna Dravida Munnetra Kazhagam,399502,2028,401530,34.4,27 - CHIDAMBARAM (Tamil Nadu),22,27
3.0,KARTHIYAYINI P,Bharatiya Janata Party,166114,2379,168493,14.44,27 - CHIDAMBARAM (Tamil Nadu),22,27
4.0,JANCIRANI R,Naam Tamilar Katchi,65116,473,65589,5.62,27 - CHIDAMBARAM (Tamil Nadu),22,27
5.0,NEELAMEGAM K,Bahujan Samaj Party,3177,26,3203,0.27,27 - CHIDAMBARAM (Tamil Nadu),22,27
6.0,TAMILVENDHAN P,Independent,3043,19,3062,0.26,27 - CHIDAMBARAM (Tamil Nadu),22,27
7.0,PERUMAL S,Independent,2231,8,2239,0.19,27 - CHIDAMBARAM (Tamil Nadu),22,27
8.0,VETTRIVEL G,Independent,2039,2,2041,0.17,27 - CHIDAMBARAM (Tamil Nadu),22,27
9.0,ARCHUNAN M A T,Independent,1833,3,1836,0.16,27 - CHIDAMBARAM (Tamil Nadu),22,27
10.0,DHAMODHARAN S,Naadaalum Makkal Katchi,1628,14,1642,0.14,27 - CHIDAMBARAM (Tamil Nadu),22,27
11.0,RATHA G,Independent,1273,7,1280,0.11,27 - CHIDAMBARAM (Tamil Nadu),22,27
12.0,RAJAMANICKAM C,Independent,1068,19,1087,0.09,27 - CHIDAMBARAM (Tamil Nadu),22,27
13.0,CHINNADURAI A,Independent,628,10,638,0.05,27 - CHIDAMBARAM (Tamil Nadu),22,27
14.0,ELAVARASAN C,Independent,584,2,586,0.05,27 - CHIDAMBARAM (Tamil Nadu),22,27
15.0,NOTA,None of the Above,8631,130,8761,0.75,27 - CHIDAMBARAM (Tamil Nadu),22,27
,Total,,1158718,8353,1167071,,27 - CHIDAMBARAM (Tamil Nadu),22,27
1.0,SUDHA R,Indian National Congress,516534,1925,518459,47.67,28 - MAYILADUTHURAI (Tamil Nadu),22,28
2.0,BABU P,All India Anna Dravida Munnetra Kazhagam,246083,1193,247276,22.73,28 - MAYILADUTHURAI (Tamil Nadu),22,28
3.0,STALIN M K,Pattali Makkal Katchi,165770,667,166437,15.3,28 - MAYILADUTHURAI (Tamil Nadu),22,28
4.0,KALIYAMMAL P,Naam Tamilar Katchi,127276,366,127642,11.73,28 - MAYILADUTHURAI (Tamil Nadu),22,28
5.0,KARTHICK A,Samaniya Makkal Nala Katchi,3888,3,3891,0.36,28 - MAYILADUTHURAI (Tamil Nadu),22,28
6.0,ILANCHEZHIAN T,Bahujan Samaj Party,2878,20,2898,0.27,28 - MAYILADUTHURAI (Tamil Nadu),22,28
7.0,BABU S,Independent,1832,6,1838,0.17,28 - MAYILADUTHURAI (Tamil Nadu),22,28
8.0,MANIMARAN T,Independent,1710,1,1711,0.16,28 - MAYILADUTHURAI (Tamil Nadu),22,28
9.0,NAGARAJAN K,Independent,1342,5,1347,0.12,28 - MAYILADUTHURAI (Tamil Nadu),22,28
10.0,SILAMBARASAN D,Independent,1255,1,1256,0.12,28 - MAYILADUTHURAI (Tamil Nadu),22,28
11.0,JAFARULLAH KHAN F,Independent,1230,6,1236,0.11,28 - MAYILADUTHURAI (Tamil Nadu),22,28
12.0,PANDIYARAJAN S,Independent,1169,5,1174,0.11,28 - MAYILADUTHURAI (Tamil Nadu),22,28
13.0,TIMOTHY T,Independent,1165,10,1175,0.11,28 - MAYILADUTHURAI (Tamil Nadu),22,28
14.0,VEDARETHINAM S,Anna MGR Dravida Makkal Kalgam,780,2,782,0.07,28 - MAYILADUTHURAI (Tamil Nadu),22,28
15.0,NITHIYANANTHAM S,Naadaalum Makkal Katchi,735,4,739,0.07,28 - MAYILADUTHURAI (Tamil Nadu),22,28
16.0,SRINIVASAN V,Independent,609,8,617,0.06,28 - MAYILADUTHURAI (Tamil Nadu),22,28
17.0,DHAKSHINAMOORTHY M,Independent,518,17,535,0.05,28 - MAYILADUTHURAI (Tamil Nadu),22,28
18.0,NOTA,None of the Above,8642,53,8695,0.8,28 - MAYILADUTHURAI (Tamil Nadu),22,28
,Total,,1083416,4292,1087708,,28 - MAYILADUTHURAI (Tamil Nadu),22,28
1.0,SELVARAJ V,Communist Party of India,462759,2285,465044,47.79,29 - NAGAPATTINAM (Tamil Nadu),22,29
2.0,DR SURSITH SANKAR G,All India Anna Dravida Munnetra Kazhagam,254676,1411,256087,26.32,29 - NAGAPATTINAM (Tamil Nadu),22,29
3.0,KARTHIKA M,Naam Tamilar Katchi,130846,448,131294,13.49,29 - NAGAPATTINAM (Tamil Nadu),22,29
4.0,RAMESHGOVIND S G M,Bharatiya Janata Party,101535,638,102173,10.5,29 - NAGAPATTINAM (Tamil Nadu),22,29
5.0,VIJAYARAGAVAN N,Independent,3072,30,3102,0.32,29 - NAGAPATTINAM (Tamil Nadu),22,29
6.0,SUBRAMANIAN K,Independent,2434,33,2467,0.25,29 - NAGAPATTINAM (Tamil Nadu),22,29
7.0,JAGADEESH J BE,Bahujan Samaj Party,1789,17,1806,0.19,29 - NAGAPATTINAM (Tamil Nadu),22,29
8.0,BOOMINATHAN B,Desiya Makkal Sakthi Katchi,1048,2,1050,0.11,29 - NAGAPATTINAM (Tamil Nadu),22,29
9.0,PREM S,Independent,1047,23,1070,0.11,29 - NAGAPATTINAM (Tamil Nadu),22,29
10.0,NOTA,None of the Above,8843,75,8918,0.92,29 - NAGAPATTINAM (Tamil Nadu),22,29
,Total,,968049,4962,973011,,29 - NAGAPATTINAM (Tamil Nadu),22,29
1.0,MURASOLI S,Dravida Munnetra Kazhagam,498822,3423,502245,48.82,30 - THANJAVUR (Tamil Nadu),22,30
2.0,SIVANESAN P,Desiya Murpokku Dravida Kazhagam,182172,490,182662,17.76,30 - THANJAVUR (Tamil Nadu),22,30
3.0,MURUGANANTHAM M,Bharatiya Janata Party,169587,1026,170613,16.59,30 - THANJAVUR (Tamil Nadu),22,30
4.0,HUMAYUN KABIR,Naam Tamilar Katchi,119683,610,120293,11.69,30 - THANJAVUR (Tamil Nadu),22,30
5.0,RENGASAMY C,Independent,18130,61,18191,1.77,30 - THANJAVUR (Tamil Nadu),22,30
6.0,SARAVANAN M,Independent,6730,65,6795,0.66,30 - THANJAVUR (Tamil Nadu),22,30
7.0,SENTHIL KUMAR N,Independent,4133,25,4158,0.4,30 - THANJAVUR (Tamil Nadu),22,30
8.0,EZHILARASAN S,Independent,3834,17,3851,0.37,30 - THANJAVUR (Tamil Nadu),22,30
9.0,JAYABAL A,Bahujan Samaj Party,2400,10,2410,0.23,30 - THANJAVUR (Tamil Nadu),22,30
10.0,SANTHOSH M,Independent,1982,10,1992,0.19,30 - THANJAVUR (Tamil Nadu),22,30
11.0,ER ARJUN S,Independent,1440,6,1446,0.14,30 - THANJAVUR (Tamil Nadu),22,30
12.0,KARIKALA CHOLAN S,Independent,1209,8,1217,0.12,30 - THANJAVUR (Tamil Nadu),22,30
13.0,NOTA,None of the Above,12674,159,12833,1.25,30 - THANJAVUR (Tamil Nadu),22,30
,Total,,1022796,5910,1028706,,30 - THANJAVUR (Tamil Nadu),22,30
1.0,KARTI P CHIDAMBARAM,Indian National Congress,425631,2046,427677,40.6,31 - SIVAGANGA (Tamil Nadu),22,31
2.0,XAVIERDASS A,All India Anna Dravida Munnetra Kazhagam,221255,758,222013,21.08,31 - SIVAGANGA (Tamil Nadu),22,31
3.0,DHEVANATHAN YADAV T,Bharatiya Janata Party,194559,1229,195788,18.59,31 - SIVAGANGA (Tamil Nadu),22,31
4.0,EZHILARASI,Naam Tamilar Katchi,162558,854,163412,15.51,31 - SIVAGANGA (Tamil Nadu),22,31
5.0,DHANALAKSHMI M,Independent,8494,18,8512,0.81,31 - SIVAGANGA (Tamil Nadu),22,31
6.0,GOVINDHARAJU M.G,Independent,4231,10,4241,0.4,31 - SIVAGANGA (Tamil Nadu),22,31
7.0,NAGARAJAN KR,Independent,3682,14,3696,0.35,31 - SIVAGANGA (Tamil Nadu),22,31
8.0,PALANIYAPPAN R,Independent,3426,1,3427,0.33,31 - SIVAGANGA (Tamil Nadu),22,31
9.0,RANJITHKUMAR BALUSWAMY,Bahujan Samaj Party,3160,11,3171,0.3,31 - SIVAGANGA (Tamil Nadu),22,31
10.0,BASKARAN S,Independent,2191,3,2194,0.21,31 - SIVAGANGA (Tamil Nadu),22,31
11.0,KALAISELVAM K,Independent,1660,3,1663,0.16,31 - SIVAGANGA (Tamil Nadu),22,31
12.0,MALAISAMY K,Independent,1524,3,1527,0.14,31 - SIVAGANGA (Tamil Nadu),22,31
13.0,SEKAR A,Independent,1285,7,1292,0.12,31 - SIVAGANGA (Tamil Nadu),22,31
14.0,SELVARAJ P,Independent,1108,3,1111,0.11,31 - SIVAGANGA (Tamil Nadu),22,31
15.0,THILLAIVASAGAM M,Vidiyalai Thedum Indhiyargal Party,1068,5,1073,0.1,31 - SIVAGANGA (Tamil Nadu),22,31
16.0,ASHOK KUMAR K,Independent,1030,4,1034,0.1,31 - SIVAGANGA (Tamil Nadu),22,31
17.0,KARTHICK C,Independent,975,6,981,0.09,31 - SIVAGANGA (Tamil Nadu),22,31
18.0,MUTHARASU PANDIYAN V,Independent,824,4,828,0.08,31 - SIVAGANGA (Tamil Nadu),22,31
19.0,KALAIRAJA B,Independent,816,3,819,0.08,31 - SIVAGANGA (Tamil Nadu),22,31
20.0,KARTHIKAIRAJAN P,Independent,762,9,771,0.07,31 - SIVAGANGA (Tamil Nadu),22,31
21.0,NOTA,None of the Above,8119,70,8189,0.78,31 - SIVAGANGA (Tamil Nadu),22,31
,Total,,1048358,5061,1053419,,31 - SIVAGANGA (Tamil Nadu),22,31
1.0,VENKATESAN S,Communist Party of India (Marxist),428201,2122,430323,43.6,32 - MADURAI (Tamil Nadu),22,32
2.0,RAAMA SREENIVASAN,Bharatiya Janata Party,219035,1879,220914,22.38,32 - MADURAI (Tamil Nadu),22,32
3.0,SARAVANAN P,All India Anna Dravida Munnetra Kazhagam,204163,641,204804,20.75,32 - MADURAI (Tamil Nadu),22,32
4.0,SATHYADEVI T,Naam Tamilar Katchi,92386,493,92879,9.41,32 - MADURAI (Tamil Nadu),22,32
5.0,VELMURUGAN A,Bharatiya Praja Aikyata Party,5966,43,6009,0.61,32 - MADURAI (Tamil Nadu),22,32
6.0,VENKATESAN M,Independent,2497,8,2505,0.25,32 - MADURAI (Tamil Nadu),22,32
7.0,RAMAR PANDI T,Bahujan Samaj Party,2489,17,2506,0.25,32 - MADURAI (Tamil Nadu),22,32
8.0,SHANMUGA SUNDARAM A,United Republican Party of India,2338,11,2349,0.24,32 - MADURAI (Tamil Nadu),22,32
9.0,PERIYASAMY K,Independent,1966,2,1968,0.2,32 - MADURAI (Tamil Nadu),22,32
10.0,PANDIYAN S,Bahujan Dravida Party,1559,3,1562,0.16,32 - MADURAI (Tamil Nadu),22,32
11.0,BOOMINATHAN C,Independent,1211,2,1213,0.12,32 - MADURAI (Tamil Nadu),22,32
12.0,MUTHUPANDI S,Independent,1206,1,1207,0.12,32 - MADURAI (Tamil Nadu),22,32
13.0,RAMANATHAN S,Independent,1191,3,1194,0.12,32 - MADURAI (Tamil Nadu),22,32
14.0,VENKATESH S,Independent,1041,5,1046,0.11,32 - MADURAI (Tamil Nadu),22,32
15.0,SANKARAPANDI M.P.,Independent,1025,4,1029,0.1,32 - MADURAI (Tamil Nadu),22,32
16.0,GOPISON M.M.,Independent,942,4,946,0.1,32 - MADURAI (Tamil Nadu),22,32
17.0,SARAVANAN K.K.,Independent,843,1,844,0.09,32 - MADURAI (Tamil Nadu),22,32
18.0,GOPALAKRISHNAN S,Independent,745,1,746,0.08,32 - MADURAI (Tamil Nadu),22,32
19.0,CHANDRASEKAR N,Independent,708,3,711,0.07,32 - MADURAI (Tamil Nadu),22,32
20.0,PANDIYAN P,Socialist Unity Centre Of India (COMMUNIST),576,2,578,0.06,32 - MADURAI (Tamil Nadu),22,32
21.0,AVADAINATHAN V,Independent,461,1,462,0.05,32 - MADURAI (Tamil Nadu),22,32
22.0,NOTA,None of the Above,11074,100,11174,1.13,32 - MADURAI (Tamil Nadu),22,32
,Total,,981623,5346,986969,,32 - MADURAI (Tamil Nadu),22,32
1.0,THANGA TAMILSELVAN,Dravida Munnetra Kazhagam,569110,2383,571493,50.08,33 - THENI (Tamil Nadu),22,33
2.0,TTV DHINAKARAN,Amma Makkal Munnettra Kazagam,289909,2759,292668,25.65,33 - THENI (Tamil Nadu),22,33
3.0,NARAYANASAMY V T,All India Anna Dravida Munnetra Kazhagam,154871,716,155587,13.63,33 - THENI (Tamil Nadu),22,33
4.0,MADHAN,Naam Tamilar Katchi,75495,1339,76834,6.73,33 - THENI (Tamil Nadu),22,33
5.0,PRAKASH P,Independent,6293,5,6298,0.55,33 - THENI (Tamil Nadu),22,33
6.0,PANDIKUMAR S,Independent,3907,60,3967,0.35,33 - THENI (Tamil Nadu),22,33
7.0,AJEETHKUMAR S,Independent,2977,29,3006,0.26,33 - THENI (Tamil Nadu),22,33
8.0,PARAMASIVAN S,Independent,2852,14,2866,0.25,33 - THENI (Tamil Nadu),22,33
9.0,PARTHIBAN G,Independent,2275,2,2277,0.2,33 - THENI (Tamil Nadu),22,33
10.0,JEEVA M,Bahujan Samaj Party,2123,99,2222,0.19,33 - THENI (Tamil Nadu),22,33
11.0,CHARCHIL DURAI P,Humanity for Peace Party,1905,30,1935,0.17,33 - THENI (Tamil Nadu),22,33
12.0,PREMA S,Independent,1225,7,1232,0.11,33 - THENI (Tamil Nadu),22,33
13.0,MANIKANDAN R,Independent,1195,6,1201,0.11,33 - THENI (Tamil Nadu),22,33
14.0,REVATHI K,Independent,1115,13,1128,0.1,33 - THENI (Tamil Nadu),22,33
15.0,MUDIYARASU,All India Youth Development Party,1078,16,1094,0.1,33 - THENI (Tamil Nadu),22,33
16.0,THIAGARAJAN O V,Independent,924,8,932,0.08,33 - THENI (Tamil Nadu),22,33
17.0,VASANTHA SARAVANAN,Independent,803,2,805,0.07,33 - THENI (Tamil Nadu),22,33
18.0,VIJAYAN K,Independent,665,2,667,0.06,33 - THENI (Tamil Nadu),22,33
19.0,SETHUPATHI G,Independent,613,4,617,0.05,33 - THENI (Tamil Nadu),22,33
20.0,JOHNGILBERTRAJ,Independent,598,5,603,0.05,33 - THENI (Tamil Nadu),22,33
21.0,AATHIMUTHUKUMAR M,Independent,587,5,592,0.05,33 - THENI (Tamil Nadu),22,33
22.0,MUTHUKUMAR,Independent,539,4,543,0.05,33 - THENI (Tamil Nadu),22,33
23.0,HARIKRISHNAKUMAR R,Independent,481,5,486,0.04,33 - THENI (Tamil Nadu),22,33
24.0,SATHEESH KUMAR A,Independent,447,6,453,0.04,33 - THENI (Tamil Nadu),22,33
25.0,KUMAR,Independent,376,1,377,0.03,33 - THENI (Tamil Nadu),22,33
26.0,NOTA,None of the Above,11206,130,11336,0.99,33 - THENI (Tamil Nadu),22,33
,Total,,1133569,7650,1141219,,33 - THENI (Tamil Nadu),22,33
1.0,MANICKAM TAGORE B,Indian National Congress,382876,2380,385256,36.28,34 - VIRUDHUNAGAR (Tamil Nadu),22,34
2.0,VIJAYAPRABHAKARAN V,Desiya Murpokku Dravida Kazhagam,378243,2634,380877,35.87,34 - VIRUDHUNAGAR (Tamil Nadu),22,34
3.0,RADIKAA R,Bharatiya Janata Party,164149,2122,166271,15.66,34 - VIRUDHUNAGAR (Tamil Nadu),22,34
4.0,KAUSHIK S,Naam Tamilar Katchi,76122,909,77031,7.25,34 - VIRUDHUNAGAR (Tamil Nadu),22,34
5.0,RAJESH,Independent,6167,6,6173,0.58,34 - VIRUDHUNAGAR (Tamil Nadu),22,34
6.0,ASHOK KUMAR M,Bharatiya Praja Aikyata Party,5228,65,5293,0.5,34 - VIRUDHUNAGAR (Tamil Nadu),22,34
7.0,SEKAR S,Hindu Samaj Party,3436,10,3446,0.32,34 - VIRUDHUNAGAR (Tamil Nadu),22,34
8.0,MANIKANDAN M,Independent,3341,5,3346,0.32,34 - VIRUDHUNAGAR (Tamil Nadu),22,34
9.0,MAYAK KANNAN,Independent,2749,2,2751,0.26,34 - VIRUDHUNAGAR (Tamil Nadu),22,34
10.0,MAHENDRA RAMAKRISHNAN P,Independent,2404,1,2405,0.23,34 - VIRUDHUNAGAR (Tamil Nadu),22,34
11.0,SURESH,Bahujan Samaj Party,2378,19,2397,0.23,34 - VIRUDHUNAGAR (Tamil Nadu),22,34
12.0,SELVI K,Independent,2165,23,2188,0.21,34 - VIRUDHUNAGAR (Tamil Nadu),22,34
13.0,PANDIYAMMAL R,Independent,2128,5,2133,0.2,34 - VIRUDHUNAGAR (Tamil Nadu),22,34
14.0,SUDALAIMANI M,Independent,1357,2,1359,0.13,34 - VIRUDHUNAGAR (Tamil Nadu),22,34
15.0,PALANICHAMY P,Bahujan Dravida Party,1261,2,1263,0.12,34 - VIRUDHUNAGAR (Tamil Nadu),22,34
16.0,PALANISAMY K,Independent,1251,6,1257,0.12,34 - VIRUDHUNAGAR (Tamil Nadu),22,34
17.0,VENKATESWARAN V K,Independent,1242,5,1247,0.12,34 - VIRUDHUNAGAR (Tamil Nadu),22,34
18.0,SELVARAJAN V V,Independent,1120,1,1121,0.11,34 - VIRUDHUNAGAR (Tamil Nadu),22,34
19.0,MARIEESWARI M,Independent,1100,10,1110,0.1,34 - VIRUDHUNAGAR (Tamil Nadu),22,34
20.0,SANKARANARAYANAN N,Independent,994,4,998,0.09,34 - VIRUDHUNAGAR (Tamil Nadu),22,34
21.0,SELVAKUMAR M,Independent,896,6,902,0.08,34 - VIRUDHUNAGAR (Tamil Nadu),22,34
22.0,MUTHUKANNU C,Tamilaga Makkal Nala Katchi,753,8,761,0.07,34 - VIRUDHUNAGAR (Tamil Nadu),22,34
23.0,MARISELVAM S,All India People Development Party,708,3,711,0.07,34 - VIRUDHUNAGAR (Tamil Nadu),22,34
24.0,JEYARAJ T,Independent,602,8,610,0.06,34 - VIRUDHUNAGAR (Tamil Nadu),22,34
25.0,VEDHA @ DHAMODHARAN,Independent,599,1,600,0.06,34 - VIRUDHUNAGAR (Tamil Nadu),22,34
26.0,RAJAGOPAL S,Independent,525,2,527,0.05,34 - VIRUDHUNAGAR (Tamil Nadu),22,34
27.0,GANESHAMOORTHI G,Independent,457,3,460,0.04,34 - VIRUDHUNAGAR (Tamil Nadu),22,34
28.0,NOTA,None of the Above,9256,152,9408,0.89,34 - VIRUDHUNAGAR (Tamil Nadu),22,34
,Total,,1053507,8394,1061901,,34 - VIRUDHUNAGAR (Tamil Nadu),22,34
1.0,NAVASKANI K,Indian Union Muslim League,506690,2974,509664,45.92,35 - RAMANATHAPURAM (Tamil Nadu),22,35
2.0,PANNEERSELVAM O S/O OTTAKARATHEVAR,Independent,340778,2104,342882,30.89,35 - RAMANATHAPURAM (Tamil Nadu),22,35
3.0,JEYAPERUMAL P,All India Anna Dravida Munnetra Kazhagam,98757,1023,99780,8.99,35 - RAMANATHAPURAM (Tamil Nadu),22,35
4.0,DR CHANDRA PRABHA JEYAPAL,Naam Tamilar Katchi,96701,971,97672,8.8,35 - RAMANATHAPURAM (Tamil Nadu),22,35
5.0,MUVITH KUMAR N,Independent,7901,18,7919,0.71,35 - RAMANATHAPURAM (Tamil Nadu),22,35
6.0,SENTHILMALLAR K,Independent,6629,198,6827,0.62,35 - RAMANATHAPURAM (Tamil Nadu),22,35
7.0,SIVASHANKAR N,Independent,6583,10,6593,0.59,35 - RAMANATHAPURAM (Tamil Nadu),22,35
8.0,KANNADHASAN R,Independent,3485,17,3502,0.32,35 - RAMANATHAPURAM (Tamil Nadu),22,35
9.0,SELVARAJ G,Puthiya Makkal Tamil Desam Katchi,2943,14,2957,0.27,35 - RAMANATHAPURAM (Tamil Nadu),22,35
10.0,PANNEERSELVAM O S/O OCHAPPAN,Independent,2939,42,2981,0.27,35 - RAMANATHAPURAM (Tamil Nadu),22,35
11.0,PANCHAVARNAM V,Independent,2561,11,2572,0.23,35 - RAMANATHAPURAM (Tamil Nadu),22,35
12.0,PARIRAJAN C,Veerath Thiyagi Viswanathadoss Thozhilalarkal Katchi,2493,4,2497,0.22,35 - RAMANATHAPURAM (Tamil Nadu),22,35
13.0,PANNIR SELVAM M S/O MALAIYANDI,Independent,2387,15,2402,0.22,35 - RAMANATHAPURAM (Tamil Nadu),22,35
14.0,NAWASKHAN,Independent,2301,22,2323,0.21,35 - RAMANATHAPURAM (Tamil Nadu),22,35
15.0,SIVANANDAM N,Bahujan Samaj Party,1958,56,2014,0.18,35 - RAMANATHAPURAM (Tamil Nadu),22,35
16.0,PANNEERSELVAM O S/O OYYADEVAR,Independent,1920,9,1929,0.17,35 - RAMANATHAPURAM (Tamil Nadu),22,35
17.0,ABUBAKKAR SITHICK J,Desiya Makkal Sakthi Katchi,1497,21,1518,0.14,35 - RAMANATHAPURAM (Tamil Nadu),22,35
18.0,MANIVASAGAM S,Bahujan Dravida Party,1392,11,1403,0.13,35 - RAMANATHAPURAM (Tamil Nadu),22,35
19.0,PANNEERSELVAM O S/O OYYARAM,Independent,1369,7,1376,0.12,35 - RAMANATHAPURAM (Tamil Nadu),22,35
20.0,SALEEM,Independent,961,13,974,0.09,35 - RAMANATHAPURAM (Tamil Nadu),22,35
21.0,SASIKANI K,Independent,896,3,899,0.08,35 - RAMANATHAPURAM (Tamil Nadu),22,35
22.0,SATHURAGIRI K,Independent,815,12,827,0.07,35 - RAMANATHAPURAM (Tamil Nadu),22,35
23.0,SIKKANDAR B,Independent,804,19,823,0.07,35 - RAMANATHAPURAM (Tamil Nadu),22,35
24.0,VIGNESH V,Independent,643,9,652,0.06,35 - RAMANATHAPURAM (Tamil Nadu),22,35
25.0,PANNERSELVAM O S/O OCHATTHEVAR,Independent,564,8,572,0.05,35 - RAMANATHAPURAM (Tamil Nadu),22,35
26.0,NOTA,None of the Above,6163,132,6295,0.57,35 - RAMANATHAPURAM (Tamil Nadu),22,35
,Total,,1102130,7723,1109853,,35 - RAMANATHAPURAM (Tamil Nadu),22,35
1.0,KANIMOZHI KARUNANIDHI,Dravida Munnetra Kazhagam,537879,2850,540729,55.26,36 - THOOTHUKKUDI (Tamil Nadu),22,36
2.0,SIVASAMY VELUMANI R,All India Anna Dravida Munnetra Kazhagam,147407,584,147991,15.12,36 - THOOTHUKKUDI (Tamil Nadu),22,36
3.0,VIJAYASEELAN SDR,Tamil Maanila Congress (Moopanar),121680,700,122380,12.51,36 - THOOTHUKKUDI (Tamil Nadu),22,36
4.0,ROWENA RUTH JANE J,Naam Tamilar Katchi,119374,926,120300,12.29,36 - THOOTHUKKUDI (Tamil Nadu),22,36
5.0,RAJHA N P,Naam Indiar Party,6622,18,6640,0.68,36 - THOOTHUKKUDI (Tamil Nadu),22,36
6.0,ARUNADEVI R,Independent,6029,43,6072,0.62,36 - THOOTHUKKUDI (Tamil Nadu),22,36
7.0,CHITHIRAI JEGAN S,Independent,3637,3,3640,0.37,36 - THOOTHUKKUDI (Tamil Nadu),22,36
8.0,SIVANESWARAN J,Independent,3363,13,3376,0.35,36 - THOOTHUKKUDI (Tamil Nadu),22,36
9.0,SAMUEL T,Independent,2240,5,2245,0.23,36 - THOOTHUKKUDI (Tamil Nadu),22,36
10.0,MANIKKARAJ A,Bahujan Samaj Party,2158,37,2195,0.22,36 - THOOTHUKKUDI (Tamil Nadu),22,36
11.0,AASIRIYAR SHANMUGA SUNDARAM K,Independent,1832,7,1839,0.19,36 - THOOTHUKKUDI (Tamil Nadu),22,36
12.0,KALEERMURUGAPAVENTHAN R,Makkal Nalvaazhvuk Katchi,1736,56,1792,0.18,36 - THOOTHUKKUDI (Tamil Nadu),22,36
13.0,PONKUMARAN T P S,Independent,894,3,897,0.09,36 - THOOTHUKKUDI (Tamil Nadu),22,36
14.0,JEYAKUMAR C,Independent,825,4,829,0.08,36 - THOOTHUKKUDI (Tamil Nadu),22,36
15.0,GANDHIMALLAR S M,Independent,791,14,805,0.08,36 - THOOTHUKKUDI (Tamil Nadu),22,36
16.0,BISHOP DR GODFREY NOBLE,Aanaithinthiya Jananayaka Pathukappu Kazhagam,757,12,769,0.08,36 - THOOTHUKKUDI (Tamil Nadu),22,36
17.0,PERUMALKUMAR P,Puthiya Makkal Tamil Desam Katchi,727,12,739,0.08,36 - THOOTHUKKUDI (Tamil Nadu),22,36
18.0,ESAKKIMUTHU V,Independent,699,11,710,0.07,36 - THOOTHUKKUDI (Tamil Nadu),22,36
19.0,KANNAN G,Independent,679,10,689,0.07,36 - THOOTHUKKUDI (Tamil Nadu),22,36
20.0,DAVID JEBASEELAN J,Independent,656,7,663,0.07,36 - THOOTHUKKUDI (Tamil Nadu),22,36
21.0,SUDALAIMUTHU P,Independent,576,2,578,0.06,36 - THOOTHUKKUDI (Tamil Nadu),22,36
22.0,KRISHNAN S,Independent,479,1,480,0.05,36 - THOOTHUKKUDI (Tamil Nadu),22,36
23.0,RADHAKRISHNAN V G,Independent,456,5,461,0.05,36 - THOOTHUKKUDI (Tamil Nadu),22,36
24.0,JAMES P,Independent,433,11,444,0.05,36 - THOOTHUKKUDI (Tamil Nadu),22,36
25.0,PONRAJ K,Independent,428,1,429,0.04,36 - THOOTHUKKUDI (Tamil Nadu),22,36
26.0,PRASANNA KUMAR M,Independent,396,-,396,0.04,36 - THOOTHUKKUDI (Tamil Nadu),22,36
27.0,SELVAMUTHUKUMAR M,Independent,341,-,341,0.03,36 - THOOTHUKKUDI (Tamil Nadu),22,36
28.0,SENTHIL KUMAR S,Independent,290,1,291,0.03,36 - THOOTHUKKUDI (Tamil Nadu),22,36
29.0,NOTA,None of the Above,9682,124,9806,1.0,36 - THOOTHUKKUDI (Tamil Nadu),22,36
,Total,,973066,5460,978526,,36 - THOOTHUKKUDI (Tamil Nadu),22,36
1.0,DR RANI SRI KUMAR,Dravida Munnetra Kazhagam,423025,2654,425679,40.97,37 - TENKASI (Tamil Nadu),22,37
2.0,DR K KRISHNASAMY,All India Anna Dravida Munnetra Kazhagam,228290,1190,229480,22.08,37 - TENKASI (Tamil Nadu),22,37
3.0,B JOHN PANDIAN,Bharatiya Janata Party,206982,1843,208825,20.1,37 - TENKASI (Tamil Nadu),22,37
4.0,ESAI MATHIVANAN,Naam Tamilar Katchi,128750,1585,130335,12.54,37 - TENKASI (Tamil Nadu),22,37
5.0,KARPAGAVALLI P,Independent,6200,114,6314,0.61,37 - TENKASI (Tamil Nadu),22,37
6.0,T MAHESHKUMAR,Bahujan Samaj Party,3526,28,3554,0.34,37 - TENKASI (Tamil Nadu),22,37
7.0,RAMASAMY P,Viro Ke Vir Indian Party,3395,17,3412,0.33,37 - TENKASI (Tamil Nadu),22,37
8.0,M MANMATHAN,Independent,3276,2,3278,0.32,37 - TENKASI (Tamil Nadu),22,37
9.0,A SEETHA,Bahujan Dravida Party,2476,-,2476,0.24,37 - TENKASI (Tamil Nadu),22,37
10.0,KRISHNASAMY,Independent,1828,5,1833,0.18,37 - TENKASI (Tamil Nadu),22,37
11.0,M UMAMAHESWARI,Desiya Makkal Sakthi Katchi,1626,29,1655,0.16,37 - TENKASI (Tamil Nadu),22,37
12.0,A MUTHAIAH,Independent,1440,17,1457,0.14,37 - TENKASI (Tamil Nadu),22,37
13.0,P KRISHNASAMY,Independent,1342,8,1350,0.13,37 - TENKASI (Tamil Nadu),22,37
14.0,ARUMUGASWAMI M,Independent,1292,21,1313,0.13,37 - TENKASI (Tamil Nadu),22,37
15.0,RAJA SEKAR,Independent,982,11,993,0.1,37 - TENKASI (Tamil Nadu),22,37
16.0,NOTA,None of the Above,16877,288,17165,1.65,37 - TENKASI (Tamil Nadu),22,37
,Total,,1031307,7812,1039119,,37 - TENKASI (Tamil Nadu),22,37
1.0,ROBERT BRUCE C,Indian National Congress,499493,2803,502296,47.06,38 - TIRUNELVELI (Tamil Nadu),22,38
2.0,NAINAR NAGENTHRAN,Bharatiya Janata Party,334431,2245,336676,31.54,38 - TIRUNELVELI (Tamil Nadu),22,38
3.0,JANSI RANI M,All India Anna Dravida Munnetra Kazhagam,88996,605,89601,8.39,38 - TIRUNELVELI (Tamil Nadu),22,38
4.0,SATHYA,Naam Tamilar Katchi,86918,768,87686,8.21,38 - TIRUNELVELI (Tamil Nadu),22,38
5.0,POTTAL SUNDARA MUNISWARAN,Independent,19802,50,19852,1.86,38 - TIRUNELVELI (Tamil Nadu),22,38
6.0,ATHISAYAM V,Independent,3744,37,3781,0.35,38 - TIRUNELVELI (Tamil Nadu),22,38
7.0,BALASUBRAMANIAN,Bahujan Samaj Party,2044,23,2067,0.19,38 - TIRUNELVELI (Tamil Nadu),22,38
8.0,CHINNA MAHARAJA K,Independent,1888,7,1895,0.18,38 - TIRUNELVELI (Tamil Nadu),22,38
9.0,DAVID M,Independent,1829,7,1836,0.17,38 - TIRUNELVELI (Tamil Nadu),22,38
10.0,SAMUEL LAWRENCE PONNIAH,Independent,1493,4,1497,0.14,38 - TIRUNELVELI (Tamil Nadu),22,38
11.0,BISHOP DR GODFREY WASHINGTON NOBLE,Aanaithinthiya Jananayaka Pathukappu Kazhagam,1457,18,1475,0.14,38 - TIRUNELVELI (Tamil Nadu),22,38
12.0,LENIN K,Independent,1441,9,1450,0.14,38 - TIRUNELVELI (Tamil Nadu),22,38
13.0,CHANDRAN M,Veerath Thiyagi Viswanathadoss Thozhilalarkal Katchi,1409,4,1413,0.13,38 - TIRUNELVELI (Tamil Nadu),22,38
14.0,SELVA KUMAR S,Bahujan Dravida Party,1317,29,1346,0.13,38 - TIRUNELVELI (Tamil Nadu),22,38
15.0,KUMAR V,Puthiya Makkal Tamil Desam Katchi,1057,15,1072,0.1,38 - TIRUNELVELI (Tamil Nadu),22,38
16.0,MUTHURAMAN A,Aravor Munnetra Kazhagam,1046,2,1048,0.1,38 - TIRUNELVELI (Tamil Nadu),22,38
17.0,THALAPATHY MURUGAN M,Independent,913,4,917,0.09,38 - TIRUNELVELI (Tamil Nadu),22,38
18.0,SIVARAM K,Independent,855,20,875,0.08,38 - TIRUNELVELI (Tamil Nadu),22,38
19.0,RAMAKRISHNAN N,Nam India Naam Indiyar Katchi,790,-,790,0.07,38 - TIRUNELVELI (Tamil Nadu),22,38
20.0,SURESH,Independent,777,11,788,0.07,38 - TIRUNELVELI (Tamil Nadu),22,38
21.0,DR RAJENDRA RETNAM K,Independent,685,4,689,0.06,38 - TIRUNELVELI (Tamil Nadu),22,38
22.0,SEVAL KANNAN B ADVOCATE,Independent,622,14,636,0.06,38 - TIRUNELVELI (Tamil Nadu),22,38
23.0,RAGHAVAN C M,Independent,364,2,366,0.03,38 - TIRUNELVELI (Tamil Nadu),22,38
24.0,NOTA,None of the Above,7285,111,7396,0.69,38 - TIRUNELVELI (Tamil Nadu),22,38
,Total,,1060656,6792,1067448,,38 - TIRUNELVELI (Tamil Nadu),22,38
1.0,VIJAYAKUMAR (Alias) VIJAY VASANTH,Indian National Congress,540267,5981,546248,53.08,39 - KANNIYAKUMARI (Tamil Nadu),22,39
2.0,RADHAKRISHNAN P,Bharatiya Janata Party,361623,4718,366341,35.6,39 - KANNIYAKUMARI (Tamil Nadu),22,39
3.0,MARIA JENNIFER CLARA MICHAEL,Naam Tamilar Katchi,51893,828,52721,5.12,39 - KANNIYAKUMARI (Tamil Nadu),22,39
4.0,PASILIAN NAZERATH,All India Anna Dravida Munnetra Kazhagam,40927,466,41393,4.02,39 - KANNIYAKUMARI (Tamil Nadu),22,39
5.0,NAGOOR MEERAN PEER MOHAMED U,Independent,4412,3,4415,0.43,39 - KANNIYAKUMARI (Tamil Nadu),22,39
6.0,BERRILA L,Independent,3256,6,3262,0.32,39 - KANNIYAKUMARI (Tamil Nadu),22,39
7.0,BALASUBRAMANIAN T,Independent,2047,25,2072,0.2,39 - KANNIYAKUMARI (Tamil Nadu),22,39
8.0,VIJAYAN G,Bahujan Samaj Party,1607,16,1623,0.16,39 - KANNIYAKUMARI (Tamil Nadu),22,39
9.0,DENNISON V,Independent,1274,4,1278,0.12,39 - KANNIYAKUMARI (Tamil Nadu),22,39
10.0,DR TOM MANOHAR C M,Punnagai Desam Party,1034,6,1040,0.1,39 - KANNIYAKUMARI (Tamil Nadu),22,39
11.0,SATHISH BABU P,Independent,747,1,748,0.07,39 - KANNIYAKUMARI (Tamil Nadu),22,39
12.0,RAJAN SINGH,Bahujan Dravida Party,592,6,598,0.06,39 - KANNIYAKUMARI (Tamil Nadu),22,39
13.0,GEETA M,Thakkam Katchi,528,24,552,0.05,39 - KANNIYAKUMARI (Tamil Nadu),22,39
14.0,SANTHAKUMAR N,Independent,521,6,527,0.05,39 - KANNIYAKUMARI (Tamil Nadu),22,39
15.0,RAMESHKUMAR J L,Independent,464,1,465,0.05,39 - KANNIYAKUMARI (Tamil Nadu),22,39
16.0,ESAKKIMUTHU N,Independent,435,6,441,0.04,39 - KANNIYAKUMARI (Tamil Nadu),22,39
17.0,AYYAPPAN V,Independent,358,15,373,0.04,39 - KANNIYAKUMARI (Tamil Nadu),22,39
18.0,SARAVANAN N,Samaniya Makkal Nala Katchi,308,7,315,0.03,39 - KANNIYAKUMARI (Tamil Nadu),22,39
19.0,VINO JEBA SEELAN T,Independent,265,5,270,0.03,39 - KANNIYAKUMARI (Tamil Nadu),22,39
20.0,KRISHNAN P,Independent,250,4,254,0.02,39 - KANNIYAKUMARI (Tamil Nadu),22,39
21.0,VENKADESH S C,Independent,187,1,188,0.02,39 - KANNIYAKUMARI (Tamil Nadu),22,39
22.0,ANTONY MICHAEL J,Independent,166,9,175,0.02,39 - KANNIYAKUMARI (Tamil Nadu),22,39
23.0,NOTA,None of the Above,3680,76,3756,0.36,39 - KANNIYAKUMARI (Tamil Nadu),22,39
,Total,,1016841,12214,1029055,,39 - KANNIYAKUMARI (Tamil Nadu),22,39
1.0,BIPLAB KUMAR DEB,Bharatiya Janata Party,868484,12857,881341,72.85,1 - Tripura West (Tripura),23,1
2.0,ASISH KUMAR SAHA,Indian National Congress,265912,3851,269763,22.3,1 - Tripura West (Tripura),23,1
3.0,RAMENDRA REANG,Independent,8899,33,8932,0.74,1 - Tripura West (Tripura),23,1
4.0,ARUN KUMAR BHAUMIK,Socialist Unity Centre Of India (COMMUNIST),8617,167,8784,0.73,1 - Tripura West (Tripura),23,1
5.0,GOURI SANKAR NANDI,Independent,8074,40,8114,0.67,1 - Tripura West (Tripura),23,1
6.0,MILAN PADA MURASING,Independent,6625,27,6652,0.55,1 - Tripura West (Tripura),23,1
7.0,BALARAM DEBBARMA,Independent,4356,123,4479,0.37,1 - Tripura West (Tripura),23,1
8.0,BRAJALAL DEBNATH,Independent,3656,27,3683,0.3,1 - Tripura West (Tripura),23,1
9.0,ARNAB ROY,Republican Party of India (A),3420,29,3449,0.29,1 - Tripura West (Tripura),23,1
10.0,NOTA,None of the Above,14444,168,14612,1.21,1 - Tripura West (Tripura),23,1
,Total,,1192487,17322,1209809,,1 - Tripura West (Tripura),23,1
1.0,KRITI DEVI DEBBARMAN,Bharatiya Janata Party,768129,9318,777447,68.54,2 - Tripura East (Tripura),23,2
2.0,RAJENDRA REANG,Communist Party of India (Marxist),287772,2856,290628,25.62,2 - Tripura East (Tripura),23,2
3.0,ARCHANA URANG,Independent,10814,108,10922,0.96,2 - Tripura East (Tripura),23,2
4.0,DARSHAN KUMAR REANG,Independent,9200,69,9269,0.82,2 - Tripura East (Tripura),23,2
5.0,SANTOJOY TRIPURA,Independent,6825,37,6862,0.6,2 - Tripura East (Tripura),23,2
6.0,SHIB CHANDRA DEBBARMA,Independent,6685,34,6719,0.59,2 - Tripura East (Tripura),23,2
7.0,SATRUGHNA JAMATIA,Independent,5939,28,5967,0.53,2 - Tripura East (Tripura),23,2
8.0,KRISHNA MOHAN JAMATIA,Independent,4166,51,4217,0.37,2 - Tripura East (Tripura),23,2
9.0,KALPA MOHAN TRIPURA,Independent,3958,53,4011,0.35,2 - Tripura East (Tripura),23,2
10.0,NOTA,None of the Above,18176,127,18303,1.61,2 - Tripura East (Tripura),23,2
,Total,,1121664,12681,1134345,,2 - Tripura East (Tripura),23,2
1.0,IMRAN MASOOD,Indian National Congress,547383,584,547967,44.57,1 - Saharanpur (Uttar Pradesh),24,1
2.0,RAGHAV LAKHANPAL,Bharatiya Janata Party,482120,1305,483425,39.32,1 - Saharanpur (Uttar Pradesh),24,1
3.0,MAJID ALI,Bahujan Samaj Party,179994,359,180353,14.67,1 - Saharanpur (Uttar Pradesh),24,1
4.0,MOHD INAM,Akhil Bhartiya Parivar Party,5392,8,5400,0.44,1 - Saharanpur (Uttar Pradesh),24,1
5.0,SHABNAM,Independent,2370,3,2373,0.19,1 - Saharanpur (Uttar Pradesh),24,1
6.0,SHAHBAJ,Independent,1696,2,1698,0.14,1 - Saharanpur (Uttar Pradesh),24,1
7.0,RASHID KHAN,Independent,1227,3,1230,0.1,1 - Saharanpur (Uttar Pradesh),24,1
8.0,TASMEEM BANO,Independent,883,2,885,0.07,1 - Saharanpur (Uttar Pradesh),24,1
9.0,RAJKUMAR,Independent,807,6,813,0.07,1 - Saharanpur (Uttar Pradesh),24,1
10.0,KAMRAN,Independent,744,1,745,0.06,1 - Saharanpur (Uttar Pradesh),24,1
11.0,NOTA,None of the Above,4559,7,4566,0.37,1 - Saharanpur (Uttar Pradesh),24,1
,Total,,1227175,2280,1229455,,1 - Saharanpur (Uttar Pradesh),24,1
1.0,IQRA CHOUDHARY,Samajwadi Party,526887,1126,528013,48.9,2 - Kairana (Uttar Pradesh),24,2
2.0,PRADEEP KUMAR,Bharatiya Janata Party,456075,2822,458897,42.5,2 - Kairana (Uttar Pradesh),24,2
3.0,SRIPAL,Bahujan Samaj Party,75978,222,76200,7.06,2 - Kairana (Uttar Pradesh),24,2
4.0,JAHID,Social Democratic Party Of India,3316,4,3320,0.31,2 - Kairana (Uttar Pradesh),24,2
5.0,SHOKINDER KUMAR,Independent,1983,2,1985,0.18,2 - Kairana (Uttar Pradesh),24,2
6.0,MANOJ RANA,Independent,1925,11,1936,0.18,2 - Kairana (Uttar Pradesh),24,2
7.0,VIKAS KUMAR,Independent,1098,2,1100,0.1,2 - Kairana (Uttar Pradesh),24,2
8.0,OMBEER,Azad Adhikar Sena,1088,8,1096,0.1,2 - Kairana (Uttar Pradesh),24,2
9.0,VIKRAM SINGH,Independent,897,3,900,0.08,2 - Kairana (Uttar Pradesh),24,2
10.0,PRITI KASHYAP,Rashtriya Mazdoor Ekta Party,781,10,791,0.07,2 - Kairana (Uttar Pradesh),24,2
11.0,VIKRAM SAINI,Akhand Bharat Swatantra Party,776,4,780,0.07,2 - Kairana (Uttar Pradesh),24,2
12.0,YOGESH,Independent,664,6,670,0.06,2 - Kairana (Uttar Pradesh),24,2
13.0,MOHD KADIR,Independent,436,6,442,0.04,2 - Kairana (Uttar Pradesh),24,2
14.0,NAND KISHOOR,Aapki Apni Party (Peoples),420,7,427,0.04,2 - Kairana (Uttar Pradesh),24,2
15.0,NOTA,None of the Above,3213,36,3249,0.3,2 - Kairana (Uttar Pradesh),24,2
,Total,,1075537,4269,1079806,,2 - Kairana (Uttar Pradesh),24,2
1.0,HARENDRA SINGH MALIK,Samajwadi Party,469804,917,470721,43.64,3 - Muzaffarnagar (Uttar Pradesh),24,3
2.0,SANJEEV KUMAR BALYAN,Bharatiya Janata Party,443815,2234,446049,41.35,3 - Muzaffarnagar (Uttar Pradesh),24,3
3.0,DARA SINGH PRAJAPATI,Bahujan Samaj Party,143323,384,143707,13.32,3 - Muzaffarnagar (Uttar Pradesh),24,3
4.0,SUNIL TYAGI,Independent,7131,36,7167,0.66,3 - Muzaffarnagar (Uttar Pradesh),24,3
5.0,KAVITA,Rashtrawadi Janlok Party (Satya),1970,30,2000,0.19,3 - Muzaffarnagar (Uttar Pradesh),24,3
6.0,SHASHIKANT SHAMAR,Independent,1429,2,1431,0.13,3 - Muzaffarnagar (Uttar Pradesh),24,3
7.0,BIRBAL SINGH,Vishal Janta Party,1419,2,1421,0.13,3 - Muzaffarnagar (Uttar Pradesh),24,3
8.0,NEEL KUMAR,Jai Samta Party,858,3,861,0.08,3 - Muzaffarnagar (Uttar Pradesh),24,3
9.0,RESHU SHARMA,Independent,679,5,684,0.06,3 - Muzaffarnagar (Uttar Pradesh),24,3
10.0,ANKUR,Independent,362,10,372,0.03,3 - Muzaffarnagar (Uttar Pradesh),24,3
11.0,MANUJ VERMA,Independent,333,7,340,0.03,3 - Muzaffarnagar (Uttar Pradesh),24,3
12.0,NOTA,None of the Above,3884,32,3916,0.36,3 - Muzaffarnagar (Uttar Pradesh),24,3
,Total,,1075007,3662,1078669,,3 - Muzaffarnagar (Uttar Pradesh),24,3
1.0,CHANDAN CHAUHAN,Rashtriya Lok Dal,402604,1889,404493,39.48,4 - Bijnor (Uttar Pradesh),24,4
2.0,DEEPAK,Samajwadi Party,366226,759,366985,35.82,4 - Bijnor (Uttar Pradesh),24,4
3.0,VIJENDER SINGH,Bahujan Samaj Party,218294,692,218986,21.38,4 - Bijnor (Uttar Pradesh),24,4
4.0,ABDUL BARI,Jai Samta Party,8046,26,8072,0.79,4 - Bijnor (Uttar Pradesh),24,4
5.0,DEEPAK KUMAR,Independent,7284,34,7318,0.71,4 - Bijnor (Uttar Pradesh),24,4
6.0,ZAHEER,Independent,2780,8,2788,0.27,4 - Bijnor (Uttar Pradesh),24,4
7.0,RAJAPAL,Peoples Party of India (Democratic),2361,12,2373,0.23,4 - Bijnor (Uttar Pradesh),24,4
8.0,MOHD. SHAHJAD,Independent,2342,5,2347,0.23,4 - Bijnor (Uttar Pradesh),24,4
9.0,FARMAN,Majloom Samaj Party,2334,9,2343,0.23,4 - Bijnor (Uttar Pradesh),24,4
10.0,CHANDAN SINGH,Independent,2132,44,2176,0.21,4 - Bijnor (Uttar Pradesh),24,4
11.0,RAMDHAN SINGH,Majdoor Kisan Union Party,2088,17,2105,0.21,4 - Bijnor (Uttar Pradesh),24,4
12.0,NOTA,None of the Above,4386,60,4446,0.43,4 - Bijnor (Uttar Pradesh),24,4
,Total,,1020877,3555,1024432,,4 - Bijnor (Uttar Pradesh),24,4
1.0,CHANDRASHEKHAR,Aazad Samaj Party (Kanshi Ram),511812,740,512552,51.19,5 - Nagina (Uttar Pradesh),24,5
2.0,OM KUMAR,Bharatiya Janata Party,359751,1328,361079,36.06,5 - Nagina (Uttar Pradesh),24,5
3.0,MANOJ KUMAR,Samajwadi Party,102104,270,102374,10.22,5 - Nagina (Uttar Pradesh),24,5
4.0,SURENDRA PAL SINGH,Bahujan Samaj Party,13212,60,13272,1.33,5 - Nagina (Uttar Pradesh),24,5
5.0,JOGENDRA,Independent,4509,9,4518,0.45,5 - Nagina (Uttar Pradesh),24,5
6.0,SANJEEV KUMAR,Independent,2195,6,2201,0.22,5 - Nagina (Uttar Pradesh),24,5
7.0,NOTA,None of the Above,5287,20,5307,0.53,5 - Nagina (Uttar Pradesh),24,5
,Total,,998870,2433,1001303,,5 - Nagina (Uttar Pradesh),24,5
1.0,RUCHI VIRA,Samajwadi Party,636733,630,637363,49.67,6 - Moradabad (Uttar Pradesh),24,6
2.0,KUNWAR SARVESH KUMAR,Bharatiya Janata Party,530176,1425,531601,41.43,6 - Moradabad (Uttar Pradesh),24,6
3.0,MO IRFAN,Bahujan Samaj Party,92116,197,92313,7.19,6 - Moradabad (Uttar Pradesh),24,6
4.0,AJAY YADAV,Apna Haq Party,4084,10,4094,0.32,6 - Moradabad (Uttar Pradesh),24,6
5.0,MUSHARRAT HUSAIN,Independent,2583,-,2583,0.2,6 - Moradabad (Uttar Pradesh),24,6
6.0,SADHNA SINGH,Independent,2292,4,2296,0.18,6 - Moradabad (Uttar Pradesh),24,6
7.0,MOHD JAMSHED,Independent,1717,2,1719,0.13,6 - Moradabad (Uttar Pradesh),24,6
8.0,ONKAR SINGH,Bharatiya Bahujan Samta Party,1449,10,1459,0.11,6 - Moradabad (Uttar Pradesh),24,6
9.0,SHAKIL AHMED,Samata Party,1356,-,1356,0.11,6 - Moradabad (Uttar Pradesh),24,6
10.0,HAR KISHORE SINGH,Socialist Unity Centre Of India (COMMUNIST),940,-,940,0.07,6 - Moradabad (Uttar Pradesh),24,6
11.0,AMARJEET SINGH JATAV,Independent,937,15,952,0.07,6 - Moradabad (Uttar Pradesh),24,6
12.0,GANGARAM SHARMA,Rashtriya Congress(J) Party,629,56,685,0.05,6 - Moradabad (Uttar Pradesh),24,6
13.0,NOTA,None of the Above,5807,17,5824,0.45,6 - Moradabad (Uttar Pradesh),24,6
,Total,,1280819,2366,1283185,,6 - Moradabad (Uttar Pradesh),24,6
1.0,MOHIBBULLAH,Samajwadi Party,481252,251,481503,49.74,7 - Rampur (Uttar Pradesh),24,7
2.0,GHANSHYAM SINGH LODHI,Bharatiya Janata Party,393154,915,394069,40.71,7 - Rampur (Uttar Pradesh),24,7
3.0,ZEESHAN KHAN,Bahujan Samaj Party,79561,131,79692,8.23,7 - Rampur (Uttar Pradesh),24,7
4.0,ARSHAD WARSI,Minorities Democratic Party,2919,8,2927,0.3,7 - Rampur (Uttar Pradesh),24,7
5.0,MEHMOOD PRACHA,Independent,2750,9,2759,0.28,7 - Rampur (Uttar Pradesh),24,7
6.0,SHIV PRASAD,Independent,1465,11,1476,0.15,7 - Rampur (Uttar Pradesh),24,7
7.0,NOTA,None of the Above,5643,10,5653,0.58,7 - Rampur (Uttar Pradesh),24,7
,Total,,966744,1335,968079,,7 - Rampur (Uttar Pradesh),24,7
1.0,ZIA UR REHMAN,Samajwadi Party,570745,416,571161,47.8,8 - Sambhal (Uttar Pradesh),24,8
2.0,PARMESHWAR LAL SAINI,Bharatiya Janata Party,448983,684,449667,37.63,8 - Sambhal (Uttar Pradesh),24,8
3.0,CHAUDHARY SAULAT ALI,Bahujan Samaj Party,152317,143,152460,12.76,8 - Sambhal (Uttar Pradesh),24,8
4.0,WASEEM SO MOH SHAMIM,Independent,3863,1,3864,0.32,8 - Sambhal (Uttar Pradesh),24,8
5.0,MOHD WASEEM SO MOHD FAREED,Independent,2077,-,2077,0.17,8 - Sambhal (Uttar Pradesh),24,8
6.0,JAYGAMUL ISLAM,Janta Shashan Party,1940,2,1942,0.16,8 - Sambhal (Uttar Pradesh),24,8
7.0,ANUJ VARSHNEY,Independent,1674,3,1677,0.14,8 - Sambhal (Uttar Pradesh),24,8
8.0,MAHANDRA SINGH,Independent,1291,3,1294,0.11,8 - Sambhal (Uttar Pradesh),24,8
9.0,SANTOSH,Kisan Kranti Dal,1201,3,1204,0.1,8 - Sambhal (Uttar Pradesh),24,8
10.0,DR RASHID,Peace Party,1059,1,1060,0.09,8 - Sambhal (Uttar Pradesh),24,8
11.0,TAUFIK AHAMAD,Independent,722,1,723,0.06,8 - Sambhal (Uttar Pradesh),24,8
12.0,PAVAN KUMAR,Log Party,636,1,637,0.05,8 - Sambhal (Uttar Pradesh),24,8
13.0,NOTA,None of the Above,7213,4,7217,0.6,8 - Sambhal (Uttar Pradesh),24,8
,Total,,1193721,1262,1194983,,8 - Sambhal (Uttar Pradesh),24,8
1.0,KANWAR SINGH TANWAR,Bharatiya Janata Party,475210,1296,476506,42.9,9 - Amroha (Uttar Pradesh),24,9
2.0,KUNWAR DANISH ALI,Indian National Congress,447343,493,447836,40.32,9 - Amroha (Uttar Pradesh),24,9
3.0,MUJAHID HUSAIN,Bahujan Samaj Party,163885,214,164099,14.77,9 - Amroha (Uttar Pradesh),24,9
4.0,DHANISH,Independent,3615,2,3617,0.33,9 - Amroha (Uttar Pradesh),24,9
5.0,SURESH,Independent,2716,1,2717,0.24,9 - Amroha (Uttar Pradesh),24,9
6.0,JEETPAL RANA,Independent,2550,6,2556,0.23,9 - Amroha (Uttar Pradesh),24,9
7.0,SUHEL HAIDER,Akhil Bhartiya Parivar Party,2492,12,2504,0.23,9 - Amroha (Uttar Pradesh),24,9
8.0,NARENDRA SINGH,Independent,1776,3,1779,0.16,9 - Amroha (Uttar Pradesh),24,9
9.0,NAEEMUDDIN,Independent,1002,2,1004,0.09,9 - Amroha (Uttar Pradesh),24,9
10.0,KUSHAGRA,Independent,856,2,858,0.08,9 - Amroha (Uttar Pradesh),24,9
11.0,KASHIF HUSAIN,Independent,677,2,679,0.06,9 - Amroha (Uttar Pradesh),24,9
12.0,KUMDESH KUMAR,Independent,627,8,635,0.06,9 - Amroha (Uttar Pradesh),24,9
13.0,NOTA,None of the Above,5886,14,5900,0.53,9 - Amroha (Uttar Pradesh),24,9
,Total,,1108635,2055,1110690,,9 - Amroha (Uttar Pradesh),24,9
1.0,ARUN GOVIL,Bharatiya Janata Party,544375,2094,546469,46.21,10 - Meerut (Uttar Pradesh),24,10
2.0,SUNITA VERMA,Samajwadi Party,535009,875,535884,45.32,10 - Meerut (Uttar Pradesh),24,10
3.0,DEVVRAT KUMAR TYAGI,Bahujan Samaj Party,86693,332,87025,7.36,10 - Meerut (Uttar Pradesh),24,10
4.0,BHUPENDRA PAL URF BHUPPI BHAI,Rashtriya Shoshit Samaj Party,2615,11,2626,0.22,10 - Meerut (Uttar Pradesh),24,10
5.0,HAJI AFZAL,Sabse Achchhi Party,2026,3,2029,0.17,10 - Meerut (Uttar Pradesh),24,10
6.0,ABID HUSAIN,Social Democratic Party Of India,1917,5,1922,0.16,10 - Meerut (Uttar Pradesh),24,10
7.0,LIYAKAT,Majloom Samaj Party,891,3,894,0.08,10 - Meerut (Uttar Pradesh),24,10
8.0,DR HIMANSHU BHATNAGAR,Jai Hind National Party,848,6,854,0.07,10 - Meerut (Uttar Pradesh),24,10
9.0,NOTA,None of the Above,4738,38,4776,0.4,10 - Meerut (Uttar Pradesh),24,10
,Total,,1179112,3367,1182479,,10 - Meerut (Uttar Pradesh),24,10
1.0,DR RAJKUMAR SANGWAN,Rashtriya Lok Dal,485765,3202,488967,52.36,11 - Baghpat (Uttar Pradesh),24,11
2.0,AMARPAL,Samajwadi Party,328487,1021,329508,35.29,11 - Baghpat (Uttar Pradesh),24,11
3.0,PRAVEEN BANSAL,Bahujan Samaj Party,91740,526,92266,9.88,11 - Baghpat (Uttar Pradesh),24,11
4.0,MUKESH KUMAR SHARMA,Azad Adhikar Sena,5441,82,5523,0.59,11 - Baghpat (Uttar Pradesh),24,11
5.0,MAHENDER SINGH,Sarvjan Samta Party,4957,63,5020,0.54,11 - Baghpat (Uttar Pradesh),24,11
6.0,SUKHVIR SINGH,Swatantra Jantaraj Party,4056,43,4099,0.44,11 - Baghpat (Uttar Pradesh),24,11
7.0,RUBY KASHYAP,Sarvjan Lok Shakti Party,3202,78,3280,0.35,11 - Baghpat (Uttar Pradesh),24,11
8.0,NOTA,None of the Above,4980,130,5110,0.55,11 - Baghpat (Uttar Pradesh),24,11
,Total,,928628,5145,933773,,11 - Baghpat (Uttar Pradesh),24,11
1.0,ATUL GARG,Bharatiya Janata Party,853036,1134,854170,58.09,12 - Ghaziabad (Uttar Pradesh),24,12
2.0,DOLLY SHARMA,Indian National Congress,516699,506,517205,35.17,12 - Ghaziabad (Uttar Pradesh),24,12
3.0,NAND KISHOR PUNDIR,Bahujan Samaj Party,79387,138,79525,5.41,12 - Ghaziabad (Uttar Pradesh),24,12
4.0,RAVI KUMAR PANCHAL,Independent,1965,1,1966,0.13,12 - Ghaziabad (Uttar Pradesh),24,12
5.0,ANAND KUMAR,Rashtra Nirman Party,1174,4,1178,0.08,12 - Ghaziabad (Uttar Pradesh),24,12
6.0,NATTHUSINGH CHAUDHARY,Independent,1159,3,1162,0.08,12 - Ghaziabad (Uttar Pradesh),24,12
7.0,AURANGJEB,Independent,1120,-,1120,0.08,12 - Ghaziabad (Uttar Pradesh),24,12
8.0,NAMAHA,Samaj Vikas Kranti Party,1079,1,1080,0.07,12 - Ghaziabad (Uttar Pradesh),24,12
9.0,AVDESH KUMAR,Independent,1037,6,1043,0.07,12 - Ghaziabad (Uttar Pradesh),24,12
10.0,POOJA SAXENA,Right to Recall Party,874,4,878,0.06,12 - Ghaziabad (Uttar Pradesh),24,12
11.0,KAVITA,Independent,772,3,775,0.05,12 - Ghaziabad (Uttar Pradesh),24,12
12.0,ANSUL GUPTA,Rashtriya Jan Karmath Party,763,1,764,0.05,12 - Ghaziabad (Uttar Pradesh),24,12
13.0,DHIRENDRA SINGH BHADAURIYA,Subhashwadi Bhartiya Samajwadi Party (Subhas Party),696,4,700,0.05,12 - Ghaziabad (Uttar Pradesh),24,12
14.0,ABHISHEK PUNDIR,Independent,652,1,653,0.04,12 - Ghaziabad (Uttar Pradesh),24,12
15.0,NOTA,None of the Above,8195,16,8211,0.56,12 - Ghaziabad (Uttar Pradesh),24,12
,Total,,1468608,1822,1470430,,12 - Ghaziabad (Uttar Pradesh),24,12
1.0,DR. MAHESH SHARMA,Bharatiya Janata Party,855413,2416,857829,59.69,13 - Gautam Buddha Nagar (Uttar Pradesh),24,13
2.0,DR. MAHENDRA SINGH NAGAR,Samajwadi Party,297697,660,298357,20.76,13 - Gautam Buddha Nagar (Uttar Pradesh),24,13
3.0,RAJENDRA SINGH SOLANKI,Bahujan Samaj Party,250962,653,251615,17.51,13 - Gautam Buddha Nagar (Uttar Pradesh),24,13
4.0,BHIM PRAKASH JIGYASU,Viro Ke Vir Indian Party,3873,2,3875,0.27,13 - Gautam Buddha Nagar (Uttar Pradesh),24,13
5.0,MOHD. MUMTAJ AALAM,Independent,2818,3,2821,0.2,13 - Gautam Buddha Nagar (Uttar Pradesh),24,13
6.0,SHIVAM ASHUTOSH,Independent,2637,4,2641,0.18,13 - Gautam Buddha Nagar (Uttar Pradesh),24,13
7.0,MANISH KUMAR DWIVEDI,Akhil Bhartiya Parivar Party,1769,3,1772,0.12,13 - Gautam Buddha Nagar (Uttar Pradesh),24,13
8.0,KISHOR SINGH,National Party,1739,28,1767,0.12,13 - Gautam Buddha Nagar (Uttar Pradesh),24,13
9.0,MAHKAR SINGH,Independent,1118,6,1124,0.08,13 - Gautam Buddha Nagar (Uttar Pradesh),24,13
10.0,KM. SHALU,Loktantrik Janshakti Party,1020,30,1050,0.07,13 - Gautam Buddha Nagar (Uttar Pradesh),24,13
11.0,PARAG KAUSHIK,Independent,945,1,946,0.07,13 - Gautam Buddha Nagar (Uttar Pradesh),24,13
12.0,NARESH NAUTIYAL,Bhartiya Rashtriya Jansatta,931,10,941,0.07,13 - Gautam Buddha Nagar (Uttar Pradesh),24,13
13.0,RAN SINGH DUDEE,Super Power India Party,905,3,908,0.06,13 - Gautam Buddha Nagar (Uttar Pradesh),24,13
14.0,RAJEEV MISHRA,Jai Hind National Party,642,15,657,0.05,13 - Gautam Buddha Nagar (Uttar Pradesh),24,13
15.0,NARAVEDASHVAR,Subhashwadi Bhartiya Samajwadi Party (Subhas Party),615,2,617,0.04,13 - Gautam Buddha Nagar (Uttar Pradesh),24,13
16.0,NOTA,None of the Above,10286,38,10324,0.72,13 - Gautam Buddha Nagar (Uttar Pradesh),24,13
,Total,,1433370,3874,1437244,,13 - Gautam Buddha Nagar (Uttar Pradesh),24,13
1.0,DR BHOLA SINGH,Bharatiya Janata Party,594040,3270,597310,56.65,14 - Bulandshahr (Uttar Pradesh),24,14
2.0,SHIVRAM,Indian National Congress,321043,1133,322176,30.56,14 - Bulandshahr (Uttar Pradesh),24,14
3.0,GIRISH CHANDRA,Bahujan Samaj Party,116876,548,117424,11.14,14 - Bulandshahr (Uttar Pradesh),24,14
4.0,RAJESH TUREHA,Rishivadi Karm Sheel Young Parmarthi Party,4391,10,4401,0.42,14 - Bulandshahr (Uttar Pradesh),24,14
5.0,SONAM BHARTI,Independent,3558,42,3600,0.34,14 - Bulandshahr (Uttar Pradesh),24,14
6.0,PRADEEP KUMAR,Independent,2547,16,2563,0.24,14 - Bulandshahr (Uttar Pradesh),24,14
7.0,NOTA,None of the Above,6870,55,6925,0.66,14 - Bulandshahr (Uttar Pradesh),24,14
,Total,,1049325,5074,1054399,,14 - Bulandshahr (Uttar Pradesh),24,14
1.0,SATISH KUMAR GAUTAM,Bharatiya Janata Party,500453,1381,501834,44.28,15 - Aligarh (Uttar Pradesh),24,15
2.0,BIJENDRA SINGH,Samajwadi Party,485588,599,486187,42.9,15 - Aligarh (Uttar Pradesh),24,15
3.0,HITENDRA KUMAR ALIAS BUNTY UPADHYAY,Bahujan Samaj Party,123770,159,123929,10.93,15 - Aligarh (Uttar Pradesh),24,15
4.0,GYANI RAM,Independent,3795,4,3799,0.34,15 - Aligarh (Uttar Pradesh),24,15
5.0,SATISH KUMAR,Independent,3553,8,3561,0.31,15 - Aligarh (Uttar Pradesh),24,15
6.0,SATISH KUMAR,Swatantra Jantaraj Party,1647,1,1648,0.15,15 - Aligarh (Uttar Pradesh),24,15
7.0,MANOJ KUMAR ALIAS MANOJ LODHI,Saman Adhikar Party,1434,6,1440,0.13,15 - Aligarh (Uttar Pradesh),24,15
8.0,KESHAV DEV ALIAS PANDIT KESHAV DEV GAUTAM,Independent,1308,11,1319,0.12,15 - Aligarh (Uttar Pradesh),24,15
9.0,SURENDRA,Moulik Adhikar Party,1175,3,1178,0.1,15 - Aligarh (Uttar Pradesh),24,15
10.0,RAJESH KUMAR,Independent,1053,3,1056,0.09,15 - Aligarh (Uttar Pradesh),24,15
11.0,DILEEP SHARMA AD.,Independent,952,3,955,0.08,15 - Aligarh (Uttar Pradesh),24,15
12.0,MAHESH CHANDRA SHARMA,Independent,733,3,736,0.06,15 - Aligarh (Uttar Pradesh),24,15
13.0,RAJ KUMAR,Rashtriya Shoshit Samaj Party,407,5,412,0.04,15 - Aligarh (Uttar Pradesh),24,15
14.0,MANOJ KUMAR SHARMA ADVOCATE,Loktantrik Janshakti Party,371,7,378,0.03,15 - Aligarh (Uttar Pradesh),24,15
15.0,NOTA,None of the Above,4916,18,4934,0.44,15 - Aligarh (Uttar Pradesh),24,15
,Total,,1131155,2211,1133366,,15 - Aligarh (Uttar Pradesh),24,15
1.0,ANOOP PRADHAN BALMIKI,Bharatiya Janata Party,552334,2412,554746,51.24,16 - Hathras (Uttar Pradesh),24,16
2.0,JASVEER VALMIKI,Samajwadi Party,306637,791,307428,28.39,16 - Hathras (Uttar Pradesh),24,16
3.0,HEMBABOO DHANGAR,Bahujan Samaj Party,200876,387,201263,18.59,16 - Hathras (Uttar Pradesh),24,16
4.0,JAYPAL MAHOR,Independent,3044,17,3061,0.28,16 - Hathras (Uttar Pradesh),24,16
5.0,RAJPAL SINGH,Independent,2361,11,2372,0.22,16 - Hathras (Uttar Pradesh),24,16
6.0,GHANSHYAM SINGH,Swaraj Bhartiya Nyay Party,2329,16,2345,0.22,16 - Hathras (Uttar Pradesh),24,16
7.0,RAVI KUMAR,Independent,1638,7,1645,0.15,16 - Hathras (Uttar Pradesh),24,16
8.0,DR. JAYVEER SINGH DHANGAR,Rashtra Uday Party,1591,16,1607,0.15,16 - Hathras (Uttar Pradesh),24,16
9.0,DINESH SAI,Independent,1140,4,1144,0.11,16 - Hathras (Uttar Pradesh),24,16
10.0,MUNNALAL JATAV,Independent,803,7,810,0.07,16 - Hathras (Uttar Pradesh),24,16
11.0,NOTA,None of the Above,6257,42,6299,0.58,16 - Hathras (Uttar Pradesh),24,16
,Total,,1079010,3710,1082720,,16 - Hathras (Uttar Pradesh),24,16
1.0,HEMAMALINI DHARMENDRA DEOL,Bharatiya Janata Party,507535,2529,510064,53.3,17 - Mathura (Uttar Pradesh),24,17
2.0,MUKESH DHANGAR,Indian National Congress,216043,614,216657,22.64,17 - Mathura (Uttar Pradesh),24,17
3.0,SURESH SINGH,Bahujan Samaj Party,188152,265,188417,19.69,17 - Mathura (Uttar Pradesh),24,17
4.0,BHANU PRATAP SINGH,Independent,15640,25,15665,1.64,17 - Mathura (Uttar Pradesh),24,17
5.0,RAKESH KUMAR,Independent,4492,2,4494,0.47,17 - Mathura (Uttar Pradesh),24,17
6.0,JAGDISH PRASAD KAUSHIK ADVOCATE,Rashtriya Samta Vikas Party,3567,8,3575,0.37,17 - Mathura (Uttar Pradesh),24,17
7.0,RAVI VERMA,Independent,2724,-,2724,0.28,17 - Mathura (Uttar Pradesh),24,17
8.0,SHIKHA SHARMA,Independent,2246,5,2251,0.24,17 - Mathura (Uttar Pradesh),24,17
9.0,KAMAL KANT SHARMA,Independent,1491,12,1503,0.16,17 - Mathura (Uttar Pradesh),24,17
10.0,YOGESH KUMAR TALAN,Independent,1491,2,1493,0.16,17 - Mathura (Uttar Pradesh),24,17
11.0,MONI FALHARI BAPU,Independent,1322,4,1326,0.14,17 - Mathura (Uttar Pradesh),24,17
12.0,KSHETRA PAL SINGH,Independent,1206,5,1211,0.13,17 - Mathura (Uttar Pradesh),24,17
13.0,DR. RASHMI YADAV,Independent,1183,6,1189,0.12,17 - Mathura (Uttar Pradesh),24,17
14.0,PRAVESHANAND PURI,Independent,1081,4,1085,0.11,17 - Mathura (Uttar Pradesh),24,17
15.0,SURESH CHANDRA VAGHEL,Rashtriya Shoshit Samaj Party,822,7,829,0.09,17 - Mathura (Uttar Pradesh),24,17
16.0,NOTA,None of the Above,4527,36,4563,0.48,17 - Mathura (Uttar Pradesh),24,17
,Total,,953522,3524,957046,,17 - Mathura (Uttar Pradesh),24,17
1.0,PROF S P SINGH BAGHEL,Bharatiya Janata Party,597061,2336,599397,53.34,18 - Agra (Uttar Pradesh),24,18
2.0,SURESH CHAND KARDAM,Samajwadi Party,326644,1459,328103,29.2,18 - Agra (Uttar Pradesh),24,18
3.0,POOJA AMROHI,Bahujan Samaj Party,175810,664,176474,15.7,18 - Agra (Uttar Pradesh),24,18
4.0,ARAM SINGH,Peoples Party of India (Democratic),4130,13,4143,0.37,18 - Agra (Uttar Pradesh),24,18
5.0,KULDEEP KUMAR,Bharatiya Kisan Parivartan Party,1997,5,2002,0.18,18 - Agra (Uttar Pradesh),24,18
6.0,MAHENDRA SINGH,Independent,1779,6,1785,0.16,18 - Agra (Uttar Pradesh),24,18
7.0,POOJA,Independent,1363,7,1370,0.12,18 - Agra (Uttar Pradesh),24,18
8.0,SARVESH KUMAR,Bharatiya Majdoor Janta Party,1123,10,1133,0.1,18 - Agra (Uttar Pradesh),24,18
9.0,AMBEDAKARI HASANURAM AMBEDAKARI,Independent,927,6,933,0.08,18 - Agra (Uttar Pradesh),24,18
10.0,JITENDRA GAUTAM,Lokpriya Rashtrawadi Party,780,2,782,0.07,18 - Agra (Uttar Pradesh),24,18
11.0,CHANDRA PAL,Adarsh Samaj Party,640,3,643,0.06,18 - Agra (Uttar Pradesh),24,18
12.0,NOTA,None of the Above,6929,85,7014,0.62,18 - Agra (Uttar Pradesh),24,18
,Total,,1119183,4596,1123779,,18 - Agra (Uttar Pradesh),24,18
1.0,RAJKUMAR CHAHAR,Bharatiya Janata Party,442862,2795,445657,43.09,19 - Fatehpur Sikri (Uttar Pradesh),24,19
2.0,RAMNATH SINGH SIKARWAR,Indian National Congress,400572,1680,402252,38.9,19 - Fatehpur Sikri (Uttar Pradesh),24,19
3.0,PT. RAMNIWAS SHARMA,Bahujan Samaj Party,120143,396,120539,11.66,19 - Fatehpur Sikri (Uttar Pradesh),24,19
4.0,DR RAMESHWAR SINGH,Independent,48301,305,48606,4.7,19 - Fatehpur Sikri (Uttar Pradesh),24,19
5.0,KALLAN KUMBHKAR,Independent,3458,5,3463,0.33,19 - Fatehpur Sikri (Uttar Pradesh),24,19
6.0,HOTAM SINGH NISHAD,Rashtriya Shoshit Samaj Party,1805,5,1810,0.18,19 - Fatehpur Sikri (Uttar Pradesh),24,19
7.0,GIRRAJ SINGH DHAKREY,"Proutist Bloc, India",1556,8,1564,0.15,19 - Fatehpur Sikri (Uttar Pradesh),24,19
8.0,SANGEETA TOMAR,Bharatiya Majdoor Janta Party,1417,16,1433,0.14,19 - Fatehpur Sikri (Uttar Pradesh),24,19
9.0,VED PRAKASH,Rashtriya Jansanchar Dal,1031,7,1038,0.1,19 - Fatehpur Sikri (Uttar Pradesh),24,19
10.0,NOTA,None of the Above,7764,29,7793,0.75,19 - Fatehpur Sikri (Uttar Pradesh),24,19
,Total,,1028909,5246,1034155,,19 - Fatehpur Sikri (Uttar Pradesh),24,19
1.0,AKSHAYA YADAV,Samajwadi Party,541861,1176,543037,49.04,20 - Firozabad (Uttar Pradesh),24,20
2.0,VISHWADEEP SINGH,Bharatiya Janata Party,452946,779,453725,40.98,20 - Firozabad (Uttar Pradesh),24,20
3.0,CHOWDHARY BASHEER,Bahujan Samaj Party,90849,99,90948,8.21,20 - Firozabad (Uttar Pradesh),24,20
4.0,UPENDRA SINGH,Bharatiya Kisan Parivartan Party,7111,8,7119,0.64,20 - Firozabad (Uttar Pradesh),24,20
5.0,RASHMI KANT,Parivartan Samaj Party,2927,3,2930,0.26,20 - Firozabad (Uttar Pradesh),24,20
6.0,PREM DUTT,Rashtra Uday Party,2876,2,2878,0.26,20 - Firozabad (Uttar Pradesh),24,20
7.0,RAJVEER,Independent,1367,13,1380,0.12,20 - Firozabad (Uttar Pradesh),24,20
8.0,NOTA,None of the Above,5273,6,5279,0.48,20 - Firozabad (Uttar Pradesh),24,20
,Total,,1105210,2086,1107296,,20 - Firozabad (Uttar Pradesh),24,20
1.0,DIMPLE YADAV,Samajwadi Party,596710,1816,598526,56.79,21 - Mainpuri (Uttar Pradesh),24,21
2.0,JAYVEER SINGH,Bharatiya Janata Party,375895,992,376887,35.76,21 - Mainpuri (Uttar Pradesh),24,21
3.0,SHIV PRASAD YADAV,Bahujan Samaj Party,66697,117,66814,6.34,21 - Mainpuri (Uttar Pradesh),24,21
4.0,SURESH CHANDRA,Independent,2366,8,2374,0.23,21 - Mainpuri (Uttar Pradesh),24,21
5.0,NAND RAM BAGRI,Voters Party International,1765,4,1769,0.17,21 - Mainpuri (Uttar Pradesh),24,21
6.0,MANJU PAL,Bhartiya Shakti Chetna Party,1148,23,1171,0.11,21 - Mainpuri (Uttar Pradesh),24,21
7.0,PRAMOD KUMAR,Independent,994,12,1006,0.1,21 - Mainpuri (Uttar Pradesh),24,21
8.0,SUNIL KUMAR MISHRA,Sarva Samaj Janata Party,878,4,882,0.08,21 - Mainpuri (Uttar Pradesh),24,21
9.0,NOTA,None of the Above,4570,12,4582,0.43,21 - Mainpuri (Uttar Pradesh),24,21
,Total,,1051023,2988,1054011,,21 - Mainpuri (Uttar Pradesh),24,21
1.0,DEVESH SHAKYA,Samajwadi Party,474263,1545,475808,47.09,22 - Etah (Uttar Pradesh),24,22
2.0,RAJVEER SINGH (RAJU BHAIYA),Bharatiya Janata Party,446748,1008,447756,44.32,22 - Etah (Uttar Pradesh),24,22
3.0,MOHAMMAD IRFAN ADVOCATE,Bahujan Samaj Party,71407,178,71585,7.08,22 - Etah (Uttar Pradesh),24,22
4.0,ANUPAM KUMAR,Kisan Kranti Dal,3944,5,3949,0.39,22 - Etah (Uttar Pradesh),24,22
5.0,KAILASH KUMAR,Independent,1728,-,1728,0.17,22 - Etah (Uttar Pradesh),24,22
6.0,DANVEER,Independent,1261,4,1265,0.13,22 - Etah (Uttar Pradesh),24,22
7.0,UDAY VEER SINGH,Peoples Party of India (Democratic),985,7,992,0.1,22 - Etah (Uttar Pradesh),24,22
8.0,ASHOK KUMAR,Independent,777,3,780,0.08,22 - Etah (Uttar Pradesh),24,22
9.0,VIABHAV MISHRA,Bhartiya Shakti Chetna Party,742,5,747,0.07,22 - Etah (Uttar Pradesh),24,22
10.0,AMAR SINGH,Independent,609,6,615,0.06,22 - Etah (Uttar Pradesh),24,22
11.0,NOTA,None of the Above,5145,11,5156,0.51,22 - Etah (Uttar Pradesh),24,22
,Total,,1007609,2772,1010381,,22 - Etah (Uttar Pradesh),24,22
1.0,ADITYA YADAV,Samajwadi Party,501390,465,501855,45.97,23 - Badaun (Uttar Pradesh),24,23
2.0,DURVIJAY SINGH SHAKYA,Bharatiya Janata Party,466323,541,466864,42.76,23 - Badaun (Uttar Pradesh),24,23
3.0,MUSLIM KHAN,Bahujan Samaj Party,97686,65,97751,8.95,23 - Badaun (Uttar Pradesh),24,23
4.0,SANDEEP KUMAR,Independent,3835,1,3836,0.35,23 - Badaun (Uttar Pradesh),24,23
5.0,DINESH KUMAR,Independent,2672,2,2674,0.24,23 - Badaun (Uttar Pradesh),24,23
6.0,LATA YADAV,Independent,2572,6,2578,0.24,23 - Badaun (Uttar Pradesh),24,23
7.0,NILAM RANI PAL,Rashtriya Shoshit Samaj Party,2428,10,2438,0.22,23 - Badaun (Uttar Pradesh),24,23
8.0,RAM PRATAP MAURYA,Independent,1542,1,1543,0.14,23 - Badaun (Uttar Pradesh),24,23
9.0,ISRAT ALI,Independent,1512,1,1513,0.14,23 - Badaun (Uttar Pradesh),24,23
10.0,SULEMAN,Swaraj Bhartiya Nyay Party,1240,-,1240,0.11,23 - Badaun (Uttar Pradesh),24,23
11.0,HARIRAJ SINGH URF SIPU YADAV,Log Party,909,1,910,0.08,23 - Badaun (Uttar Pradesh),24,23
12.0,NOTA,None of the Above,8553,9,8562,0.78,23 - Badaun (Uttar Pradesh),24,23
,Total,,1090662,1102,1091764,,23 - Badaun (Uttar Pradesh),24,23
1.0,NEERAJ MAURYA,Samajwadi Party,491119,1396,492515,45.23,24 - Aonla (Uttar Pradesh),24,24
2.0,DHARMENDRA KASHYAP,Bharatiya Janata Party,475434,1112,476546,43.76,24 - Aonla (Uttar Pradesh),24,24
3.0,ABID ALI,Bahujan Samaj Party,95407,223,95630,8.78,24 - Aonla (Uttar Pradesh),24,24
4.0,KAUSAR KHAN,Peace Party,4210,3,4213,0.39,24 - Aonla (Uttar Pradesh),24,24
5.0,PREM PAL SAGAR,Vanchitsamaj Insaaf Party,3328,2,3330,0.31,24 - Aonla (Uttar Pradesh),24,24
6.0,MAKKHAN LAL,Independent,2946,7,2953,0.27,24 - Aonla (Uttar Pradesh),24,24
7.0,RAJ KUMAR PATEL,Sardar Patel Siddhant Party,2700,6,2706,0.25,24 - Aonla (Uttar Pradesh),24,24
8.0,MOHAMMAD AMIR KHAN,Bharat Jodo Party,2348,7,2355,0.22,24 - Aonla (Uttar Pradesh),24,24
9.0,NIRMOD KUMAR SINGH,Bhartiya Shakti Chetna Party,1785,5,1790,0.16,24 - Aonla (Uttar Pradesh),24,24
10.0,NOTA,None of the Above,6843,15,6858,0.63,24 - Aonla (Uttar Pradesh),24,24
,Total,,1086120,2776,1088896,,24 - Aonla (Uttar Pradesh),24,24
1.0,CHHATRA PAL SINGH GANGWAR,Bharatiya Janata Party,565600,1527,567127,50.66,25 - Bareilly (Uttar Pradesh),24,25
2.0,PRAVEEN SINGH ARON,Samajwadi Party,530825,1498,532323,47.55,25 - Bareilly (Uttar Pradesh),24,25
3.0,IRSHAD ANSARI ADVOCATE,Peace Party,3548,5,3553,0.32,25 - Bareilly (Uttar Pradesh),24,25
4.0,WASEEM MIAN,Independent,2839,-,2839,0.25,25 - Bareilly (Uttar Pradesh),24,25
5.0,BHUPENDRA KUMAR MAURYA,Peoples Party of India (Democratic),1702,2,1704,0.15,25 - Bareilly (Uttar Pradesh),24,25
6.0,BUDDH PRIYA KARMRAJ RAHUL,Independent,1192,2,1194,0.11,25 - Bareilly (Uttar Pradesh),24,25
7.0,ROHTASH KASHYAP,Jan Shakti Ekta Party,844,3,847,0.08,25 - Bareilly (Uttar Pradesh),24,25
8.0,JAGPAL SINGH YADAV,Samrat Mihir Bhoj Samaj Party,654,2,656,0.06,25 - Bareilly (Uttar Pradesh),24,25
9.0,RAVI KUMAR,Sardar Patel Siddhant Party,626,1,627,0.06,25 - Bareilly (Uttar Pradesh),24,25
10.0,MOHD NAJIM ALI,Bharat Jodo Party,624,9,633,0.06,25 - Bareilly (Uttar Pradesh),24,25
11.0,NITIN MOHAN,Independent,619,1,620,0.06,25 - Bareilly (Uttar Pradesh),24,25
12.0,ASHISH GANGWAR,Independent,616,-,616,0.06,25 - Bareilly (Uttar Pradesh),24,25
13.0,AYSHA BI,Independent,550,9,559,0.05,25 - Bareilly (Uttar Pradesh),24,25
14.0,NOTA,None of the Above,6226,34,6260,0.56,25 - Bareilly (Uttar Pradesh),24,25
,Total,,1116465,3093,1119558,,25 - Bareilly (Uttar Pradesh),24,25
1.0,JITIN PRASADA,Bharatiya Janata Party,605199,1959,607158,52.3,26 - Pilibhit (Uttar Pradesh),24,26
2.0,BHAGWAT SARAN GANGWAR,Samajwadi Party,439735,2488,442223,38.09,26 - Pilibhit (Uttar Pradesh),24,26
3.0,ANIS AHMED KHAN (PHOOL BABU),Bahujan Samaj Party,89252,445,89697,7.73,26 - Pilibhit (Uttar Pradesh),24,26
4.0,RAJEEV KUMAR SAXENA,Bhartiya Krishak Dal,3800,9,3809,0.33,26 - Pilibhit (Uttar Pradesh),24,26
5.0,SUSHIL KUMAR SHUKLA,Independent,2723,4,2727,0.23,26 - Pilibhit (Uttar Pradesh),24,26
6.0,MOHMMAD SHAHID HUSAIN,Independent,1842,4,1846,0.16,26 - Pilibhit (Uttar Pradesh),24,26
7.0,ASHISH KUMAR,Independent,1842,8,1850,0.16,26 - Pilibhit (Uttar Pradesh),24,26
8.0,ADARSH PANDEY,Independent,1714,12,1726,0.15,26 - Pilibhit (Uttar Pradesh),24,26
9.0,SANJAY KUMAR BHARTI,Rashtriya Samaj Dal (R),1621,10,1631,0.14,26 - Pilibhit (Uttar Pradesh),24,26
10.0,PRAMOD BHAI PATEL ALIAS P.K.,Independent,1525,14,1539,0.13,26 - Pilibhit (Uttar Pradesh),24,26
11.0,NOTA,None of the Above,6714,27,6741,0.58,26 - Pilibhit (Uttar Pradesh),24,26
,Total,,1155967,4980,1160947,,26 - Pilibhit (Uttar Pradesh),24,26
1.0,ARUN KUMAR SAGAR,Bharatiya Janata Party,591500,1218,592718,47.5,27 - Shahjahanpur (Uttar Pradesh),24,27
2.0,JYOTSNA GOND,Samajwadi Party,534720,2619,537339,43.06,27 - Shahjahanpur (Uttar Pradesh),24,27
3.0,DOD RAM VERMA,Bahujan Samaj Party,91302,408,91710,7.35,27 - Shahjahanpur (Uttar Pradesh),24,27
4.0,KIRAN,Rashtriya Sanatan Party,6587,1,6588,0.53,27 - Shahjahanpur (Uttar Pradesh),24,27
5.0,SHIV KUMAR,Independent,2805,-,2805,0.22,27 - Shahjahanpur (Uttar Pradesh),24,27
6.0,MEENA KASYAP,Independent,2051,10,2061,0.17,27 - Shahjahanpur (Uttar Pradesh),24,27
7.0,PRADEEP KUMAR,Independent,1996,9,2005,0.16,27 - Shahjahanpur (Uttar Pradesh),24,27
8.0,PREMCHANDRA HARIJAN,Sardar Patel Siddhant Party,1686,1,1687,0.14,27 - Shahjahanpur (Uttar Pradesh),24,27
9.0,DHARM PAL,Independent,1413,10,1423,0.11,27 - Shahjahanpur (Uttar Pradesh),24,27
10.0,RAMESH CHANDRA VERMA,Manav Kranti Party,1076,-,1076,0.09,27 - Shahjahanpur (Uttar Pradesh),24,27
11.0,NOTA,None of the Above,8449,41,8490,0.68,27 - Shahjahanpur (Uttar Pradesh),24,27
,Total,,1243585,4317,1247902,,27 - Shahjahanpur (Uttar Pradesh),24,27
1.0,UTKARSH VERMA 'MADHUR',Samajwadi Party,555277,2088,557365,45.94,28 - Kheri (Uttar Pradesh),24,28
2.0,AJAY KUMAR,Bharatiya Janata Party,521954,1082,523036,43.11,28 - Kheri (Uttar Pradesh),24,28
3.0,ANSHAY KALRA,Bahujan Samaj Party,110122,338,110460,9.1,28 - Kheri (Uttar Pradesh),24,28
4.0,SANDHYA JAISWAL,Parivartan Samaj Party,3093,3,3096,0.26,28 - Kheri (Uttar Pradesh),24,28
5.0,SATENDRA KUMAR MAURYA,Independent,2980,2,2982,0.25,28 - Kheri (Uttar Pradesh),24,28
6.0,OM NATH SINGH,Rashtriya Shoshit Samaj Party,2298,2,2300,0.19,28 - Kheri (Uttar Pradesh),24,28
7.0,NARESH SINGH BHADAURIYA,Independent,2107,4,2111,0.17,28 - Kheri (Uttar Pradesh),24,28
8.0,MUKESH KUMAR (BHARTI),Rashtriya Vikalp Party,1266,3,1269,0.1,28 - Kheri (Uttar Pradesh),24,28
9.0,KHANJAN,Netaji Subhash Chander Bose Rashtriya Azad Party,1018,1,1019,0.08,28 - Kheri (Uttar Pradesh),24,28
10.0,DARWARI URF DARWARI LAL CHAUHAN,Janta Kranti Party,935,1,936,0.08,28 - Kheri (Uttar Pradesh),24,28
11.0,KM. PANCHSHEELA ANAND,Uttar Pradesh Republican Party,845,9,854,0.07,28 - Kheri (Uttar Pradesh),24,28
12.0,NOTA,None of the Above,7915,16,7931,0.65,28 - Kheri (Uttar Pradesh),24,28
,Total,,1209810,3549,1213359,,28 - Kheri (Uttar Pradesh),24,28
1.0,ANAND BHADAURIYA,Samajwadi Party,442650,1093,443743,39.91,29 - Dhaurahra (Uttar Pradesh),24,29
2.0,REKHA VERMA,Bharatiya Janata Party,438573,721,439294,39.51,29 - Dhaurahra (Uttar Pradesh),24,29
3.0,SHYAM KISHOR AWASTHI,Bahujan Samaj Party,184964,510,185474,16.68,29 - Dhaurahra (Uttar Pradesh),24,29
4.0,JANARDAN PRASAD,Communist Party of India,15898,2,15900,1.43,29 - Dhaurahra (Uttar Pradesh),24,29
5.0,RAJESH KUMAR,Political Justice Party,5020,3,5023,0.45,29 - Dhaurahra (Uttar Pradesh),24,29
6.0,ASHUTOSH PATHAK,Aam Janta Party (India),3550,6,3556,0.32,29 - Dhaurahra (Uttar Pradesh),24,29
7.0,SUDESH KUMAR,Lok Jan Sangharsh Party,2811,3,2814,0.25,29 - Dhaurahra (Uttar Pradesh),24,29
8.0,SAMRENDRA KUMAR,Independent,2482,2,2484,0.22,29 - Dhaurahra (Uttar Pradesh),24,29
9.0,VIJAY KUMAR TIWARI,Independent,2017,-,2017,0.18,29 - Dhaurahra (Uttar Pradesh),24,29
10.0,KASIM ALI,Peace Party,1809,3,1812,0.16,29 - Dhaurahra (Uttar Pradesh),24,29
11.0,SAKASEN,Sardar Patel Siddhant Party,1295,1,1296,0.12,29 - Dhaurahra (Uttar Pradesh),24,29
12.0,RAM NARESH,Independent,1290,-,1290,0.12,29 - Dhaurahra (Uttar Pradesh),24,29
13.0,NOTA,None of the Above,7133,11,7144,0.64,29 - Dhaurahra (Uttar Pradesh),24,29
,Total,,1109492,2355,1111847,,29 - Dhaurahra (Uttar Pradesh),24,29
1.0,RAKESH RATHOR,Indian National Congress,530467,671,531138,48.2,30 - Sitapur (Uttar Pradesh),24,30
2.0,RAJESH VERMA,Bharatiya Janata Party,441066,431,441497,40.06,30 - Sitapur (Uttar Pradesh),24,30
3.0,MAHENDRA SINGH YADAV,Bahujan Samaj Party,99284,80,99364,9.02,30 - Sitapur (Uttar Pradesh),24,30
4.0,MO. KASHIF ANSARI,Apna Dal (Kamerawadi),7585,1,7586,0.69,30 - Sitapur (Uttar Pradesh),24,30
5.0,LEKHRAJ LODHI,Aazad Samaj Party (Kanshi Ram),6734,-,6734,0.61,30 - Sitapur (Uttar Pradesh),24,30
6.0,VIDYAWATI GAUTAM,Independent,4193,1,4194,0.38,30 - Sitapur (Uttar Pradesh),24,30
7.0,CHANDRA SHEKHAR VERMA,Rashtriya Shoshit Samaj Party,2429,-,2429,0.22,30 - Sitapur (Uttar Pradesh),24,30
8.0,RAM ADHAR VERMA,Sardar Patel Siddhant Party,2114,1,2115,0.19,30 - Sitapur (Uttar Pradesh),24,30
9.0,NOTA,None of the Above,6954,4,6958,0.63,30 - Sitapur (Uttar Pradesh),24,30
,Total,,1100826,1189,1102015,,30 - Sitapur (Uttar Pradesh),24,30
1.0,JAI PRAKASH,Bharatiya Janata Party,485745,1053,486798,44.25,31 - Hardoi (Uttar Pradesh),24,31
2.0,USHA VERMA,Samajwadi Party,457553,1389,458942,41.72,31 - Hardoi (Uttar Pradesh),24,31
3.0,BHIMRAO AMBEDKAR,Bahujan Samaj Party,122334,295,122629,11.15,31 - Hardoi (Uttar Pradesh),24,31
4.0,SHIVE KUMAR,Independent,4897,1,4898,0.45,31 - Hardoi (Uttar Pradesh),24,31
5.0,SHYAM KUMAR,Peoples Party of India (Democratic),4196,4,4200,0.38,31 - Hardoi (Uttar Pradesh),24,31
6.0,SUNIL KUMAR VERMA,Independent,3819,2,3821,0.35,31 - Hardoi (Uttar Pradesh),24,31
7.0,INDRAPAL PASI,Justice Party,2945,1,2946,0.27,31 - Hardoi (Uttar Pradesh),24,31
8.0,MUNNA LAL,Naari Nar Rakshak Party,1588,1,1589,0.14,31 - Hardoi (Uttar Pradesh),24,31
9.0,OM PRAKASH,Independent,1559,2,1561,0.14,31 - Hardoi (Uttar Pradesh),24,31
10.0,AWADESH KUMAR,Independent,1420,4,1424,0.13,31 - Hardoi (Uttar Pradesh),24,31
11.0,PRADEEP KUMAR,Bhartiya Krishak Dal,1349,5,1354,0.12,31 - Hardoi (Uttar Pradesh),24,31
12.0,BRAHMA PRASAD,Lok Jan Sangharsh Party,1139,1,1140,0.1,31 - Hardoi (Uttar Pradesh),24,31
13.0,NOTA,None of the Above,8778,36,8814,0.8,31 - Hardoi (Uttar Pradesh),24,31
,Total,,1097322,2794,1100116,,31 - Hardoi (Uttar Pradesh),24,31
1.0,ASHOK KUMAR RAWAT,Bharatiya Janata Party,473971,1045,475016,45.15,32 - Misrikh (Uttar Pradesh),24,32
2.0,SANGITA RAJVANSHI,Samajwadi Party,440157,1453,441610,41.98,32 - Misrikh (Uttar Pradesh),24,32
3.0,B R AHIRWAR,Bahujan Samaj Party,111670,275,111945,10.64,32 - Misrikh (Uttar Pradesh),24,32
4.0,RAMPAL,Independent,3973,5,3978,0.38,32 - Misrikh (Uttar Pradesh),24,32
5.0,LALIT KUMAR,Bhartiya Shakti Chetna Party,3811,4,3815,0.36,32 - Misrikh (Uttar Pradesh),24,32
6.0,Neelam Singh,Independent,2899,6,2905,0.28,32 - Misrikh (Uttar Pradesh),24,32
7.0,VANDNA VERMA,Naari Nar Rakshak Party,1907,5,1912,0.18,32 - Misrikh (Uttar Pradesh),24,32
8.0,AVDHESH,Independent,1419,4,1423,0.14,32 - Misrikh (Uttar Pradesh),24,32
9.0,SAVITRI DEVI,Rashtriya Janshakti Samaj Party,1347,3,1350,0.13,32 - Misrikh (Uttar Pradesh),24,32
10.0,NOTA,None of the Above,7997,32,8029,0.76,32 - Misrikh (Uttar Pradesh),24,32
,Total,,1049151,2832,1051983,,32 - Misrikh (Uttar Pradesh),24,32
1.0,SWAMI SACHCHIDANAND HARI SAKSHI,Bharatiya Janata Party,614832,1301,616133,47.31,33 - Unnao (Uttar Pradesh),24,33
2.0,ANNU TANDON,Samajwadi Party,577699,2616,580315,44.56,33 - Unnao (Uttar Pradesh),24,33
3.0,ASHOK KUMAR PANDEY,Bahujan Samaj Party,72245,282,72527,5.57,33 - Unnao (Uttar Pradesh),24,33
4.0,SAIF KHAN,Parcham Party of India,8390,14,8404,0.65,33 - Unnao (Uttar Pradesh),24,33
5.0,UMESH,Independent,5625,10,5635,0.43,33 - Unnao (Uttar Pradesh),24,33
6.0,SHIV PRAKASH SINGH,Independent,4107,11,4118,0.32,33 - Unnao (Uttar Pradesh),24,33
7.0,SAIYYAD SARFARAZ GANDHI,Independent,3018,5,3023,0.23,33 - Unnao (Uttar Pradesh),24,33
8.0,HIMANSHU SHARMA,Bhartiya Shakti Chetna Party,2656,7,2663,0.2,33 - Unnao (Uttar Pradesh),24,33
9.0,NOTA,None of the Above,9430,23,9453,0.73,33 - Unnao (Uttar Pradesh),24,33
,Total,,1298002,4269,1302271,,33 - Unnao (Uttar Pradesh),24,33
1.0,R.K. CHAUDHARY,Samajwadi Party,666560,1309,667869,48.49,34 - Mohanlalganj (Uttar Pradesh),24,34
2.0,KAUSHAL KISHORE,Bharatiya Janata Party,596197,1380,597577,43.38,34 - Mohanlalganj (Uttar Pradesh),24,34
3.0,RAJESH KUMAR,Bahujan Samaj Party,88257,204,88461,6.42,34 - Mohanlalganj (Uttar Pradesh),24,34
4.0,MAHENDRA,Independent,2654,7,2661,0.19,34 - Mohanlalganj (Uttar Pradesh),24,34
5.0,SUSHIL KUMAR,Independent,2626,1,2627,0.19,34 - Mohanlalganj (Uttar Pradesh),24,34
6.0,RAMESH KUMAR,Independent,1839,2,1841,0.13,34 - Mohanlalganj (Uttar Pradesh),24,34
7.0,SUNITA CHHEDA PASI,Aam Janta Party (India),1736,13,1749,0.13,34 - Mohanlalganj (Uttar Pradesh),24,34
8.0,S. L.SINGH,Peoples Party of India (Democratic),1711,6,1717,0.12,34 - Mohanlalganj (Uttar Pradesh),24,34
9.0,BRIJESH KUMAR VIKRAM,Rashtriya Samaj Paksha,1648,7,1655,0.12,34 - Mohanlalganj (Uttar Pradesh),24,34
10.0,JITENDRA KUMAR,Independent,1402,12,1414,0.1,34 - Mohanlalganj (Uttar Pradesh),24,34
11.0,SURAJ KUMAR,Sardar Patel Siddhant Party,1010,5,1015,0.07,34 - Mohanlalganj (Uttar Pradesh),24,34
12.0,NOTA,None of the Above,8838,28,8866,0.64,34 - Mohanlalganj (Uttar Pradesh),24,34
,Total,,1374478,2974,1377452,,34 - Mohanlalganj (Uttar Pradesh),24,34
1.0,RAJ NATH SINGH,Bharatiya Janata Party,610597,2112,612709,53.89,35 - Lucknow (Uttar Pradesh),24,35
2.0,RAVIDAS MEHROTRA,Samajwadi Party,476303,1247,477550,42.0,35 - Lucknow (Uttar Pradesh),24,35
3.0,MOHAMMAD SARWAR MALIK,Bahujan Samaj Party,29982,210,30192,2.66,35 - Lucknow (Uttar Pradesh),24,35
4.0,MO AHMAD URF RINKU,Social Democratic Party Of India,3251,4,3255,0.29,35 - Lucknow (Uttar Pradesh),24,35
5.0,AKHAND PRATAP SINGH,Independent,1465,8,1473,0.13,35 - Lucknow (Uttar Pradesh),24,35
6.0,SARVAR ALI,Sarvar Party,1199,3,1202,0.11,35 - Lucknow (Uttar Pradesh),24,35
7.0,ISHTIYAQ ALI,Independent,929,5,934,0.08,35 - Lucknow (Uttar Pradesh),24,35
8.0,KAPIL MOHAN CHOWDHARY,Mera Adhikaar Rashtriya Dal,815,2,817,0.07,35 - Lucknow (Uttar Pradesh),24,35
9.0,GAURAV VERMA,Hindu Samaj Party,801,6,807,0.07,35 - Lucknow (Uttar Pradesh),24,35
10.0,BRIJESH KUMAR YADAV,Kisan Vishwa Party,601,2,603,0.05,35 - Lucknow (Uttar Pradesh),24,35
11.0,NOTA,None of the Above,7316,34,7350,0.65,35 - Lucknow (Uttar Pradesh),24,35
,Total,,1133259,3633,1136892,,35 - Lucknow (Uttar Pradesh),24,35
1.0,RAHUL GANDHI,Indian National Congress,686044,1605,687649,66.17,36 - Rae Bareli (Uttar Pradesh),24,36
2.0,DINESH PRATAP SINGH,Bharatiya Janata Party,296703,916,297619,28.64,36 - Rae Bareli (Uttar Pradesh),24,36
3.0,THAKUR PRASAD YADAV,Bahujan Samaj Party,21588,36,21624,2.08,36 - Rae Bareli (Uttar Pradesh),24,36
4.0,DILEEP SINGH,Akhil Bhartiya Apna Dal,8676,2,8678,0.84,36 - Rae Bareli (Uttar Pradesh),24,36
5.0,HORILAL,Independent,5397,2,5399,0.52,36 - Rae Bareli (Uttar Pradesh),24,36
6.0,SUDARSHAN RAM,Bhartiya Panchsheel Party,4343,2,4345,0.42,36 - Rae Bareli (Uttar Pradesh),24,36
7.0,HIND ROHITASH,Manavtawadi Samaj Party,3859,-,3859,0.37,36 - Rae Bareli (Uttar Pradesh),24,36
8.0,MO MOBIN,Apna Dal (Kamerawadi),2173,1,2174,0.21,36 - Rae Bareli (Uttar Pradesh),24,36
9.0,NOTA,None of the Above,7861,11,7872,0.76,36 - Rae Bareli (Uttar Pradesh),24,36
,Total,,1036644,2575,1039219,,36 - Rae Bareli (Uttar Pradesh),24,36
1.0,KISHORI LAL,Indian National Congress,536680,2548,539228,54.99,37 - Amethi (Uttar Pradesh),24,37
2.0,SMRITI IRANI,Bharatiya Janata Party,370754,1278,372032,37.94,37 - Amethi (Uttar Pradesh),24,37
3.0,NANHE SINGH CHAUHAN,Bahujan Samaj Party,34418,116,34534,3.52,37 - Amethi (Uttar Pradesh),24,37
4.0,SURENDRA KUMAR,Independent,5699,-,5699,0.58,37 - Amethi (Uttar Pradesh),24,37
5.0,DINESH CHANDRA MAURYA,Janshakti Samta Party,4569,8,4577,0.47,37 - Amethi (Uttar Pradesh),24,37
6.0,JAGDAMBA PRASAD YADAV,Independent,4019,1,4020,0.41,37 - Amethi (Uttar Pradesh),24,37
7.0,BHAGWANDIN PASI,Moulik Adhikar Party,2333,1,2334,0.24,37 - Amethi (Uttar Pradesh),24,37
8.0,CHANDRAWATI,Independent,2278,13,2291,0.23,37 - Amethi (Uttar Pradesh),24,37
9.0,MOHD HASAN LAHRI,Rashtriya Narayanwadi Vikas Party,1525,2,1527,0.16,37 - Amethi (Uttar Pradesh),24,37
10.0,KHUSHIRAM,Independent,1401,-,1401,0.14,37 - Amethi (Uttar Pradesh),24,37
11.0,UDAYRAJ,Independent,1300,5,1305,0.13,37 - Amethi (Uttar Pradesh),24,37
12.0,SANTRAM,Samajhdar Party,1208,4,1212,0.12,37 - Amethi (Uttar Pradesh),24,37
13.0,SHAILENDRA KUMAR MISHRA,Sanyogwadi Party,1124,4,1128,0.12,37 - Amethi (Uttar Pradesh),24,37
14.0,NOTA,None of the Above,9371,12,9383,0.96,37 - Amethi (Uttar Pradesh),24,37
,Total,,976679,3992,980671,,37 - Amethi (Uttar Pradesh),24,37
1.0,RAMBHUAL NISHAD,Samajwadi Party,442886,1444,444330,43.0,38 - Sultanpur (Uttar Pradesh),24,38
2.0,MANEKA SANJAY GANDHI,Bharatiya Janata Party,399859,1297,401156,38.82,38 - Sultanpur (Uttar Pradesh),24,38
3.0,UDRAJ VERMA,Bahujan Samaj Party,162603,422,163025,15.78,38 - Sultanpur (Uttar Pradesh),24,38
4.0,ABDUL MABOOD,Apna Desh Party,4295,2,4297,0.42,38 - Sultanpur (Uttar Pradesh),24,38
5.0,MOHAMMAD ASIF,Independent,3382,5,3387,0.33,38 - Sultanpur (Uttar Pradesh),24,38
6.0,UDAYRAJ VERMA,Independent,2900,9,2909,0.28,38 - Sultanpur (Uttar Pradesh),24,38
7.0,GIRISH LAL,Azad Party,2305,6,2311,0.22,38 - Sultanpur (Uttar Pradesh),24,38
8.0,DR SHIV SHANKAR INDIAN,Most Backward Classes Of India,2085,5,2090,0.2,38 - Sultanpur (Uttar Pradesh),24,38
9.0,JAY PRAKASH,Sardar Patel Siddhant Party,1364,5,1369,0.13,38 - Sultanpur (Uttar Pradesh),24,38
10.0,NOTA,None of the Above,8500,13,8513,0.82,38 - Sultanpur (Uttar Pradesh),24,38
,Total,,1030179,3208,1033387,,38 - Sultanpur (Uttar Pradesh),24,38
1.0,SHIV PAL SINGH PATEL (DR. S P SINGH),Samajwadi Party,439836,2096,441932,46.65,39 - Pratapgarh (Uttar Pradesh),24,39
2.0,SANGAM LAL GUPTA,Bharatiya Janata Party,374208,1518,375726,39.66,39 - Pratapgarh (Uttar Pradesh),24,39
3.0,PRATHMESH MISHRA 'SENANI',Bahujan Samaj Party,79872,272,80144,8.46,39 - Pratapgarh (Uttar Pradesh),24,39
4.0,SANDEEP SINGH,National Jan Dal,5270,16,5286,0.56,39 - Pratapgarh (Uttar Pradesh),24,39
5.0,ARUN KUMAR PANDEY,Hindustan Samaj Party,4984,7,4991,0.53,39 - Pratapgarh (Uttar Pradesh),24,39
6.0,SHIV RAM SHARMA,Moulik Adhikar Party,4709,2,4711,0.5,39 - Pratapgarh (Uttar Pradesh),24,39
7.0,AMAR SINGH,Independent,4135,3,4138,0.44,39 - Pratapgarh (Uttar Pradesh),24,39
8.0,SUNIL CHANDRA PAL,Rashtra Uday Party,3337,3,3340,0.35,39 - Pratapgarh (Uttar Pradesh),24,39
9.0,AJEET PRATAP,Independent,2581,-,2581,0.27,39 - Pratapgarh (Uttar Pradesh),24,39
10.0,VIJAY SINGH,Sanatan Sanskriti Raksha Dal,2457,2,2459,0.26,39 - Pratapgarh (Uttar Pradesh),24,39
11.0,RISHI PATEL,Apna Dal (Kamerawadi),2425,4,2429,0.26,39 - Pratapgarh (Uttar Pradesh),24,39
12.0,MAHESH KUMAR PRAJAPATI,Samajhdar Party,1963,1,1964,0.21,39 - Pratapgarh (Uttar Pradesh),24,39
13.0,DHANANJAY,Independent,1622,1,1623,0.17,39 - Pratapgarh (Uttar Pradesh),24,39
14.0,GEETA DEVI,Bhartiya Lokmat Rashtrwadi Party,1582,12,1594,0.17,39 - Pratapgarh (Uttar Pradesh),24,39
15.0,RAMSIDDH YADAV URF R.S.YADAV,Manavtawadi Samaj Party,1326,1,1327,0.14,39 - Pratapgarh (Uttar Pradesh),24,39
16.0,SUNIL KUMAR MISHRA,Independent,1134,2,1136,0.12,39 - Pratapgarh (Uttar Pradesh),24,39
17.0,SHANKAR SUMAN TIVARI,Independent,1128,1,1129,0.12,39 - Pratapgarh (Uttar Pradesh),24,39
18.0,DURGESH KUMAR,Rastriya Atal Janta Party,1113,3,1116,0.12,39 - Pratapgarh (Uttar Pradesh),24,39
19.0,RAM KUMAR YADAV,Socialist Unity Centre Of India (COMMUNIST),1070,1,1071,0.11,39 - Pratapgarh (Uttar Pradesh),24,39
20.0,SHIV PAL PATEL,Independent,1025,5,1030,0.11,39 - Pratapgarh (Uttar Pradesh),24,39
21.0,DHARMENDRA TIWARI,Log Party,992,1,993,0.1,39 - Pratapgarh (Uttar Pradesh),24,39
22.0,JOKHU PATEL,Sardar Patel Siddhant Party,969,2,971,0.1,39 - Pratapgarh (Uttar Pradesh),24,39
23.0,SHRAWAN KUMAR TRIPATHI,Independent,849,2,851,0.09,39 - Pratapgarh (Uttar Pradesh),24,39
24.0,DHYAN SINGH,Independent,675,3,678,0.07,39 - Pratapgarh (Uttar Pradesh),24,39
25.0,PRAMOD KUMAR,Independent,672,2,674,0.07,39 - Pratapgarh (Uttar Pradesh),24,39
26.0,MOHRAM ALI,Independent,501,2,503,0.05,39 - Pratapgarh (Uttar Pradesh),24,39
27.0,NOTA,None of the Above,2869,22,2891,0.31,39 - Pratapgarh (Uttar Pradesh),24,39
,Total,,943304,3984,947288,,39 - Pratapgarh (Uttar Pradesh),24,39
1.0,MUKESH RAJPUT,Bharatiya Janata Party,486925,1038,487963,47.2,40 - Farrukhabad (Uttar Pradesh),24,40
2.0,DR. NAVAL KISHOR SHAKYA,Samajwadi Party,484485,800,485285,46.94,40 - Farrukhabad (Uttar Pradesh),24,40
3.0,KRANTI PANDEY,Bahujan Samaj Party,45274,116,45390,4.39,40 - Farrukhabad (Uttar Pradesh),24,40
4.0,AMAR SINGH,Bharatiya Rashtriya Morcha,3345,13,3358,0.32,40 - Farrukhabad (Uttar Pradesh),24,40
5.0,HARNANDAN SINGH,Independent,2457,12,2469,0.24,40 - Farrukhabad (Uttar Pradesh),24,40
6.0,SHYAMVEER SINGH,Bharatiya Nagrik Party,2431,3,2434,0.24,40 - Farrukhabad (Uttar Pradesh),24,40
7.0,VIDYAPRAKASH,Bharatheeya Jawan Kisan Party,1456,11,1467,0.14,40 - Farrukhabad (Uttar Pradesh),24,40
8.0,DINESH,Bhartiya Shakti Chetna Party,1061,2,1063,0.1,40 - Farrukhabad (Uttar Pradesh),24,40
9.0,NOTA,None of the Above,4350,15,4365,0.42,40 - Farrukhabad (Uttar Pradesh),24,40
,Total,,1031784,2010,1033794,,40 - Farrukhabad (Uttar Pradesh),24,40
1.0,JITENDRA KUMAR DOHARE,Samajwadi Party,489358,1389,490747,47.47,41 - Etawah (Uttar Pradesh),24,41
2.0,DR RAM SHANKAR KATHERIA,Bharatiya Janata Party,430922,1406,432328,41.82,41 - Etawah (Uttar Pradesh),24,41
3.0,SARIKA SINGH BAGHEL,Bahujan Samaj Party,96253,288,96541,9.34,41 - Etawah (Uttar Pradesh),24,41
4.0,SUNIL SHANKWAR ADVOCATE,Independent,2954,9,2963,0.29,41 - Etawah (Uttar Pradesh),24,41
5.0,MULAYAM SINGH,Independent,1688,20,1708,0.17,41 - Etawah (Uttar Pradesh),24,41
6.0,BHUVNESH KUMARI,Samyak Party,1648,9,1657,0.16,41 - Etawah (Uttar Pradesh),24,41
7.0,VIVEK RAJ,Janta Samajwadi Party (Vivek Raj),1569,5,1574,0.15,41 - Etawah (Uttar Pradesh),24,41
8.0,NOTA,None of the Above,6229,37,6266,0.61,41 - Etawah (Uttar Pradesh),24,41
,Total,,1030621,3163,1033784,,41 - Etawah (Uttar Pradesh),24,41
1.0,AKHILESH YADAV,Samajwadi Party,640207,2085,642292,52.74,42 - Kannauj (Uttar Pradesh),24,42
2.0,SUBRAT PATHAK,Bharatiya Janata Party,470131,1239,471370,38.71,42 - Kannauj (Uttar Pradesh),24,42
3.0,IMRAN BIN ZAFAR,Bahujan Samaj Party,81471,168,81639,6.7,42 - Kannauj (Uttar Pradesh),24,42
4.0,ALOK VERMA,Rashtriya Shoshit Samaj Party,4484,8,4492,0.37,42 - Kannauj (Uttar Pradesh),24,42
5.0,LALIT KUMARI,Independent,3262,5,3267,0.27,42 - Kannauj (Uttar Pradesh),24,42
6.0,SINOD KUMAR,Independent,1732,1,1733,0.14,42 - Kannauj (Uttar Pradesh),24,42
7.0,RAJ KATHERIA,Independent,1463,1,1464,0.12,42 - Kannauj (Uttar Pradesh),24,42
8.0,BHANU PRATAP SINGH DOHRE,Independent,1430,2,1432,0.12,42 - Kannauj (Uttar Pradesh),24,42
9.0,SHAILENDRA KUMAR,Bharatiya Kisan Parivartan Party,1141,10,1151,0.09,42 - Kannauj (Uttar Pradesh),24,42
10.0,YADVENDRA KISHOR,Independent,1061,1,1062,0.09,42 - Kannauj (Uttar Pradesh),24,42
11.0,SUBHASH CHANDRA,All India Forward Bloc,799,2,801,0.07,42 - Kannauj (Uttar Pradesh),24,42
12.0,SUNIL,Bhartiya Shakti Chetna Party,738,1,739,0.06,42 - Kannauj (Uttar Pradesh),24,42
13.0,PRAMOD KUMAR YADAV,Bhartiya Krishak Dal,557,3,560,0.05,42 - Kannauj (Uttar Pradesh),24,42
14.0,PURUSHOTTAM TIWARI,Independent,541,2,543,0.04,42 - Kannauj (Uttar Pradesh),24,42
15.0,IRFAN ALI,Independent,463,7,470,0.04,42 - Kannauj (Uttar Pradesh),24,42
16.0,NOTA,None of the Above,4805,13,4818,0.4,42 - Kannauj (Uttar Pradesh),24,42
,Total,,1214285,3548,1217833,,42 - Kannauj (Uttar Pradesh),24,42
1.0,RAMESH AWASTHI,Bharatiya Janata Party,440609,2446,443055,49.93,43 - Kanpur (Uttar Pradesh),24,43
2.0,ALOK MISRA,Indian National Congress,419469,2618,422087,47.56,43 - Kanpur (Uttar Pradesh),24,43
3.0,KULDEEP BHADAURIYA,Bahujan Samaj Party,11843,189,12032,1.36,43 - Kanpur (Uttar Pradesh),24,43
4.0,ASHOK PASWAN ADVOCATE,Sabhi Jan Party,1969,5,1974,0.22,43 - Kanpur (Uttar Pradesh),24,43
5.0,ALOK MISHRA,Independent,1186,12,1198,0.14,43 - Kanpur (Uttar Pradesh),24,43
6.0,MANOJ KUMAR,Independent,776,2,778,0.09,43 - Kanpur (Uttar Pradesh),24,43
7.0,AJAY KUMAR MISHRA,Independent,671,1,672,0.08,43 - Kanpur (Uttar Pradesh),24,43
8.0,PRASHAST DHEER,All India Forward Bloc,462,3,465,0.05,43 - Kanpur (Uttar Pradesh),24,43
9.0,ARVIND KUMAR SRIVASTAVA,Independent,394,4,398,0.04,43 - Kanpur (Uttar Pradesh),24,43
10.0,SANJAY SINGH,"Proutist Bloc, India",348,2,350,0.04,43 - Kanpur (Uttar Pradesh),24,43
11.0,VALENDRA KATIYAR,Socialist Unity Centre Of India (COMMUNIST),267,3,270,0.03,43 - Kanpur (Uttar Pradesh),24,43
12.0,NOTA,None of the Above,4048,69,4117,0.46,43 - Kanpur (Uttar Pradesh),24,43
,Total,,882042,5354,887396,,43 - Kanpur (Uttar Pradesh),24,43
1.0,DEVENDRA SINGH ALIAS BHOLE SINGH,Bharatiya Janata Party,514256,3167,517423,47.6,44 - Akbarpur (Uttar Pradesh),24,44
2.0,RAJARAM PAL,Samajwadi Party,469766,3312,473078,43.52,44 - Akbarpur (Uttar Pradesh),24,44
3.0,RAJESH KUMAR DWIVEDI,Bahujan Samaj Party,72679,461,73140,6.73,44 - Akbarpur (Uttar Pradesh),24,44
4.0,RAJARAM,Independent,4629,13,4642,0.43,44 - Akbarpur (Uttar Pradesh),24,44
5.0,ASHOK PASWAN ADVOCATE,Sabhi Jan Party,3160,13,3173,0.29,44 - Akbarpur (Uttar Pradesh),24,44
6.0,CHANDRESH SINGH,Bhartiya Shakti Chetna Party,2641,13,2654,0.24,44 - Akbarpur (Uttar Pradesh),24,44
7.0,YOGESH JAISWAL,Independent,2529,14,2543,0.23,44 - Akbarpur (Uttar Pradesh),24,44
8.0,VIPIN KUMAR,Rashtriya Sanskriti Party,1489,5,1494,0.14,44 - Akbarpur (Uttar Pradesh),24,44
9.0,RAMGOPAL,Rashtriya Janutthan Party,1146,11,1157,0.11,44 - Akbarpur (Uttar Pradesh),24,44
10.0,NOTA,None of the Above,7523,126,7649,0.7,44 - Akbarpur (Uttar Pradesh),24,44
,Total,,1079818,7135,1086953,,44 - Akbarpur (Uttar Pradesh),24,44
1.0,NARAYAN DAS AHIRWAR,Samajwadi Party,529444,736,530180,46.96,45 - Jalaun (Uttar Pradesh),24,45
2.0,BHANU PRATAP SINGH VERMA,Bharatiya Janata Party,475232,1050,476282,42.19,45 - Jalaun (Uttar Pradesh),24,45
3.0,SURESH CHANDRA GAUTAM,Bahujan Samaj Party,100105,143,100248,8.88,45 - Jalaun (Uttar Pradesh),24,45
4.0,BRIJ MOHAN,Independent,4666,7,4673,0.41,45 - Jalaun (Uttar Pradesh),24,45
5.0,NAGENDRA KUMAR,Bhartiya Shakti Chetna Party,3205,7,3212,0.28,45 - Jalaun (Uttar Pradesh),24,45
6.0,PREMLATA VERMA,Independent,3176,24,3200,0.28,45 - Jalaun (Uttar Pradesh),24,45
7.0,NOTA,None of the Above,11138,16,11154,0.99,45 - Jalaun (Uttar Pradesh),24,45
,Total,,1126966,1983,1128949,,45 - Jalaun (Uttar Pradesh),24,45
1.0,ANURAG SHARMA,Bharatiya Janata Party,689438,878,690316,50.0,46 - Jhansi (Uttar Pradesh),24,46
2.0,"PRADEEP JAIN ""ADITYA""",Indian National Congress,587000,702,587702,42.57,46 - Jhansi (Uttar Pradesh),24,46
3.0,RAVI PRAKASH,Bahujan Samaj Party,63106,86,63192,4.58,46 - Jhansi (Uttar Pradesh),24,46
4.0,LAKHAN LAL,Independent,6832,-,6832,0.49,46 - Jhansi (Uttar Pradesh),24,46
5.0,RAMESH,Independent,6330,8,6338,0.46,46 - Jhansi (Uttar Pradesh),24,46
6.0,GANESH RAM,Independent,2574,1,2575,0.19,46 - Jhansi (Uttar Pradesh),24,46
7.0,CHANDAN SINGH,Apna Dal (Kamerawadi),2487,4,2491,0.18,46 - Jhansi (Uttar Pradesh),24,46
8.0,DHARMENDRA PRATAP,Independent,2299,4,2303,0.17,46 - Jhansi (Uttar Pradesh),24,46
9.0,INDRA SINGH,Independent,2076,2,2078,0.15,46 - Jhansi (Uttar Pradesh),24,46
10.0,ER. DEEPAK KUMAR VERMA,Al-Hind Party,1375,2,1377,0.1,46 - Jhansi (Uttar Pradesh),24,46
11.0,NOTA,None of the Above,15290,12,15302,1.11,46 - Jhansi (Uttar Pradesh),24,46
,Total,,1378807,1699,1380506,,46 - Jhansi (Uttar Pradesh),24,46
1.0,AJENDRA SINGH LODHI,Samajwadi Party,490003,680,490683,44.0,47 - Hamirpur (Uttar Pradesh),24,47
2.0,KUNWAR PUSHPENDRA SINGH CHANDEL,Bharatiya Janata Party,487373,681,488054,43.76,47 - Hamirpur (Uttar Pradesh),24,47
3.0,NIRDOSH KUMAR DIXIT,Bahujan Samaj Party,94564,132,94696,8.49,47 - Hamirpur (Uttar Pradesh),24,47
4.0,ANUPAM KUMAR TRIPATHI,Bhartiya Shakti Chetna Party,6401,6,6407,0.57,47 - Hamirpur (Uttar Pradesh),24,47
5.0,BRIJESH KUMAR PAL,Rashtra Uday Party,4516,11,4527,0.41,47 - Hamirpur (Uttar Pradesh),24,47
6.0,BHUVANENDRA NARAYAN SINGH,Independent,4315,5,4320,0.39,47 - Hamirpur (Uttar Pradesh),24,47
7.0,SANTOSH KUMAR,Independent,3776,1,3777,0.34,47 - Hamirpur (Uttar Pradesh),24,47
8.0,RAJESH SINGH,Independent,3605,2,3607,0.32,47 - Hamirpur (Uttar Pradesh),24,47
9.0,SURESH KUMAR,Eklavya Samaj Party,2181,-,2181,0.2,47 - Hamirpur (Uttar Pradesh),24,47
10.0,SANJIV KUMAR,Spashtwadi Jan Aadhar Party,2003,-,2003,0.18,47 - Hamirpur (Uttar Pradesh),24,47
11.0,DHARMRAJ,Al-Hind Party,1589,2,1591,0.14,47 - Hamirpur (Uttar Pradesh),24,47
12.0,NOTA,None of the Above,13442,11,13453,1.21,47 - Hamirpur (Uttar Pradesh),24,47
,Total,,1113768,1531,1115299,,47 - Hamirpur (Uttar Pradesh),24,47
1.0,KRISHNA DEVI SHIVSHANKER PATEL,Samajwadi Party,406018,549,406567,38.94,48 - Banda (Uttar Pradesh),24,48
2.0,R. K. SINGH PATEL,Bharatiya Janata Party,334950,407,335357,32.12,48 - Banda (Uttar Pradesh),24,48
3.0,MAYANK DWIVEDI,Bahujan Samaj Party,245530,215,245745,23.54,48 - Banda (Uttar Pradesh),24,48
4.0,RAMCHANDRA SARAS,Communist Party of India,9436,2,9438,0.9,48 - Banda (Uttar Pradesh),24,48
5.0,PANCHA URF PANCHAMLAL,Bhagidari Party(P),7714,3,7717,0.74,48 - Banda (Uttar Pradesh),24,48
6.0,GULAB CHANDER BARMA,Rashtra Uday Party,5905,2,5907,0.57,48 - Banda (Uttar Pradesh),24,48
7.0,RAMCHRAN,Independent,5419,4,5423,0.52,48 - Banda (Uttar Pradesh),24,48
8.0,SURENDRA KUMAR,Swatantra Jantaraj Party,4380,2,4382,0.42,48 - Banda (Uttar Pradesh),24,48
9.0,SHRIRAM SINGH GAUR,Bhartiya Shakti Chetna Party,3347,3,3350,0.32,48 - Banda (Uttar Pradesh),24,48
10.0,DINESH KUMAR PATEL,Sardar Patel Siddhant Party,2507,1,2508,0.24,48 - Banda (Uttar Pradesh),24,48
11.0,BABULAL,Log Party,2358,3,2361,0.23,48 - Banda (Uttar Pradesh),24,48
12.0,PRAMOD AZAD,Apna Dal (Kamerawadi),2141,1,2142,0.21,48 - Banda (Uttar Pradesh),24,48
13.0,NOTA,None of the Above,13226,9,13235,1.27,48 - Banda (Uttar Pradesh),24,48
,Total,,1042931,1201,1044132,,48 - Banda (Uttar Pradesh),24,48
1.0,NARESH CHANDRA UTTAM PATEL,Samajwadi Party,499866,462,500328,45.2,49 - Fatehpur (Uttar Pradesh),24,49
2.0,NIRANJAN JYOTI,Bharatiya Janata Party,466249,880,467129,42.2,49 - Fatehpur (Uttar Pradesh),24,49
3.0,MANISH SINGH SACHAN,Bahujan Samaj Party,90897,73,90970,8.22,49 - Fatehpur (Uttar Pradesh),24,49
4.0,BIRENDRA SINGH,Independent,7917,3,7920,0.72,49 - Fatehpur (Uttar Pradesh),24,49
5.0,KAMLESH KUMAR SINGH,Parivartan Samaj Party,5212,7,5219,0.47,49 - Fatehpur (Uttar Pradesh),24,49
6.0,PANKAJ AWASTHI,Independent,4456,1,4457,0.4,49 - Fatehpur (Uttar Pradesh),24,49
7.0,RAMKISHOR,Rashtra Uday Party,4075,4,4079,0.37,49 - Fatehpur (Uttar Pradesh),24,49
8.0,JITENDRA KUMAR MAURYA,Independent,3333,3,3336,0.3,49 - Fatehpur (Uttar Pradesh),24,49
9.0,KULDEEP KUSHWAHA,Independent,2724,2,2726,0.25,49 - Fatehpur (Uttar Pradesh),24,49
10.0,RAJ BAHADUR,Peoples Party of India (Democratic),2653,1,2654,0.24,49 - Fatehpur (Uttar Pradesh),24,49
11.0,NIRAJ KUMAR,Akhil Bhartiya Parivar Party,2561,6,2567,0.23,49 - Fatehpur (Uttar Pradesh),24,49
12.0,RAM BIHARI,Bhartiya Shakti Chetna Party,2342,2,2344,0.21,49 - Fatehpur (Uttar Pradesh),24,49
13.0,NEERAJ LODHI,Vikas Insaf Party,2028,5,2033,0.18,49 - Fatehpur (Uttar Pradesh),24,49
14.0,JAY CHANDRA KUMAR,Vishwa Kalyan Rashtriya Manav Samaj Party,1602,2,1604,0.14,49 - Fatehpur (Uttar Pradesh),24,49
15.0,RAJESH KUMAR PATEL,Sardar Patel Siddhant Party,1449,9,1458,0.13,49 - Fatehpur (Uttar Pradesh),24,49
16.0,NOTA,None of the Above,8108,12,8120,0.73,49 - Fatehpur (Uttar Pradesh),24,49
,Total,,1105472,1472,1106944,,49 - Fatehpur (Uttar Pradesh),24,49
1.0,PUSHPENDRA SAROJ,Samajwadi Party,509175,612,509787,50.51,50 - Kaushambi (Uttar Pradesh),24,50
2.0,VINOD KUMAR SONKAR,Bharatiya Janata Party,405142,701,405843,40.21,50 - Kaushambi (Uttar Pradesh),24,50
3.0,SHUBH NARAYAN,Bahujan Samaj Party,55797,61,55858,5.53,50 - Kaushambi (Uttar Pradesh),24,50
4.0,PUSHPENDRA KUMAR SAROJ,Independent,5178,6,5184,0.51,50 - Kaushambi (Uttar Pradesh),24,50
5.0,NARENDRA KUMAR,Apna Dal (Kamerawadi),5127,4,5131,0.51,50 - Kaushambi (Uttar Pradesh),24,50
6.0,SANJAY KUMAR,Independent,4631,3,4634,0.46,50 - Kaushambi (Uttar Pradesh),24,50
7.0,RAJENDRA SONKAR URF PANNA BHAIYA,Independent,3421,-,3421,0.34,50 - Kaushambi (Uttar Pradesh),24,50
8.0,PRADEEP KUMAR,Independent,2539,2,2541,0.25,50 - Kaushambi (Uttar Pradesh),24,50
9.0,RAMESHWAR PRASAD,Bhartiya Shakti Chetna Party,2011,2,2013,0.2,50 - Kaushambi (Uttar Pradesh),24,50
10.0,RAM ASREY,Manavtawadi Samaj Party,1948,2,1950,0.19,50 - Kaushambi (Uttar Pradesh),24,50
11.0,NOTA,None of the Above,12958,9,12967,1.28,50 - Kaushambi (Uttar Pradesh),24,50
,Total,,1007927,1402,1009329,,50 - Kaushambi (Uttar Pradesh),24,50
1.0,PRAVEEN PATEL,Bharatiya Janata Party,451380,1220,452600,44.6,51 - Phulpur (Uttar Pradesh),24,51
2.0,AMAR NATH SINGH MAURYA,Samajwadi Party,446596,1672,448268,44.17,51 - Phulpur (Uttar Pradesh),24,51
3.0,JAGANNATH PAL,Bahujan Samaj Party,82375,211,82586,8.14,51 - Phulpur (Uttar Pradesh),24,51
4.0,MAHIMA PATEL,Apna Dal (Kamerawadi),4134,28,4162,0.41,51 - Phulpur (Uttar Pradesh),24,51
5.0,JILA JEET BHARTIY,Bahujan Awam Party,3294,5,3299,0.33,51 - Phulpur (Uttar Pradesh),24,51
6.0,SUNIL KUMAR PRAJAPATI,Bhagidari Party(P),3040,7,3047,0.3,51 - Phulpur (Uttar Pradesh),24,51
7.0,ENGG YOGESH KUSHWAHA,Pragatisheel Samaj Party,2768,3,2771,0.27,51 - Phulpur (Uttar Pradesh),24,51
8.0,AKHILESH TRIPATHI,Independent,2295,3,2298,0.23,51 - Phulpur (Uttar Pradesh),24,51
9.0,NAFIS AHAMAD,Independent,2145,2,2147,0.21,51 - Phulpur (Uttar Pradesh),24,51
10.0,DR NEERAJ,Independent,1702,8,1710,0.17,51 - Phulpur (Uttar Pradesh),24,51
11.0,SANJEEV KUMAR MISHRA,Yuva Vikas Party,1675,4,1679,0.17,51 - Phulpur (Uttar Pradesh),24,51
12.0,MUSHIR AHMAD SIDDIQUI,Peoples Party of India (Democratic),1505,1,1506,0.15,51 - Phulpur (Uttar Pradesh),24,51
13.0,SANGEETA YADAV,Subhashwadi Bhartiya Samajwadi Party (Subhas Party),1283,8,1291,0.13,51 - Phulpur (Uttar Pradesh),24,51
14.0,LALA RAM SAROJ,Prabuddhwadi Bahujan Morcha,1043,9,1052,0.1,51 - Phulpur (Uttar Pradesh),24,51
15.0,PRAMOD BHAI PATEL URF P K,Sardar Patel Siddhant Party,947,1,948,0.09,51 - Phulpur (Uttar Pradesh),24,51
16.0,NOTA,None of the Above,5445,15,5460,0.54,51 - Phulpur (Uttar Pradesh),24,51
,Total,,1011627,3197,1014824,,51 - Phulpur (Uttar Pradesh),24,51
1.0,UJJWAL RAMAN SINGH,Indian National Congress,461100,1045,462145,48.8,52 - Allahabad (Uttar Pradesh),24,52
2.0,NEERAJ TRIPATHI,Bharatiya Janata Party,402659,691,403350,42.59,52 - Allahabad (Uttar Pradesh),24,52
3.0,RAMESH KUMAR PATEL,Bahujan Samaj Party,49045,99,49144,5.19,52 - Allahabad (Uttar Pradesh),24,52
4.0,GOPAL SWROOP JOSHI,Independent,4248,-,4248,0.45,52 - Allahabad (Uttar Pradesh),24,52
5.0,AJEET KUMAR PATEL,Pragatisheel Samaj Party,2641,1,2642,0.28,52 - Allahabad (Uttar Pradesh),24,52
6.0,MOOLNIWASI HEMRAJ SINGH,Peoples Party of India (Democratic),2350,5,2355,0.25,52 - Allahabad (Uttar Pradesh),24,52
7.0,GEETA RANI SHARMA,Independent,2197,-,2197,0.23,52 - Allahabad (Uttar Pradesh),24,52
8.0,HANSHRAJ KOL,Apna Dal (Kamerawadi),2137,4,2141,0.23,52 - Allahabad (Uttar Pradesh),24,52
9.0,RAJENDRA PRASAD PRAJAPATI,Bhagidari Party(P),1844,3,1847,0.2,52 - Allahabad (Uttar Pradesh),24,52
10.0,AVANEESH KUMAR,Independent,1834,1,1835,0.19,52 - Allahabad (Uttar Pradesh),24,52
11.0,ANUJ SWAROOP SHUKLA,Independent,1615,1,1616,0.17,52 - Allahabad (Uttar Pradesh),24,52
12.0,SHIV PRASAD VISHWAKARMA,Samyak Party,1326,-,1326,0.14,52 - Allahabad (Uttar Pradesh),24,52
13.0,SARVAJEET SINGH,Kamera Samaj Party,1177,-,1177,0.12,52 - Allahabad (Uttar Pradesh),24,52
14.0,RAJDHAR SINGH PATEL,Rashtriya Samaj Dal (R),1024,1,1025,0.11,52 - Allahabad (Uttar Pradesh),24,52
15.0,NOTA,None of the Above,9949,3,9952,1.05,52 - Allahabad (Uttar Pradesh),24,52
,Total,,945146,1854,947000,,52 - Allahabad (Uttar Pradesh),24,52
1.0,TANUJ PUNIA,Indian National Congress,718528,1399,719927,55.78,53 - Barabanki (Uttar Pradesh),24,53
2.0,RAJRANI RAWAT,Bharatiya Janata Party,503452,771,504223,39.07,53 - Barabanki (Uttar Pradesh),24,53
3.0,SHIV KUMAR DOHAREY,Bahujan Samaj Party,39105,72,39177,3.04,53 - Barabanki (Uttar Pradesh),24,53
4.0,BABOORAM,Independent,3669,-,3669,0.28,53 - Barabanki (Uttar Pradesh),24,53
5.0,RAMLAKHAN PASI,Independent,2927,1,2928,0.23,53 - Barabanki (Uttar Pradesh),24,53
6.0,MITHALESH KUMARI,Independent,2320,1,2321,0.18,53 - Barabanki (Uttar Pradesh),24,53
7.0,DEVATADEEN GAUTAM,Independent,2172,1,2173,0.17,53 - Barabanki (Uttar Pradesh),24,53
8.0,ASHA DEVI,Swatantrata Abhivyakti Party,2018,2,2020,0.16,53 - Barabanki (Uttar Pradesh),24,53
9.0,PROF. (DR.) RAM GHULAM RAZDAN,Public Adhikar Socialist Indian Party,1493,-,1493,0.12,53 - Barabanki (Uttar Pradesh),24,53
10.0,MAHENDRA KUMAR RAWAT,Awami Samta Party,1189,1,1190,0.09,53 - Barabanki (Uttar Pradesh),24,53
11.0,OMKAR,Independent,1137,1,1138,0.09,53 - Barabanki (Uttar Pradesh),24,53
12.0,ADVOCATE SANTOSH RAWAT,Dr. Bhimrao Ambedkar Dal,1076,2,1078,0.08,53 - Barabanki (Uttar Pradesh),24,53
13.0,PREMCHANDRA HARIJAN,Sardar Patel Siddhant Party,1075,1,1076,0.08,53 - Barabanki (Uttar Pradesh),24,53
14.0,NOTA,None of the Above,8220,1,8221,0.64,53 - Barabanki (Uttar Pradesh),24,53
,Total,,1288381,2253,1290634,,53 - Barabanki (Uttar Pradesh),24,53
1.0,AWADHESH PRASAD,Samajwadi Party,553549,740,554289,48.59,54 - Faizabad (Uttar Pradesh),24,54
2.0,LALLU SINGH,Bharatiya Janata Party,499002,720,499722,43.81,54 - Faizabad (Uttar Pradesh),24,54
3.0,SACHIDANAND PANDEY,Bahujan Samaj Party,46347,60,46407,4.07,54 - Faizabad (Uttar Pradesh),24,54
4.0,ARVIND SEN,Communist Party of India,15353,14,15367,1.35,54 - Faizabad (Uttar Pradesh),24,54
5.0,SUNIL KUMAR BHATT,Independent,3826,1,3827,0.34,54 - Faizabad (Uttar Pradesh),24,54
6.0,KANCHAN YADAV,Moulik Adhikar Party,2662,4,2666,0.23,54 - Faizabad (Uttar Pradesh),24,54
7.0,AMBRISH DEV GUPTA,Bharat Mahaparivar Party,2216,2,2218,0.19,54 - Faizabad (Uttar Pradesh),24,54
8.0,FAREED SALMANI,Independent,1779,1,1780,0.16,54 - Faizabad (Uttar Pradesh),24,54
9.0,LAL MANI URF L.M. TRIPATHI (BHAI SAHAB),Independent,1717,-,1717,0.15,54 - Faizabad (Uttar Pradesh),24,54
10.0,ANIL KUMAR RAVAT,Rashtriya Janshakti Samaj Party,1636,2,1638,0.14,54 - Faizabad (Uttar Pradesh),24,54
11.0,JAGAT SINGH,Independent,1252,2,1254,0.11,54 - Faizabad (Uttar Pradesh),24,54
12.0,BRAJENDRA DUTT TRIPATHI URF B. D. TRIPATHI,Adarshwaadi Congress Party,1163,10,1173,0.1,54 - Faizabad (Uttar Pradesh),24,54
13.0,ARUN KUMAR,Independent,1063,4,1067,0.09,54 - Faizabad (Uttar Pradesh),24,54
14.0,NOTA,None of the Above,7529,7,7536,0.66,54 - Faizabad (Uttar Pradesh),24,54
,Total,,1139094,1567,1140661,,54 - Faizabad (Uttar Pradesh),24,54
1.0,LALJI VERMA,Samajwadi Party,543721,1238,544959,46.3,55 - Ambedkar Nagar (Uttar Pradesh),24,55
2.0,RITESH PANDEY,Bharatiya Janata Party,406851,861,407712,34.64,55 - Ambedkar Nagar (Uttar Pradesh),24,55
3.0,QAMAR HAYAT,Bahujan Samaj Party,199252,247,199499,16.95,55 - Ambedkar Nagar (Uttar Pradesh),24,55
4.0,NEELAM SINGH,Moolniwasi Samaj Party,4321,10,4331,0.37,55 - Ambedkar Nagar (Uttar Pradesh),24,55
5.0,SHABANA KHATOON,Peace Party,3983,7,3990,0.34,55 - Ambedkar Nagar (Uttar Pradesh),24,55
6.0,JAVED AHMAD SIDDIQUI,Independent,3857,3,3860,0.33,55 - Ambedkar Nagar (Uttar Pradesh),24,55
7.0,RAM NARESH PRAJAPATI,Bhagidari Party(P),3410,3,3413,0.29,55 - Ambedkar Nagar (Uttar Pradesh),24,55
8.0,VIVEK KUMAR,Bhartiya Shakti Chetna Party,1848,2,1850,0.16,55 - Ambedkar Nagar (Uttar Pradesh),24,55
9.0,NOTA,None of the Above,7429,19,7448,0.63,55 - Ambedkar Nagar (Uttar Pradesh),24,55
,Total,,1174672,2390,1177062,,55 - Ambedkar Nagar (Uttar Pradesh),24,55
1.0,ANAND KUMAR,Bharatiya Janata Party,518575,227,518802,49.1,56 - Baharaich (Uttar Pradesh),24,56
2.0,RAMESH CHANDRA,Samajwadi Party,454454,121,454575,43.02,56 - Baharaich (Uttar Pradesh),24,56
3.0,DR. BRIJESH KUMAR,Bahujan Samaj Party,50422,26,50448,4.77,56 - Baharaich (Uttar Pradesh),24,56
4.0,ARVIND KUMAR,Bhartiya Awam Party (Rastriya),6158,2,6160,0.58,56 - Baharaich (Uttar Pradesh),24,56
5.0,RAMESH BALMIKI,Independent,3223,4,3227,0.31,56 - Baharaich (Uttar Pradesh),24,56
6.0,BECHULAL,Independent,2919,1,2920,0.28,56 - Baharaich (Uttar Pradesh),24,56
7.0,JANARDAN GOND,Independent,2672,1,2673,0.25,56 - Baharaich (Uttar Pradesh),24,56
8.0,RAM MILAN,Sardar Patel Siddhant Party,1699,-,1699,0.16,56 - Baharaich (Uttar Pradesh),24,56
9.0,RINKU SAHANI,Rashtra Dharak Dal,1681,2,1683,0.16,56 - Baharaich (Uttar Pradesh),24,56
10.0,JAGRAM,Independent,1514,1,1515,0.14,56 - Baharaich (Uttar Pradesh),24,56
11.0,NOTA,None of the Above,12862,2,12864,1.22,56 - Baharaich (Uttar Pradesh),24,56
,Total,,1056179,387,1056566,,56 - Baharaich (Uttar Pradesh),24,56
1.0,KARAN BHUSHAN SINGH,Bharatiya Janata Party,570436,827,571263,53.79,57 - Kaiserganj (Uttar Pradesh),24,57
2.0,BHAGAT RAM,Samajwadi Party,422012,408,422420,39.77,57 - Kaiserganj (Uttar Pradesh),24,57
3.0,NARENDRA PANDEY,Bahujan Samaj Party,44217,62,44279,4.17,57 - Kaiserganj (Uttar Pradesh),24,57
4.0,ARUNIMA PANDEY,Independent,9230,20,9250,0.87,57 - Kaiserganj (Uttar Pradesh),24,57
5.0,NOTA,None of the Above,14872,15,14887,1.4,57 - Kaiserganj (Uttar Pradesh),24,57
,Total,,1060767,1332,1062099,,57 - Kaiserganj (Uttar Pradesh),24,57
1.0,RAM SHIROMANI VERMA,Samajwadi Party,510754,301,511055,48.83,58 - Shrawasti (Uttar Pradesh),24,58
2.0,SAKET MISRA,Bharatiya Janata Party,434192,190,434382,41.51,58 - Shrawasti (Uttar Pradesh),24,58
3.0,MUINUDDIN AHAMAD KHAN URF HAZI DADDAN KHAN,Bahujan Samaj Party,56225,26,56251,5.38,58 - Shrawasti (Uttar Pradesh),24,58
4.0,AHMAD JIYA KHAN,Peace Party,15630,-,15630,1.49,58 - Shrawasti (Uttar Pradesh),24,58
5.0,SHANTI DEVI,Independent,4010,1,4011,0.38,58 - Shrawasti (Uttar Pradesh),24,58
6.0,SUJEET KUMAR,Independent,3946,-,3946,0.38,58 - Shrawasti (Uttar Pradesh),24,58
7.0,YUGAL KISHOR SHUKLA,Aam Janta Party (India),2672,1,2673,0.26,58 - Shrawasti (Uttar Pradesh),24,58
8.0,KRISHNA KUMAR MAURYA,Samyak Party,2266,1,2267,0.22,58 - Shrawasti (Uttar Pradesh),24,58
9.0,MALIK RAM,Independent,2111,2,2113,0.2,58 - Shrawasti (Uttar Pradesh),24,58
10.0,ANIL KUMAR TIWARI,Independent,1513,1,1514,0.14,58 - Shrawasti (Uttar Pradesh),24,58
11.0,HANUMAN PRASAD MISHRA,Kisan Mazdoor Sangharsh Party,1494,1,1495,0.14,58 - Shrawasti (Uttar Pradesh),24,58
12.0,KUMARI GEETA GAUTAM,Rashtriya Janta Party,1317,2,1319,0.13,58 - Shrawasti (Uttar Pradesh),24,58
13.0,NOTA,None of the Above,9872,-,9872,0.94,58 - Shrawasti (Uttar Pradesh),24,58
,Total,,1046002,526,1046528,,58 - Shrawasti (Uttar Pradesh),24,58
1.0,KIRTIVARDHAN SINGH,Bharatiya Janata Party,473691,567,474258,49.77,59 - Gonda (Uttar Pradesh),24,59
2.0,SHREYA VERMA,Samajwadi Party,427363,671,428034,44.92,59 - Gonda (Uttar Pradesh),24,59
3.0,SAURABH,Bahujan Samaj Party,29388,41,29429,3.09,59 - Gonda (Uttar Pradesh),24,59
4.0,RAM UJAGAR,Independent,3535,-,3535,0.37,59 - Gonda (Uttar Pradesh),24,59
5.0,ARUNIMA PANDEY,Independent,3070,3,3073,0.32,59 - Gonda (Uttar Pradesh),24,59
6.0,RAGHAVENDRA,Bhartiya Shakti Chetna Party,2027,1,2028,0.21,59 - Gonda (Uttar Pradesh),24,59
7.0,RAJKUMAR,Independent,1988,1,1989,0.21,59 - Gonda (Uttar Pradesh),24,59
8.0,VINOD KUMAR SINGH,Bhartiya Uday Nirman Party,1482,1,1483,0.16,59 - Gonda (Uttar Pradesh),24,59
9.0,NOTA,None of the Above,9048,7,9055,0.95,59 - Gonda (Uttar Pradesh),24,59
,Total,,951592,1292,952884,,59 - Gonda (Uttar Pradesh),24,59
1.0,JAGDAMBIKA PAL,Bharatiya Janata Party,462614,689,463303,45.47,60 - Domariyaganj (Uttar Pradesh),24,60
2.0,BHISHMA SHANKAR ALIAS KUSHAL TIWARI,Samajwadi Party,418910,1665,420575,41.27,60 - Domariyaganj (Uttar Pradesh),24,60
3.0,AMAR SINGH CHAUDHARY,Aazad Samaj Party (Kanshi Ram),81182,123,81305,7.98,60 - Domariyaganj (Uttar Pradesh),24,60
4.0,MD. NADEEM,Bahujan Samaj Party,35654,282,35936,3.53,60 - Domariyaganj (Uttar Pradesh),24,60
5.0,NAUSHAD AZAM,Peace Party,5134,4,5138,0.5,60 - Domariyaganj (Uttar Pradesh),24,60
6.0,KIRAN DEVI,Independent,3258,3,3261,0.32,60 - Domariyaganj (Uttar Pradesh),24,60
7.0,NOTA,None of the Above,9431,16,9447,0.93,60 - Domariyaganj (Uttar Pradesh),24,60
,Total,,1016183,2782,1018965,,60 - Domariyaganj (Uttar Pradesh),24,60
1.0,RAM PRASAD CHAUDHARY,Samajwadi Party,523487,3518,527005,48.67,61 - Basti (Uttar Pradesh),24,61
2.0,HARISH CHANDRA ALIAS HARISH DWIVEDI,Bharatiya Janata Party,424604,1407,426011,39.34,61 - Basti (Uttar Pradesh),24,61
3.0,LAVKUSH PATEL,Bahujan Samaj Party,102818,483,103301,9.54,61 - Basti (Uttar Pradesh),24,61
4.0,PANKAJ DUBEY,Log Party,4624,3,4627,0.43,61 - Basti (Uttar Pradesh),24,61
5.0,PREM KUMAR,Moulik Adhikar Party,3607,4,3611,0.33,61 - Basti (Uttar Pradesh),24,61
6.0,HAFIZ ALI,All India Forward Bloc,2985,3,2988,0.28,61 - Basti (Uttar Pradesh),24,61
7.0,RAM KARAN GAUTAM,Independent,2640,5,2645,0.24,61 - Basti (Uttar Pradesh),24,61
8.0,PRAMOD KUMAR,Independent,2554,3,2557,0.24,61 - Basti (Uttar Pradesh),24,61
9.0,SHAILENDRA KUMAR,Bharat Mahaparivar Party,2361,3,2364,0.22,61 - Basti (Uttar Pradesh),24,61
10.0,NOTA,None of the Above,7742,19,7761,0.72,61 - Basti (Uttar Pradesh),24,61
,Total,,1077422,5448,1082870,,61 - Basti (Uttar Pradesh),24,61
1.0,LAXMIKANT PAPPU NISHAD,Samajwadi Party,497488,1207,498695,45.7,62 - Sant Kabir Nagar (Uttar Pradesh),24,62
2.0,PRAVIN KUMAR NISHAD,Bharatiya Janata Party,405611,914,406525,37.25,62 - Sant Kabir Nagar (Uttar Pradesh),24,62
3.0,NADEEM ASHRAF,Bahujan Samaj Party,150549,263,150812,13.82,62 - Sant Kabir Nagar (Uttar Pradesh),24,62
4.0,DHEERAJ SRIVASTAV,Pragatisheel Samaj Party,5135,5,5140,0.47,62 - Sant Kabir Nagar (Uttar Pradesh),24,62
5.0,RAM KRISHNA DWIVEDI,Independent,4509,-,4509,0.41,62 - Sant Kabir Nagar (Uttar Pradesh),24,62
6.0,SATYVANT PRATAP SINGH,Independent,4351,7,4358,0.4,62 - Sant Kabir Nagar (Uttar Pradesh),24,62
7.0,KULDEEP,Sardar Patel Siddhant Party,3591,4,3595,0.33,62 - Sant Kabir Nagar (Uttar Pradesh),24,62
8.0,MITRASEN,Independent,2535,9,2544,0.23,62 - Sant Kabir Nagar (Uttar Pradesh),24,62
9.0,RAJENDRA YADAV URF COLONEL SAHAB,Sarvjan Awaz Party,2229,10,2239,0.21,62 - Sant Kabir Nagar (Uttar Pradesh),24,62
10.0,ANAND KUMAR GAUTAM,Independent,1840,10,1850,0.17,62 - Sant Kabir Nagar (Uttar Pradesh),24,62
11.0,SUBHASH CHANDRA DUBEY,Naki Bharatiya Ekta Party,1702,6,1708,0.16,62 - Sant Kabir Nagar (Uttar Pradesh),24,62
12.0,NOTA,None of the Above,9210,17,9227,0.85,62 - Sant Kabir Nagar (Uttar Pradesh),24,62
,Total,,1088750,2452,1091202,,62 - Sant Kabir Nagar (Uttar Pradesh),24,62
1.0,PANKAJ CHAUDHARY,Bharatiya Janata Party,590487,823,591310,48.85,63 - Maharajganj (Uttar Pradesh),24,63
2.0,VIRENDRA CHAUDHARY,Indian National Congress,555045,814,555859,45.92,63 - Maharajganj (Uttar Pradesh),24,63
3.0,MO MAUSME ALAM,Bahujan Samaj Party,32893,62,32955,2.72,63 - Maharajganj (Uttar Pradesh),24,63
4.0,BRIJESH,Abhay Samaj Party,8575,8,8583,0.71,63 - Maharajganj (Uttar Pradesh),24,63
5.0,CHHEDI MAJDOOR,Independent,3833,1,3834,0.32,63 - Maharajganj (Uttar Pradesh),24,63
6.0,RAMPRIT,Independent,3028,1,3029,0.25,63 - Maharajganj (Uttar Pradesh),24,63
7.0,SUNIL,Independent,2716,2,2718,0.22,63 - Maharajganj (Uttar Pradesh),24,63
8.0,VINOD KUMAR PATEL,Sardar Patel Siddhant Party,2415,3,2418,0.2,63 - Maharajganj (Uttar Pradesh),24,63
9.0,NOTA,None of the Above,9730,15,9745,0.81,63 - Maharajganj (Uttar Pradesh),24,63
,Total,,1208722,1729,1210451,,63 - Maharajganj (Uttar Pradesh),24,63
1.0,RAVINDRA SHUKLA ALIAS RAVI KISHAN,Bharatiya Janata Party,584512,1322,585834,50.75,64 - Gorakhpur (Uttar Pradesh),24,64
2.0,KAJAL NISHAD,Samajwadi Party,480788,1520,482308,41.78,64 - Gorakhpur (Uttar Pradesh),24,64
3.0,JAVED ASHRAF ALIAS JAVED SIMNANI,Bahujan Samaj Party,55660,121,55781,4.83,64 - Gorakhpur (Uttar Pradesh),24,64
4.0,ANAND KUMAR YADAV ALIAS ANAND KUMAR FAUJI,Bharatheeya Jawan Kisan Party,4946,9,4955,0.43,64 - Gorakhpur (Uttar Pradesh),24,64
5.0,PINTU SAHANI,Independent,4031,1,4032,0.35,64 - Gorakhpur (Uttar Pradesh),24,64
6.0,SHIVSHANKAR PRAJAPATI,Bhagidari Party(P),2631,4,2635,0.23,64 - Gorakhpur (Uttar Pradesh),24,64
7.0,SUDHANSHU,Independent,2393,2,2395,0.21,64 - Gorakhpur (Uttar Pradesh),24,64
8.0,SANJAY SINGH RANA,Bhartiya Sarvdharm Party,2011,1,2012,0.17,64 - Gorakhpur (Uttar Pradesh),24,64
9.0,NAFEES AKHTAR,Independent,1880,-,1880,0.16,64 - Gorakhpur (Uttar Pradesh),24,64
10.0,ANKIT SHAH,Bharatiya Yuva Jan Ekta Party,1871,3,1874,0.16,64 - Gorakhpur (Uttar Pradesh),24,64
11.0,AMITA BHARATI,Independent,1356,8,1364,0.12,64 - Gorakhpur (Uttar Pradesh),24,64
12.0,SONU RAI,Mera Adhikaar Rashtriya Dal,891,7,898,0.08,64 - Gorakhpur (Uttar Pradesh),24,64
13.0,SHRIRAM PRASAD,Al-Hind Party,762,2,764,0.07,64 - Gorakhpur (Uttar Pradesh),24,64
14.0,NOTA,None of the Above,7652,29,7681,0.67,64 - Gorakhpur (Uttar Pradesh),24,64
,Total,,1151384,3029,1154413,,64 - Gorakhpur (Uttar Pradesh),24,64
1.0,VIJAY KUMAR DUBAY,Bharatiya Janata Party,516006,339,516345,47.79,65 - Kushi Nagar (Uttar Pradesh),24,65
2.0,AJAY PRATAP SINGH URF PINTU SAITHWAR,Samajwadi Party,434210,345,434555,40.22,65 - Kushi Nagar (Uttar Pradesh),24,65
3.0,SUBH NARAYAN CHAUHAN,Bahujan Samaj Party,67155,53,67208,6.22,65 - Kushi Nagar (Uttar Pradesh),24,65
4.0,SWAMI PRASAD MAURYA,Rashtriya Shoshit Samaj Party,36559,16,36575,3.39,65 - Kushi Nagar (Uttar Pradesh),24,65
5.0,HARIKESH,Azad Adhikar Sena,4094,3,4097,0.38,65 - Kushi Nagar (Uttar Pradesh),24,65
6.0,RAMCHANDRA SINGH,Independent,3619,2,3621,0.34,65 - Kushi Nagar (Uttar Pradesh),24,65
7.0,SUNIL KUMAR SHUKLA,Bhartiya Lok Nayak Party,3529,3,3532,0.33,65 - Kushi Nagar (Uttar Pradesh),24,65
8.0,AMIY UPADHYAY,Independent,2432,1,2433,0.23,65 - Kushi Nagar (Uttar Pradesh),24,65
9.0,VEDPRAKASH MISHRA,Subhashwadi Bhartiya Samajwadi Party (Subhas Party),2332,3,2335,0.22,65 - Kushi Nagar (Uttar Pradesh),24,65
10.0,NOTA,None of the Above,9774,8,9782,0.91,65 - Kushi Nagar (Uttar Pradesh),24,65
,Total,,1079710,773,1080483,,65 - Kushi Nagar (Uttar Pradesh),24,65
1.0,SHASHANK MANI,Bharatiya Janata Party,503509,1032,504541,48.36,66 - Deoria (Uttar Pradesh),24,66
2.0,AKHILESH PRATAP SINGH,Indian National Congress,467946,1753,469699,45.02,66 - Deoria (Uttar Pradesh),24,66
3.0,SANDESH,Bahujan Samaj Party,45446,118,45564,4.37,66 - Deoria (Uttar Pradesh),24,66
4.0,SATENDER KUMAR MALL,Independent,4149,9,4158,0.4,66 - Deoria (Uttar Pradesh),24,66
5.0,MUKTINATH SINGH,Janta Samta Party,3261,3,3264,0.31,66 - Deoria (Uttar Pradesh),24,66
6.0,AGAMSWAROOP,Rashtriya Samanta Dal,3180,2,3182,0.3,66 - Deoria (Uttar Pradesh),24,66
7.0,RAFIK ANSARI,Independent,2687,1,2688,0.26,66 - Deoria (Uttar Pradesh),24,66
8.0,NOTA,None of the Above,10203,9,10212,0.98,66 - Deoria (Uttar Pradesh),24,66
,Total,,1040381,2927,1043308,,66 - Deoria (Uttar Pradesh),24,66
1.0,KAMLESH PASWAN,Bharatiya Janata Party,427528,1165,428693,45.38,67 - Bansgaon (Uttar Pradesh),24,67
2.0,SADAL PRASAD,Indian National Congress,423872,1671,425543,45.04,67 - Bansgaon (Uttar Pradesh),24,67
3.0,RAMSAMUJH,Bahujan Samaj Party,64567,183,64750,6.85,67 - Bansgaon (Uttar Pradesh),24,67
4.0,GAYA PRASAD,Independent,6629,9,6638,0.7,67 - Bansgaon (Uttar Pradesh),24,67
5.0,SHRVAN KUMAR NIRALA,Independent,4139,3,4142,0.44,67 - Bansgaon (Uttar Pradesh),24,67
6.0,HEERALAL,Independent,2597,-,2597,0.27,67 - Bansgaon (Uttar Pradesh),24,67
7.0,MURLI DHAR,Independent,1741,4,1745,0.18,67 - Bansgaon (Uttar Pradesh),24,67
8.0,RAJENDRA CHAUDHARI,Independent,1629,5,1634,0.17,67 - Bansgaon (Uttar Pradesh),24,67
9.0,NOTA,None of the Above,9006,15,9021,0.95,67 - Bansgaon (Uttar Pradesh),24,67
,Total,,941708,3055,944763,,67 - Bansgaon (Uttar Pradesh),24,67
1.0,DAROGA PRASAD SAROJ,Samajwadi Party,437567,2392,439959,43.85,68 - Lalganj (Uttar Pradesh),24,68
2.0,NEELAM SONKER,Bharatiya Janata Party,324106,830,324936,32.38,68 - Lalganj (Uttar Pradesh),24,68
3.0,INDU CHAUDHRI,Bahujan Samaj Party,209308,745,210053,20.93,68 - Lalganj (Uttar Pradesh),24,68
4.0,GANGADEEN,Communist Party of India,12263,8,12271,1.22,68 - Lalganj (Uttar Pradesh),24,68
5.0,BALINDAR,Janta Kranti Party (Rashtravadi),4157,1,4158,0.41,68 - Lalganj (Uttar Pradesh),24,68
6.0,SUSHMITA SAROJ,Independent,2621,5,2626,0.26,68 - Lalganj (Uttar Pradesh),24,68
7.0,RAM PYARE SHARAN VIJAITA,Independent,2337,4,2341,0.23,68 - Lalganj (Uttar Pradesh),24,68
8.0,NOTA,None of the Above,7075,19,7094,0.71,68 - Lalganj (Uttar Pradesh),24,68
,Total,,999434,4004,1003438,,68 - Lalganj (Uttar Pradesh),24,68
1.0,DHARMENDRA YADAV,Samajwadi Party,504837,3402,508239,48.2,69 - Azamgarh (Uttar Pradesh),24,69
2.0,DINESH LAL YADAV “NIRAHUA”,Bharatiya Janata Party,345725,1479,347204,32.93,69 - Azamgarh (Uttar Pradesh),24,69
3.0,MASHHOD SABEEHA ANSARI,Bahujan Samaj Party,179189,650,179839,17.05,69 - Azamgarh (Uttar Pradesh),24,69
4.0,RAVINDRA NATH SHARMA,Moulik Adhikar Party,3038,4,3042,0.29,69 - Azamgarh (Uttar Pradesh),24,69
5.0,PARAS YADAV,Jan Raajya Party,2489,2,2491,0.24,69 - Azamgarh (Uttar Pradesh),24,69
6.0,SHASHIDHAR,Independent,2227,5,2232,0.21,69 - Azamgarh (Uttar Pradesh),24,69
7.0,MAHENDRA NATH YADAV,Moolniwasi Samaj Party,1904,1,1905,0.18,69 - Azamgarh (Uttar Pradesh),24,69
8.0,VIJAY KUMAR,Independent,1733,2,1735,0.16,69 - Azamgarh (Uttar Pradesh),24,69
9.0,PANKAJ KUMAR YADAV,Independent,1595,4,1599,0.15,69 - Azamgarh (Uttar Pradesh),24,69
10.0,NOTA,None of the Above,6211,23,6234,0.59,69 - Azamgarh (Uttar Pradesh),24,69
,Total,,1048948,5572,1054520,,69 - Azamgarh (Uttar Pradesh),24,69
1.0,RAJEEV RAI,Samajwadi Party,501407,1724,503131,43.73,70 - Ghosi (Uttar Pradesh),24,70
2.0,DR. ARVIND RAJBHAR,Suheldev Bharatiya Samaj Party,339416,772,340188,29.57,70 - Ghosi (Uttar Pradesh),24,70
3.0,BALKRISHNA CHAUHAN,Bahujan Samaj Party,208938,466,209404,18.2,70 - Ghosi (Uttar Pradesh),24,70
4.0,LILAWATI RAJBHAR,Moolniwasi Samaj Party,47520,7,47527,4.13,70 - Ghosi (Uttar Pradesh),24,70
5.0,PAWAN KUMAR CHAUHAN,Independent,7067,10,7077,0.62,70 - Ghosi (Uttar Pradesh),24,70
6.0,VINOD KUMAR RAI,Communist Party of India,6987,6,6993,0.61,70 - Ghosi (Uttar Pradesh),24,70
7.0,ROLI GUPTA,Akhil Bhartiya Hamara Samaj Party,4211,14,4225,0.37,70 - Ghosi (Uttar Pradesh),24,70
8.0,VIRENDRA,Rashtriya Jantantrik Bharat Vikas Party,2344,3,2347,0.2,70 - Ghosi (Uttar Pradesh),24,70
9.0,VIJAY,Socialist Unity Centre Of India (COMMUNIST),2240,1,2241,0.19,70 - Ghosi (Uttar Pradesh),24,70
10.0,AWADHESH KUMAR CHAUHAN,Janta Kranti Party (Rashtravadi),2211,28,2239,0.19,70 - Ghosi (Uttar Pradesh),24,70
11.0,SATISH CHAND PRAJAPATI FAUJI,Samajhdar Party,1918,3,1921,0.17,70 - Ghosi (Uttar Pradesh),24,70
12.0,MADAN RAJBHAR,Mang Samaj Party,1895,10,1905,0.17,70 - Ghosi (Uttar Pradesh),24,70
13.0,SAUDAGER,Independent,1892,-,1892,0.16,70 - Ghosi (Uttar Pradesh),24,70
14.0,RAJENDRA RAM,Independent,1649,-,1649,0.14,70 - Ghosi (Uttar Pradesh),24,70
15.0,YAKUB ANSARI,Peace Party,1568,5,1573,0.14,70 - Ghosi (Uttar Pradesh),24,70
16.0,PREM CHAND,Pragatisheel Manav Samaj Party,1559,2,1561,0.14,70 - Ghosi (Uttar Pradesh),24,70
17.0,SANTOSH KUMAR GUPTA,Janlok Vikas Party,1473,-,1473,0.13,70 - Ghosi (Uttar Pradesh),24,70
18.0,JYOTIRMA PATHAK,Independent,1199,5,1204,0.1,70 - Ghosi (Uttar Pradesh),24,70
19.0,BADRI NATH,Independent,1164,6,1170,0.1,70 - Ghosi (Uttar Pradesh),24,70
20.0,PREMCHAND NAYAK,Independent,1116,1,1117,0.1,70 - Ghosi (Uttar Pradesh),24,70
21.0,RAMNARESH YADAV,Jan Raajya Party,881,4,885,0.08,70 - Ghosi (Uttar Pradesh),24,70
22.0,RAJIV KUMAR SINGH,Independent,855,2,857,0.07,70 - Ghosi (Uttar Pradesh),24,70
23.0,ISHWAR DAYAL SINGH SETH,Bhartiya Sabka Dal,827,14,841,0.07,70 - Ghosi (Uttar Pradesh),24,70
24.0,PRAGYESH KUMAR,Independent,816,2,818,0.07,70 - Ghosi (Uttar Pradesh),24,70
25.0,RAMVACHAN,Sardar Patel Siddhant Party,771,2,773,0.07,70 - Ghosi (Uttar Pradesh),24,70
26.0,RAJENDRA AGRAWAL,Independent,729,1,730,0.06,70 - Ghosi (Uttar Pradesh),24,70
27.0,GOPAL SINGH,Azad Adhikar Sena,729,8,737,0.06,70 - Ghosi (Uttar Pradesh),24,70
28.0,ISMAIL ANSARI,Aawami Pichhada Party,592,2,594,0.05,70 - Ghosi (Uttar Pradesh),24,70
29.0,NOTA,None of the Above,3487,31,3518,0.31,70 - Ghosi (Uttar Pradesh),24,70
,Total,,1147461,3129,1150590,,70 - Ghosi (Uttar Pradesh),24,70
1.0,RAMASHANKAR RAJBHAR,Samajwadi Party,403616,1856,405472,44.2,71 - Salempur (Uttar Pradesh),24,71
2.0,RAVINDAR KUSHAWAHA,Bharatiya Janata Party,400489,1410,401899,43.81,71 - Salempur (Uttar Pradesh),24,71
3.0,BHIM RAJBHAR,Bahujan Samaj Party,80291,308,80599,8.79,71 - Salempur (Uttar Pradesh),24,71
4.0,JAIBAHADUR ALIAS JAIBAHADUR CHAUHAN,Janta Kranti Party (Rashtravadi),8241,22,8263,0.9,71 - Salempur (Uttar Pradesh),24,71
5.0,SHREENARAYAN MISHRA,Akhil Bhartiya Sarvjan Hit Party,3878,14,3892,0.42,71 - Salempur (Uttar Pradesh),24,71
6.0,SADDAM HUSSAIN,Independent,3210,5,3215,0.35,71 - Salempur (Uttar Pradesh),24,71
7.0,SHRIKRISHNA,Independent,2527,5,2532,0.28,71 - Salempur (Uttar Pradesh),24,71
8.0,AMRESH THAKUR,Independent,2147,9,2156,0.24,71 - Salempur (Uttar Pradesh),24,71
9.0,SURYA PRAKASH GAUTAM,Sardar Patel Siddhant Party,1782,3,1785,0.19,71 - Salempur (Uttar Pradesh),24,71
10.0,NOTA,None of the Above,7520,29,7549,0.82,71 - Salempur (Uttar Pradesh),24,71
,Total,,913701,3661,917362,,71 - Salempur (Uttar Pradesh),24,71
1.0,SANATAN PANDEY,Samajwadi Party,464473,2595,467068,46.37,72 - Ballia (Uttar Pradesh),24,72
2.0,NEERAJ SHEKHAR,Bharatiya Janata Party,421277,2407,423684,42.06,72 - Ballia (Uttar Pradesh),24,72
3.0,LALLAN SINGH YADAV,Bahujan Samaj Party,84943,262,85205,8.46,72 - Ballia (Uttar Pradesh),24,72
4.0,SUMESHWAR,Independent,5056,-,5056,0.5,72 - Ballia (Uttar Pradesh),24,72
5.0,SHESHNATH,Independent,3587,1,3588,0.36,72 - Ballia (Uttar Pradesh),24,72
6.0,RAVI KANT SINGH ALIAS RAVI PATEL,Sardar Patel Siddhant Party,3174,7,3181,0.32,72 - Ballia (Uttar Pradesh),24,72
7.0,RAMNIVAS GOND,Gondvana Gantantra Party,2642,30,2672,0.27,72 - Ballia (Uttar Pradesh),24,72
8.0,SURYA BALI PRASAD,Aazad Samaj Party (Kanshi Ram),2143,5,2148,0.21,72 - Ballia (Uttar Pradesh),24,72
9.0,RANJANA,Independent,1871,7,1878,0.19,72 - Ballia (Uttar Pradesh),24,72
10.0,ASHOK GUPTA,Independent,1339,8,1347,0.13,72 - Ballia (Uttar Pradesh),24,72
11.0,MANINDR,Independent,1186,1,1187,0.12,72 - Ballia (Uttar Pradesh),24,72
12.0,AVADHESH VERMA,Independent,1150,11,1161,0.12,72 - Ballia (Uttar Pradesh),24,72
13.0,PRAKASH KUMAR,Independent,960,-,960,0.1,72 - Ballia (Uttar Pradesh),24,72
14.0,NOTA,None of the Above,8167,20,8187,0.81,72 - Ballia (Uttar Pradesh),24,72
,Total,,1001968,5354,1007322,,72 - Ballia (Uttar Pradesh),24,72
1.0,BABU SINGH KUSHWAHA,Samajwadi Party,506076,3054,509130,46.21,73 - Jaunpur (Uttar Pradesh),24,73
2.0,KRIPASHANKAR SINGH,Bharatiya Janata Party,408512,1283,409795,37.19,73 - Jaunpur (Uttar Pradesh),24,73
3.0,SHYAM SINGH YADAV,Bahujan Samaj Party,156691,446,157137,14.26,73 - Jaunpur (Uttar Pradesh),24,73
4.0,SARFARAZ AHMAD,Independent,2750,-,2750,0.25,73 - Jaunpur (Uttar Pradesh),24,73
5.0,ASHOK SINGH,Samaj Vikas Kranti Party,2749,6,2755,0.25,73 - Jaunpur (Uttar Pradesh),24,73
6.0,JIYALAL PRAJAPATI,Bhagidari Party(P),2232,3,2235,0.2,73 - Jaunpur (Uttar Pradesh),24,73
7.0,SHRIPATI MAURYA,Independent,2091,3,2094,0.19,73 - Jaunpur (Uttar Pradesh),24,73
8.0,SHAH ALAM,Apna Dal (Kamerawadi),2003,-,2003,0.18,73 - Jaunpur (Uttar Pradesh),24,73
9.0,FULACHANDR,Moulik Adhikar Party,1632,1,1633,0.15,73 - Jaunpur (Uttar Pradesh),24,73
10.0,KRIPASHANKAR C PANDEY,Independent,1446,1,1447,0.13,73 - Jaunpur (Uttar Pradesh),24,73
11.0,GOVIND LAL,Independent,1387,2,1389,0.13,73 - Jaunpur (Uttar Pradesh),24,73
12.0,RAM PYARE,Socialist Unity Centre Of India (COMMUNIST),1160,1,1161,0.11,73 - Jaunpur (Uttar Pradesh),24,73
13.0,NISHA PATEL,Sardar Patel Siddhant Party,1125,3,1128,0.1,73 - Jaunpur (Uttar Pradesh),24,73
14.0,BHARAT RAM,Pachchasi Parivartan Samaj Party,802,-,802,0.07,73 - Jaunpur (Uttar Pradesh),24,73
15.0,NOTA,None of the Above,6301,28,6329,0.57,73 - Jaunpur (Uttar Pradesh),24,73
,Total,,1096957,4831,1101788,,73 - Jaunpur (Uttar Pradesh),24,73
1.0,PRIYA SAROJ,Samajwadi Party,449561,1731,451292,42.57,74 - Machhlishahr (Uttar Pradesh),24,74
2.0,BHOLANATH (B.P. SAROJ),Bharatiya Janata Party,414494,948,415442,39.19,74 - Machhlishahr (Uttar Pradesh),24,74
3.0,KRIPA SHANKAR SAROJ,Bahujan Samaj Party,156930,361,157291,14.84,74 - Machhlishahr (Uttar Pradesh),24,74
4.0,SHRAVAN KUMAR,Independent,5804,3,5807,0.55,74 - Machhlishahr (Uttar Pradesh),24,74
5.0,URMILA,Samaj Parivartan Party,5296,7,5303,0.5,74 - Machhlishahr (Uttar Pradesh),24,74
6.0,SUBAS,Independent,3691,2,3693,0.35,74 - Machhlishahr (Uttar Pradesh),24,74
7.0,RANG BAHADUR,Independent,2715,3,2718,0.26,74 - Machhlishahr (Uttar Pradesh),24,74
8.0,BRIJESH KUMAR SAROJ,Prabuddhwadi Bahujan Morcha,2365,-,2365,0.22,74 - Machhlishahr (Uttar Pradesh),24,74
9.0,RAJENDRA PRASAD,Rashtra Uday Party,2066,1,2067,0.19,74 - Machhlishahr (Uttar Pradesh),24,74
10.0,RAM MILAN,Sardar Patel Siddhant Party,1713,3,1716,0.16,74 - Machhlishahr (Uttar Pradesh),24,74
11.0,KAMLESH,Azad Samaj Party,1698,4,1702,0.16,74 - Machhlishahr (Uttar Pradesh),24,74
12.0,BRIJESH KUMAR,Prithviraj Janshakti Party,1362,2,1364,0.13,74 - Machhlishahr (Uttar Pradesh),24,74
13.0,NOTA,None of the Above,9277,26,9303,0.88,74 - Machhlishahr (Uttar Pradesh),24,74
,Total,,1056972,3091,1060063,,74 - Machhlishahr (Uttar Pradesh),24,74
1.0,AFZAL ANSARI,Samajwadi Party,537784,2128,539912,46.82,75 - Ghazipur (Uttar Pradesh),24,75
2.0,PARS NATH RAI,Bharatiya Janata Party,413518,1533,415051,35.99,75 - Ghazipur (Uttar Pradesh),24,75
3.0,UMESH KUMAR SINGH,Bahujan Samaj Party,164601,363,164964,14.31,75 - Ghazipur (Uttar Pradesh),24,75
4.0,AJAY,Vishwa Kalyan Rashtriya Manav Samaj Party,5068,6,5074,0.44,75 - Ghazipur (Uttar Pradesh),24,75
5.0,NUSRAT ANSARI,Independent,4567,49,4616,0.4,75 - Ghazipur (Uttar Pradesh),24,75
6.0,ADITYA SHRIVASTAV,Yuga Thulasi Party,3312,4,3316,0.29,75 - Ghazipur (Uttar Pradesh),24,75
7.0,SATYDEV YADAV,Independent,3163,9,3172,0.28,75 - Ghazipur (Uttar Pradesh),24,75
8.0,GYANCHANDRA BIND,Independent,3127,8,3135,0.27,75 - Ghazipur (Uttar Pradesh),24,75
9.0,RAMPRAVESH,Moulik Adhikar Party,2830,3,2833,0.25,75 - Ghazipur (Uttar Pradesh),24,75
10.0,DHANANJAY KUMAR TIWARI,Bhartiya Lokvani Party,1949,7,1956,0.17,75 - Ghazipur (Uttar Pradesh),24,75
11.0,NOTA,None of the Above,9033,32,9065,0.79,75 - Ghazipur (Uttar Pradesh),24,75
,Total,,1148952,4142,1153094,,75 - Ghazipur (Uttar Pradesh),24,75
1.0,BIRENDRA SINGH,Samajwadi Party,472928,1548,474476,42.5,76 - Chandauli (Uttar Pradesh),24,76
2.0,DR. MAHENDRA NATH PANDEY,Bharatiya Janata Party,451802,1109,452911,40.57,76 - Chandauli (Uttar Pradesh),24,76
3.0,SATYENDRA KUMAR MAURYA,Bahujan Samaj Party,159585,318,159903,14.32,76 - Chandauli (Uttar Pradesh),24,76
4.0,SHOBHANATH PRAJAPATI,Bhagidari Party(P),4027,5,4032,0.36,76 - Chandauli (Uttar Pradesh),24,76
5.0,SHER SINGH,Yuga Thulasi Party,3090,6,3096,0.28,76 - Chandauli (Uttar Pradesh),24,76
6.0,SANTOSH KUMAR,Independent,2965,4,2969,0.27,76 - Chandauli (Uttar Pradesh),24,76
7.0,RAJESH VISHWAKARMA,Moulik Adhikar Party,2759,3,2762,0.25,76 - Chandauli (Uttar Pradesh),24,76
8.0,ARVIND KUMAR PATEL,Sardar Patel Siddhant Party,2734,11,2745,0.25,76 - Chandauli (Uttar Pradesh),24,76
9.0,SANJAY KUMAR SINHA,Jai Hind National Party,2617,6,2623,0.23,76 - Chandauli (Uttar Pradesh),24,76
10.0,RAM GOVIND,Samajhdar Party,1975,2,1977,0.18,76 - Chandauli (Uttar Pradesh),24,76
11.0,NOTA,None of the Above,8987,18,9005,0.81,76 - Chandauli (Uttar Pradesh),24,76
,Total,,1113469,3030,1116499,,76 - Chandauli (Uttar Pradesh),24,76
1.0,NARENDRA MODI,Bharatiya Janata Party,611439,1531,612970,54.24,77 - Varanasi (Uttar Pradesh),24,77
2.0,AJAY RAI,Indian National Congress,459084,1373,460457,40.74,77 - Varanasi (Uttar Pradesh),24,77
3.0,ATHER JAMAL LARI,Bahujan Samaj Party,33646,120,33766,2.99,77 - Varanasi (Uttar Pradesh),24,77
4.0,KOLISETTY SHIVA KUMAR,Yuga Thulasi Party,5748,2,5750,0.51,77 - Varanasi (Uttar Pradesh),24,77
5.0,GAGAN PRAKASH YADAV,Apna Dal (Kamerawadi),3619,15,3634,0.32,77 - Varanasi (Uttar Pradesh),24,77
6.0,DINESH KUMAR YADAV,Independent,2912,5,2917,0.26,77 - Varanasi (Uttar Pradesh),24,77
7.0,SANJAY KUMAR TIWARI,Independent,2170,1,2171,0.19,77 - Varanasi (Uttar Pradesh),24,77
8.0,NOTA,None of the Above,8463,15,8478,0.75,77 - Varanasi (Uttar Pradesh),24,77
,Total,,1127081,3062,1130143,,77 - Varanasi (Uttar Pradesh),24,77
1.0,DR. VINOD KUMAR BIND,Bharatiya Janata Party,458877,1105,459982,42.39,78 - Bhadohi (Uttar Pradesh),24,78
2.0,LALITESHPATI TRIPATHI,All India Trinamool Congress,414131,1779,415910,38.33,78 - Bhadohi (Uttar Pradesh),24,78
3.0,HARISHANKAR,Bahujan Samaj Party,154718,335,155053,14.29,78 - Bhadohi (Uttar Pradesh),24,78
4.0,PREMCHAND BIND,Pragatisheel Manav Samaj Party,13655,34,13689,1.26,78 - Bhadohi (Uttar Pradesh),24,78
5.0,RAJ NARAYAN PATEL,Sardar Patel Siddhant Party,6198,8,6206,0.57,78 - Bhadohi (Uttar Pradesh),24,78
6.0,RAM PRAKASH MISHRA,Rashtriya Samaj Paksha,5266,4,5270,0.49,78 - Bhadohi (Uttar Pradesh),24,78
7.0,SUSHIL,All India Forward Bloc,5254,7,5261,0.48,78 - Bhadohi (Uttar Pradesh),24,78
8.0,DR. SHYAMDHAR TIWARI,Independent,4842,6,4848,0.45,78 - Bhadohi (Uttar Pradesh),24,78
9.0,KRISHNA DEV,Rashtra Uday Party,4590,7,4597,0.42,78 - Bhadohi (Uttar Pradesh),24,78
10.0,DHIRENDRA KUMAR TIWARI,Independent,2944,4,2948,0.27,78 - Bhadohi (Uttar Pradesh),24,78
11.0,NOTA,None of the Above,11222,7,11229,1.03,78 - Bhadohi (Uttar Pradesh),24,78
,Total,,1081697,3296,1084993,,78 - Bhadohi (Uttar Pradesh),24,78
1.0,ANUPRIYA PATEL,Apna Dal (Soneylal),470866,765,471631,42.67,79 - Mirzapur (Uttar Pradesh),24,79
2.0,RAMESH CHAND BIND,Samajwadi Party,433286,535,433821,39.25,79 - Mirzapur (Uttar Pradesh),24,79
3.0,MANISH KUMAR,Bahujan Samaj Party,144279,167,144446,13.07,79 - Mirzapur (Uttar Pradesh),24,79
4.0,RAJESH,Independent,10927,9,10936,0.99,79 - Mirzapur (Uttar Pradesh),24,79
5.0,LAL JI VERMA,Independent,6355,4,6359,0.58,79 - Mirzapur (Uttar Pradesh),24,79
6.0,ANIL KUMAR,Eklavya Samaj Party,6166,5,6171,0.56,79 - Mirzapur (Uttar Pradesh),24,79
7.0,DAULAT SINGH,Apna Dal (Kamerawadi),5227,8,5235,0.47,79 - Mirzapur (Uttar Pradesh),24,79
8.0,RAMDHANI,Rashtriya Samaj Paksha,4914,1,4915,0.44,79 - Mirzapur (Uttar Pradesh),24,79
9.0,SAMEER SINGH,All India Forward Bloc,3486,1,3487,0.32,79 - Mirzapur (Uttar Pradesh),24,79
10.0,SATYADEV,Purvanchal Mahapanchayat,3351,4,3355,0.3,79 - Mirzapur (Uttar Pradesh),24,79
11.0,NOTA,None of the Above,15043,6,15049,1.36,79 - Mirzapur (Uttar Pradesh),24,79
,Total,,1103900,1505,1105405,,79 - Mirzapur (Uttar Pradesh),24,79
1.0,CHHOTELAL,Samajwadi Party,465240,608,465848,46.14,80 - Robertsganj (Uttar Pradesh),24,80
2.0,RINKI SINGH,Apna Dal (Soneylal),336344,270,336614,33.34,80 - Robertsganj (Uttar Pradesh),24,80
3.0,DHANESHWAR,Bahujan Samaj Party,118669,109,118778,11.77,80 - Robertsganj (Uttar Pradesh),24,80
4.0,ASHOK KUMAR KANNAUJIYA,Communist Party of India,23830,22,23852,2.36,80 - Robertsganj (Uttar Pradesh),24,80
5.0,SUBHAGI,Janhit Sankalp Party,8191,3,8194,0.81,80 - Robertsganj (Uttar Pradesh),24,80
6.0,ARVIND KUMAR BHARTI,Rashtriya Samanta Dal,7583,9,7592,0.75,80 - Robertsganj (Uttar Pradesh),24,80
7.0,SUKALU,Independent,6701,11,6712,0.66,80 - Robertsganj (Uttar Pradesh),24,80
8.0,SHIVPUJAN,Rashtriya Samaj Paksha,6422,22,6444,0.64,80 - Robertsganj (Uttar Pradesh),24,80
9.0,SONU NIGAM,Independent,6142,2,6144,0.61,80 - Robertsganj (Uttar Pradesh),24,80
10.0,CHANDRIKA PRASAD,Janta Kranti Party (Rashtravadi),3732,9,3741,0.37,80 - Robertsganj (Uttar Pradesh),24,80
11.0,PRABHUDAYAL,Rashtriya Samaj Dal (R),3470,1,3471,0.34,80 - Robertsganj (Uttar Pradesh),24,80
12.0,RAM SHIROMANI,Sardar Patel Siddhant Party,3116,7,3123,0.31,80 - Robertsganj (Uttar Pradesh),24,80
13.0,NOTA,None of the Above,19019,13,19032,1.89,80 - Robertsganj (Uttar Pradesh),24,80
,Total,,1008459,1086,1009545,,80 - Robertsganj (Uttar Pradesh),24,80
1.0,JAGADISH CHANDRA BARMA BASUNIA,All India Trinamool Congress,785747,2628,788375,48.57,1 - Coochbehar (West Bengal),25,1
2.0,NISITH PRAMANIK,Bharatiya Janata Party,745144,3981,749125,46.16,1 - Coochbehar (West Bengal),25,1
3.0,NITISH CHANDRA ROY,All India Forward Bloc,29992,275,30267,1.86,1 - Coochbehar (West Bengal),25,1
4.0,PIYA ROY CHOWDHURY,Indian National Congress,10539,140,10679,0.66,1 - Coochbehar (West Bengal),25,1
5.0,HAREKRISHNA SARKAR,Independent,9462,5,9467,0.58,1 - Coochbehar (West Bengal),25,1
6.0,KAMALESH BARMAN,Independent,2972,21,2993,0.18,1 - Coochbehar (West Bengal),25,1
7.0,NABI BARMAN,Independent,2710,14,2724,0.17,1 - Coochbehar (West Bengal),25,1
8.0,SUBODH BARMAN,Independent,2594,5,2599,0.16,1 - Coochbehar (West Bengal),25,1
9.0,DILIP CHANDRA BARMAN,Socialist Unity Centre Of India (COMMUNIST),2449,19,2468,0.15,1 - Coochbehar (West Bengal),25,1
10.0,PURNA MOHAN ROY,Bahujan Samaj Party,2087,10,2097,0.13,1 - Coochbehar (West Bengal),25,1
11.0,BIDHAN DAS,Independent,2067,5,2072,0.13,1 - Coochbehar (West Bengal),25,1
12.0,KISHORE RAY,Independent,1588,18,1606,0.1,1 - Coochbehar (West Bengal),25,1
13.0,PRADIP KUMAR ROY,Kamatapur People’s Party (United),1499,19,1518,0.09,1 - Coochbehar (West Bengal),25,1
14.0,AMAL DAS,Independent,1488,7,1495,0.09,1 - Coochbehar (West Bengal),25,1
15.0,NOTA,None of the Above,15510,53,15563,0.96,1 - Coochbehar (West Bengal),25,1
,Total,,1615848,7200,1623048,,1 - Coochbehar (West Bengal),25,1
1.0,MANOJ TIGGA,Bharatiya Janata Party,691533,3781,695314,48.92,2 - Alipurduars (West Bengal),25,2
2.0,PRAKASH CHIK BARAIK,All India Trinamool Congress,617486,2381,619867,43.61,2 - Alipurduars (West Bengal),25,2
3.0,MILI ORAON,Revolutionary Socialist Party,39424,285,39709,2.79,2 - Alipurduars (West Bengal),25,2
4.0,PARIMAL ORAON,Independent,12560,24,12584,0.89,2 - Alipurduars (West Bengal),25,2
5.0,ARJUN INDWAR,Independent,11090,32,11122,0.78,2 - Alipurduars (West Bengal),25,2
6.0,MUNIB NARJINARY,Bahujan Samaj Party,6600,48,6648,0.47,2 - Alipurduars (West Bengal),25,2
7.0,RAHUL MARAK,Kisan Mazdoor Sangharsh Party,5679,16,5695,0.4,2 - Alipurduars (West Bengal),25,2
8.0,CHANDAN ORAON,Socialist Unity Centre Of India (COMMUNIST),2751,36,2787,0.2,2 - Alipurduars (West Bengal),25,2
9.0,BINAY MURMU,North Bengal People’s Party,2700,58,2758,0.19,2 - Alipurduars (West Bengal),25,2
10.0,NRIPENDRA NARAYAN DEBKARJEE,Kamatapur People’s Party (United),2017,38,2055,0.14,2 - Alipurduars (West Bengal),25,2
11.0,BABITA BARA,Gana Suraksha Party,1522,30,1552,0.11,2 - Alipurduars (West Bengal),25,2
12.0,NOTA,None of the Above,21235,63,21298,1.5,2 - Alipurduars (West Bengal),25,2
,Total,,1414597,6792,1421389,,2 - Alipurduars (West Bengal),25,2
1.0,DR JAYANTA KUMAR ROY,Bharatiya Janata Party,763236,3332,766568,48.57,3 - Jalpaiguri (West Bengal),25,3
2.0,NIRMAL CHANDRA ROY,All India Trinamool Congress,677496,2379,679875,43.07,3 - Jalpaiguri (West Bengal),25,3
3.0,DEBRAJ BARMAN,Communist Party of India (Marxist),73629,463,74092,4.69,3 - Jalpaiguri (West Bengal),25,3
4.0,SHIPRA RAY HAKIM,Independent,9890,17,9907,0.63,3 - Jalpaiguri (West Bengal),25,3
5.0,BINOD MALLICK,Bahujan Samaj Party,8537,29,8566,0.54,3 - Jalpaiguri (West Bengal),25,3
6.0,HAREKRISHNA SARKAR,Independent,5837,11,5848,0.37,3 - Jalpaiguri (West Bengal),25,3
7.0,MAHESWAR BARMAN,Independent,4254,13,4267,0.27,3 - Jalpaiguri (West Bengal),25,3
8.0,RAM PRASAD MANDAL,Socialist Unity Centre Of India (COMMUNIST),3815,20,3835,0.24,3 - Jalpaiguri (West Bengal),25,3
9.0,MANABENDRA ROY,Kamatapur People’s Party (United),2899,51,2950,0.19,3 - Jalpaiguri (West Bengal),25,3
10.0,NIRODE CHANDRA ADHIKARY,Independent,2504,13,2517,0.16,3 - Jalpaiguri (West Bengal),25,3
11.0,ADHIR CHANDRA BARMAN,Independent,1911,16,1927,0.12,3 - Jalpaiguri (West Bengal),25,3
12.0,RANJIT BARMAN,Mulnibasi Party of India,1180,9,1189,0.08,3 - Jalpaiguri (West Bengal),25,3
13.0,NOTA,None of the Above,16807,41,16848,1.07,3 - Jalpaiguri (West Bengal),25,3
,Total,,1571995,6394,1578389,,3 - Jalpaiguri (West Bengal),25,3
1.0,RAJU BISTA,Bharatiya Janata Party,675324,4007,679331,51.18,4 - Darjeeling (West Bengal),25,4
2.0,GOPAL LAMA,All India Trinamool Congress,498789,2017,500806,37.73,4 - Darjeeling (West Bengal),25,4
3.0,MUNISH TAMANG,Indian National Congress,82597,777,83374,6.28,4 - Darjeeling (West Bengal),25,4
4.0,BANDANA RAI,Independent,13155,519,13674,1.03,4 - Darjeeling (West Bengal),25,4
5.0,BISHNU PRASAD SHARMA,Independent,7431,16,7447,0.56,4 - Darjeeling (West Bengal),25,4
6.0,BHUPENDRA LEPCHA,Independent,6369,26,6395,0.48,4 - Darjeeling (West Bengal),25,4
7.0,ATASI BISWAS,Kisan Mazdoor Sangharsh Party,4586,55,4641,0.35,4 - Darjeeling (West Bengal),25,4
8.0,PRADHAN MARDI,Ambedkarite Party of India,2714,33,2747,0.21,4 - Darjeeling (West Bengal),25,4
9.0,KHUSHI RANJAN MANDAL,Independent,2313,24,2337,0.18,4 - Darjeeling (West Bengal),25,4
10.0,KALICHARAN BARMAN,Independent,2055,24,2079,0.16,4 - Darjeeling (West Bengal),25,4
11.0,QAMRUL HAQUE,North Bengal People’s Party,1829,24,1853,0.14,4 - Darjeeling (West Bengal),25,4
12.0,BUDHARU ROY,Kamatapur People’s Party (United),1734,28,1762,0.13,4 - Darjeeling (West Bengal),25,4
13.0,SHAHRIAR ALAM,Socialist Unity Centre Of India (COMMUNIST),1605,9,1614,0.12,4 - Darjeeling (West Bengal),25,4
14.0,SUBODH PAKHRIN,Gorkha Rashtriya Congress,1270,61,1331,0.1,4 - Darjeeling (West Bengal),25,4
15.0,NOTA,None of the Above,17960,61,18021,1.36,4 - Darjeeling (West Bengal),25,4
,Total,,1319731,7681,1327412,,4 - Darjeeling (West Bengal),25,4
1.0,KARTICK CHANDRA PAUL,Bharatiya Janata Party,558644,2253,560897,40.99,5 - Raiganj (West Bengal),25,5
2.0,KALYANI KRISHNA,All India Trinamool Congress,491150,1550,492700,36.0,5 - Raiganj (West Bengal),25,5
3.0,ALI IMRAN RAMZ,Indian National Congress,262694,579,263273,19.24,5 - Raiganj (West Bengal),25,5
4.0,DWARIK NATH BARMAN,Independent,8258,6,8264,0.6,5 - Raiganj (West Bengal),25,5
5.0,MD NAZIR AKHTAR,Independent,6004,1,6005,0.44,5 - Raiganj (West Bengal),25,5
6.0,KALIDASH MURMU,Independent,5865,3,5868,0.43,5 - Raiganj (West Bengal),25,5
7.0,SWAPAN KUMAR DAS,Bahujan Samaj Party,4106,11,4117,0.3,5 - Raiganj (West Bengal),25,5
8.0,RUPAK ROY,Independent,3355,3,3358,0.25,5 - Raiganj (West Bengal),25,5
9.0,FAKIRA MD,Independent,3353,2,3355,0.25,5 - Raiganj (West Bengal),25,5
10.0,DURGA MURMU,Ambedkarite Party of India,3330,4,3334,0.24,5 - Raiganj (West Bengal),25,5
11.0,PALASH CHANDRA MAHATO,Independent,3112,2,3114,0.23,5 - Raiganj (West Bengal),25,5
12.0,ALI IMRAN,Independent,1939,7,1946,0.14,5 - Raiganj (West Bengal),25,5
13.0,MD ABRAHIM HOQUE,Independent,1761,2,1763,0.13,5 - Raiganj (West Bengal),25,5
14.0,SHAHIDUR RAHMAN,North Bengal People’s Party,1458,4,1462,0.11,5 - Raiganj (West Bengal),25,5
15.0,SHARANYA DUTTA,Independent,1328,2,1330,0.1,5 - Raiganj (West Bengal),25,5
16.0,SANATAN DUTTA,Socialist Unity Centre Of India (COMMUNIST),1256,15,1271,0.09,5 - Raiganj (West Bengal),25,5
17.0,TAPAN BARMAN,Jai Prakash Janata Dal,1249,2,1251,0.09,5 - Raiganj (West Bengal),25,5
18.0,ANWARUL HOQUE,Independent,1187,3,1190,0.09,5 - Raiganj (West Bengal),25,5
19.0,RAMESH CHANDRA SINHA,Bhumiputra United Party,1046,5,1051,0.08,5 - Raiganj (West Bengal),25,5
20.0,AL MONOWARA BEGAM,India Manus Party,977,5,982,0.07,5 - Raiganj (West Bengal),25,5
21.0,NOTA,None of the Above,1924,16,1940,0.14,5 - Raiganj (West Bengal),25,5
,Total,,1363996,4475,1368471,,5 - Raiganj (West Bengal),25,5
1.0,SUKANTA MAJUMDAR,Bharatiya Janata Party,572925,2071,574996,46.47,6 - Balurghat (West Bengal),25,6
2.0,BIPLAB MITRA,All India Trinamool Congress,563252,1358,564610,45.63,6 - Balurghat (West Bengal),25,6
3.0,JOYDEV KUMAR SIDDHANTA,Revolutionary Socialist Party,54081,136,54217,4.38,6 - Balurghat (West Bengal),25,6
4.0,HAKIM MURMU,Independent,6820,2,6822,0.55,6 - Balurghat (West Bengal),25,6
5.0,BAKHTIAR MUJAHIT SAHANI,Independent,6391,2,6393,0.52,6 - Balurghat (West Bengal),25,6
6.0,RANENDRA NATH MALI,Independent,5590,3,5593,0.45,6 - Balurghat (West Bengal),25,6
7.0,ANTA HANSDA,Bahujan Samaj Party,5130,15,5145,0.42,6 - Balurghat (West Bengal),25,6
8.0,BISWANATH MURMU,Ambedkarite Party of India,3454,11,3465,0.28,6 - Balurghat (West Bengal),25,6
9.0,MOZAMMEL HAQUE,All India Secular Front,2261,7,2268,0.18,6 - Balurghat (West Bengal),25,6
10.0,NAROTTAM SAHA,Independent,2095,11,2106,0.17,6 - Balurghat (West Bengal),25,6
11.0,MD. SARWARDI,Bhumiputra United Party,1957,10,1967,0.16,6 - Balurghat (West Bengal),25,6
12.0,BIRENDRA NATH MAHANTA,Socialist Unity Centre Of India (COMMUNIST),1380,7,1387,0.11,6 - Balurghat (West Bengal),25,6
13.0,RUBEL SARKAR,Kamatapur People’s Party (United),898,4,902,0.07,6 - Balurghat (West Bengal),25,6
14.0,NOTA,None of the Above,7430,7,7437,0.6,6 - Balurghat (West Bengal),25,6
,Total,,1233664,3644,1237308,,6 - Balurghat (West Bengal),25,6
1.0,KHAGEN MURMU,Bharatiya Janata Party,525109,1914,527023,37.18,7 - Maldaha Uttar (West Bengal),25,7
2.0,PRASUN BANERJEE,All India Trinamool Congress,448234,1081,449315,31.7,7 - Maldaha Uttar (West Bengal),25,7
3.0,ALAM MOSTAQUE,Indian National Congress,384063,701,384764,27.14,7 - Maldaha Uttar (West Bengal),25,7
4.0,JATISH KISKU,Independent,8680,3,8683,0.61,7 - Maldaha Uttar (West Bengal),25,7
5.0,MONATAN HEMBRAM,Independent,7927,6,7933,0.56,7 - Maldaha Uttar (West Bengal),25,7
6.0,SWAPAN MAHATO,Independent,7235,2,7237,0.51,7 - Maldaha Uttar (West Bengal),25,7
7.0,SANATAN RISHI,Bahujan Samaj Party,5624,8,5632,0.4,7 - Maldaha Uttar (West Bengal),25,7
8.0,JOSEPH KISKU,Ambedkarite Party of India,4637,-,4637,0.33,7 - Maldaha Uttar (West Bengal),25,7
9.0,MONJU HEMBROM,Independent,3535,3,3538,0.25,7 - Maldaha Uttar (West Bengal),25,7
10.0,MD FARUQUE HOSSAIN,Independent,3374,1,3375,0.24,7 - Maldaha Uttar (West Bengal),25,7
11.0,SOMNATH DAS,Bharatiya Nyay-Adhikar Raksha Party,3157,7,3164,0.22,7 - Maldaha Uttar (West Bengal),25,7
12.0,SUBHASH BARMAN,Kamatapur People’s Party (United),2019,-,2019,0.14,7 - Maldaha Uttar (West Bengal),25,7
13.0,KALICHARAN ROY,Socialist Unity Centre Of India (COMMUNIST),1286,7,1293,0.09,7 - Maldaha Uttar (West Bengal),25,7
14.0,MD SOHEL,All India Secular Front,1090,2,1092,0.08,7 - Maldaha Uttar (West Bengal),25,7
15.0,NARESH PAL,Jan Sangh Party,593,3,596,0.04,7 - Maldaha Uttar (West Bengal),25,7
16.0,NOTA,None of the Above,7257,31,7288,0.51,7 - Maldaha Uttar (West Bengal),25,7
,Total,,1413820,3769,1417589,,7 - Maldaha Uttar (West Bengal),25,7
1.0,ISHA KHAN CHOUDHURY,Indian National Congress,570966,1429,572395,41.79,8 - Maldaha Dakshin (West Bengal),25,8
2.0,SREERUPA MITRA CHAUDHURY (NIRBHAYA DIDI),Bharatiya Janata Party,441531,2496,444027,32.42,8 - Maldaha Dakshin (West Bengal),25,8
3.0,SHAHNAWAZ ALI RAIHAN,All India Trinamool Congress,299825,1201,301026,21.98,8 - Maldaha Dakshin (West Bengal),25,8
4.0,PURNOCHANDRA MANDAL,Independent,8381,2,8383,0.61,8 - Maldaha Dakshin (West Bengal),25,8
5.0,AHMED HEDATUL HASAN,Independent,5735,1,5736,0.42,8 - Maldaha Dakshin (West Bengal),25,8
6.0,MD. JAMAL SAIKH,Independent,5386,-,5386,0.39,8 - Maldaha Dakshin (West Bengal),25,8
7.0,BIKASH RABIDAS,Bahujan Samaj Party,5054,11,5065,0.37,8 - Maldaha Dakshin (West Bengal),25,8
8.0,BIJOY KUMAR SARKAR,Independent,4773,3,4776,0.35,8 - Maldaha Dakshin (West Bengal),25,8
9.0,SUSMITA DEY KARJEE,Bhartiya Lokmat Rashtrwadi Party,3521,14,3535,0.26,8 - Maldaha Dakshin (West Bengal),25,8
10.0,AMAL KUMAR RABIDAS,Independent,3263,8,3271,0.24,8 - Maldaha Dakshin (West Bengal),25,8
11.0,KAVIR MADAN DAS,Ambedkarite Party of India,3137,3,3140,0.23,8 - Maldaha Dakshin (West Bengal),25,8
12.0,ASIM MANDAL,Jan Sangh Party,2786,2,2788,0.2,8 - Maldaha Dakshin (West Bengal),25,8
13.0,MD SHAHNAWAJ RAHMATULLAH,Social Democratic Party Of India,2315,8,2323,0.17,8 - Maldaha Dakshin (West Bengal),25,8
14.0,JALALUDDIN SARKAR,Bharatiya Nyay-Adhikar Raksha Party,2075,-,2075,0.15,8 - Maldaha Dakshin (West Bengal),25,8
15.0,ANGSHUDHAR MANDAL,Socialist Unity Centre Of India (COMMUNIST),1178,11,1189,0.09,8 - Maldaha Dakshin (West Bengal),25,8
16.0,MD NUR ISLAM SEKH,Rashtriya Secular Majlis Party,1130,6,1136,0.08,8 - Maldaha Dakshin (West Bengal),25,8
17.0,MD MONIRUL HASAN,Jamat-E-Seratul Mustakim,737,4,741,0.05,8 - Maldaha Dakshin (West Bengal),25,8
18.0,NOTA,None of the Above,2759,38,2797,0.2,8 - Maldaha Dakshin (West Bengal),25,8
,Total,,1364552,5237,1369789,,8 - Maldaha Dakshin (West Bengal),25,8
1.0,KHALILUR RAHAMAN,All India Trinamool Congress,543449,978,544427,39.75,9 - Jangipur (West Bengal),25,9
2.0,MURTOJA HOSSAIN BOKUL,Indian National Congress,427105,685,427790,31.23,9 - Jangipur (West Bengal),25,9
3.0,DHANANJAY GHOSH,Bharatiya Janata Party,339868,946,340814,24.88,9 - Jangipur (West Bengal),25,9
4.0,REJAUL MONDAL,Independent,7500,-,7500,0.55,9 - Jangipur (West Bengal),25,9
5.0,SAJAHAN BISWAS,All India Secular Front,6847,11,6858,0.5,9 - Jangipur (West Bengal),25,9
6.0,MUKTIPADA KONAI,Independent,5670,1,5671,0.41,9 - Jangipur (West Bengal),25,9
7.0,ASHISH BHUIMALI,Independent,3949,2,3951,0.29,9 - Jangipur (West Bengal),25,9
8.0,MD SARWARUL ISLAM SARKAR,Bahujan Samaj Party,3511,4,3515,0.26,9 - Jangipur (West Bengal),25,9
9.0,MD SAHABUDDIN,Social Democratic Party Of India,3489,7,3496,0.26,9 - Jangipur (West Bengal),25,9
10.0,SAMIRUDDIN,Socialist Unity Centre Of India (COMMUNIST),1946,4,1950,0.14,9 - Jangipur (West Bengal),25,9
11.0,PARIMAL GHOSH,Independent,1928,3,1931,0.14,9 - Jangipur (West Bengal),25,9
12.0,SANUAR ALI,Bharatheeya Jawan Kisan Party,1698,2,1700,0.12,9 - Jangipur (West Bengal),25,9
13.0,RAJIB CHATTERJEE,Bhartiya Lokmat Rashtrwadi Party,1527,5,1532,0.11,9 - Jangipur (West Bengal),25,9
14.0,MD ASADUL BISWAS,Independent,1340,-,1340,0.1,9 - Jangipur (West Bengal),25,9
15.0,NOTA,None of the Above,17135,23,17158,1.25,9 - Jangipur (West Bengal),25,9
,Total,,1366962,2671,1369633,,9 - Jangipur (West Bengal),25,9
1.0,PATHAN YUSUF,All India Trinamool Congress,523630,886,524516,37.88,10 - Baharampur (West Bengal),25,10
2.0,ADHIR RANJAN CHOWDHURY,Indian National Congress,438171,1323,439494,31.74,10 - Baharampur (West Bengal),25,10
3.0,DR. NIRMAL KUMAR SAHA,Bharatiya Janata Party,370370,1515,371885,26.86,10 - Baharampur (West Bengal),25,10
4.0,SAMIRAN DAS,Independent,18526,1,18527,1.34,10 - Baharampur (West Bengal),25,10
5.0,SWAPAN KUMAR MANDAL,Independent,6394,2,6396,0.46,10 - Baharampur (West Bengal),25,10
6.0,SANTOSH BISWAS,Bahujan Samaj Party,4219,19,4238,0.31,10 - Baharampur (West Bengal),25,10
7.0,BISWAMVOIR KALITA,Independent,3060,2,3062,0.22,10 - Baharampur (West Bengal),25,10
8.0,SOMNATH PAUL,All India Arya Mahasabha,2250,-,2250,0.16,10 - Baharampur (West Bengal),25,10
9.0,RUNA LAILA,Social Democratic Party Of India,1569,2,1571,0.11,10 - Baharampur (West Bengal),25,10
10.0,ABHIJIT MANDAL,Socialist Unity Centre Of India (COMMUNIST),1410,8,1418,0.1,10 - Baharampur (West Bengal),25,10
11.0,ASHIS DAS,Independent,1106,4,1110,0.08,10 - Baharampur (West Bengal),25,10
12.0,ADHIR SWARNAKAR,Independent,851,5,856,0.06,10 - Baharampur (West Bengal),25,10
13.0,AJIT KUMAR MANDAL,Independent,745,4,749,0.05,10 - Baharampur (West Bengal),25,10
14.0,MANIK KUMAR DAS,Jai Prakash Janata Dal,729,-,729,0.05,10 - Baharampur (West Bengal),25,10
15.0,AABDUSA SATTAR SEKH,Indian National Socialistic Action Forces,477,7,484,0.03,10 - Baharampur (West Bengal),25,10
16.0,NOTA,None of the Above,7474,11,7485,0.54,10 - Baharampur (West Bengal),25,10
,Total,,1380981,3789,1384770,,10 - Baharampur (West Bengal),25,10
1.0,ABU TAHER KHAN,All India Trinamool Congress,681674,768,682442,44.27,11 - Murshidabad (West Bengal),25,11
2.0,MD SALIM,Communist Party of India (Marxist),517733,494,518227,33.62,11 - Murshidabad (West Bengal),25,11
3.0,GOURI SANKAR GHOSH,Bharatiya Janata Party,291013,1018,292031,18.94,11 - Murshidabad (West Bengal),25,11
4.0,HABIB SAIKH,All India Secular Front,12359,11,12370,0.8,11 - Murshidabad (West Bengal),25,11
5.0,ASIM RAY,Bhartiya Lokmat Rashtrwadi Party,5522,12,5534,0.36,11 - Murshidabad (West Bengal),25,11
6.0,SAHABUDDIN MALLIK,Independent,4156,-,4156,0.27,11 - Murshidabad (West Bengal),25,11
7.0,RAFIKUL ISLAM,Independent,4064,1,4065,0.26,11 - Murshidabad (West Bengal),25,11
8.0,MAHAFUJUL ALAM,Socialist Unity Centre Of India (COMMUNIST),3423,3,3426,0.22,11 - Murshidabad (West Bengal),25,11
9.0,MD TAIEDUL ISLAM,Social Democratic Party Of India,3291,2,3293,0.21,11 - Murshidabad (West Bengal),25,11
10.0,DHANANJOY SARKAR,Independent,1535,4,1539,0.1,11 - Murshidabad (West Bengal),25,11
11.0,KRISHNA PROSAD BISWAS,Independent,1197,9,1206,0.08,11 - Murshidabad (West Bengal),25,11
12.0,NOTA,None of the Above,13249,21,13270,0.86,11 - Murshidabad (West Bengal),25,11
,Total,,1539216,2343,1541559,,11 - Murshidabad (West Bengal),25,11
1.0,MAHUA MOITRA,All India Trinamool Congress,624711,4078,628789,44.1,12 - Krishnanagar (West Bengal),25,12
2.0,AMRITA ROY,Bharatiya Janata Party,567628,4456,572084,40.13,12 - Krishnanagar (West Bengal),25,12
3.0,S.M. SADI,Communist Party of India (Marxist),179063,1138,180201,12.64,12 - Krishnanagar (West Bengal),25,12
4.0,SANJIT BISWAS,Independent,8660,11,8671,0.61,12 - Krishnanagar (West Bengal),25,12
5.0,SOURAV HELA,Independent,5061,4,5065,0.36,12 - Krishnanagar (West Bengal),25,12
6.0,NEMAI BISWAS,Independent,5047,22,5069,0.36,12 - Krishnanagar (West Bengal),25,12
7.0,AMAL CHANDRA SARKAR,Bahujan Samaj Party,5045,55,5100,0.36,12 - Krishnanagar (West Bengal),25,12
8.0,AFROJA KHATUN MONDAL,All India Secular Front,4284,14,4298,0.3,12 - Krishnanagar (West Bengal),25,12
9.0,ISMAT ARA MONDAL,Socialist Unity Centre Of India (COMMUNIST),3603,19,3622,0.25,12 - Krishnanagar (West Bengal),25,12
10.0,MD. MUKTAR SHAIKH,Independent,3287,7,3294,0.23,12 - Krishnanagar (West Bengal),25,12
11.0,ALIK KUMAR KUNDU,Independent,2699,9,2708,0.19,12 - Krishnanagar (West Bengal),25,12
12.0,NOTA,None of the Above,6754,57,6811,0.48,12 - Krishnanagar (West Bengal),25,12
,Total,,1415842,9870,1425712,,12 - Krishnanagar (West Bengal),25,12
1.0,JAGANNATH SARKAR,Bharatiya Janata Party,778046,4350,782396,50.78,13 - Ranaghat (West Bengal),25,13
2.0,MUKUT MANI ADHIKARI,All India Trinamool Congress,592276,3221,595497,38.65,13 - Ranaghat (West Bengal),25,13
3.0,ALAKESH DAS,Communist Party of India (Marxist),122970,840,123810,8.04,13 - Ranaghat (West Bengal),25,13
4.0,BIPLAB BISWAS,Bahujan Samaj Party,9319,73,9392,0.61,13 - Ranaghat (West Bengal),25,13
5.0,PARESH HALDAR,Socialist Unity Centre Of India (COMMUNIST),8223,16,8239,0.53,13 - Ranaghat (West Bengal),25,13
6.0,JAGANNATH SARKAR,Independent,5831,30,5861,0.38,13 - Ranaghat (West Bengal),25,13
7.0,SHYAMAL KUMAR MALLICK,Independent,5533,11,5544,0.36,13 - Ranaghat (West Bengal),25,13
8.0,NOTA,None of the Above,9798,95,9893,0.64,13 - Ranaghat (West Bengal),25,13
,Total,,1531996,8636,1540632,,13 - Ranaghat (West Bengal),25,13
1.0,SHANTANU THAKUR,Bharatiya Janata Party,716952,2553,719505,48.19,14 - Bangaon (West Bengal),25,14
2.0,BISWAJIT DAS S/O LATE BIJAY KRISHNA DAS,All India Trinamool Congress,643653,2159,645812,43.25,14 - Bangaon (West Bengal),25,14
3.0,PRADIPKUMAR BISWAS,Indian National Congress,64859,317,65176,4.37,14 - Bangaon (West Bengal),25,14
4.0,DIPAK MAJUMDAR,All India Secular Front,19199,17,19216,1.29,14 - Bangaon (West Bengal),25,14
5.0,SUJATA BAIRAGI,Independent,9649,4,9653,0.65,14 - Bangaon (West Bengal),25,14
6.0,JASHAJIT SARKHEL,Independent,7829,4,7833,0.52,14 - Bangaon (West Bengal),25,14
7.0,CHANDAN MALLICK,Bahujan Samaj Party,5905,30,5935,0.4,14 - Bangaon (West Bengal),25,14
8.0,PRANITA MANDAL,Independent,2407,4,2411,0.16,14 - Bangaon (West Bengal),25,14
9.0,SUMITA PODDAR,Independent,2347,7,2354,0.16,14 - Bangaon (West Bengal),25,14
10.0,BISWAJIT DAS S/O LATE BALARAM DAS,Independent,2241,7,2248,0.15,14 - Bangaon (West Bengal),25,14
11.0,PATIT PABAN MANDAL,Socialist Unity Centre Of India (COMMUNIST),2140,29,2169,0.15,14 - Bangaon (West Bengal),25,14
12.0,SAMARESH BISWAS,Party for Democratic Socialism,1562,3,1565,0.1,14 - Bangaon (West Bengal),25,14
13.0,BISWAJIT DAS,Independent,1257,15,1272,0.09,14 - Bangaon (West Bengal),25,14
14.0,KALYAN SARKAR,Independent,676,15,691,0.05,14 - Bangaon (West Bengal),25,14
15.0,SUBRATA BISWAS,Guruchand Sena Dal,581,2,583,0.04,14 - Bangaon (West Bengal),25,14
16.0,NOTA,None of the Above,6635,50,6685,0.45,14 - Bangaon (West Bengal),25,14
,Total,,1487892,5216,1493108,,14 - Bangaon (West Bengal),25,14
1.0,PARTHA BHOWMICK,All India Trinamool Congress,518486,1745,520231,45.56,15 - Barrackpur (West Bengal),25,15
2.0,ARJUN SINGH,Bharatiya Janata Party,454184,1609,455793,39.92,15 - Barrackpur (West Bengal),25,15
3.0,DEBDUT GHOSH,Communist Party of India (Marxist),109038,526,109564,9.6,15 - Barrackpur (West Bengal),25,15
4.0,MD JAMIR HOSSAIN,All India Secular Front,18797,9,18806,1.65,15 - Barrackpur (West Bengal),25,15
5.0,ROHIT KUMAR PATHAK,Independent,7116,16,7132,0.62,15 - Barrackpur (West Bengal),25,15
6.0,CHAPALA RAY (MAJUMDER),Bahujan Samaj Party,3882,27,3909,0.34,15 - Barrackpur (West Bengal),25,15
7.0,SHARMISTHA DAS,Independent,3622,12,3634,0.32,15 - Barrackpur (West Bengal),25,15
8.0,ANJAN GOSWAMI,Bharatiya Nyay-Adhikar Raksha Party,3434,14,3448,0.3,15 - Barrackpur (West Bengal),25,15
9.0,DHARMENDRA SINGH,Independent,2843,4,2847,0.25,15 - Barrackpur (West Bengal),25,15
10.0,SANJAY SINGH,Independent,1670,6,1676,0.15,15 - Barrackpur (West Bengal),25,15
11.0,DEBASISH BANERJEE,Socialist Unity Centre Of India (COMMUNIST),1422,12,1434,0.13,15 - Barrackpur (West Bengal),25,15
12.0,KUNDAN SINGH,Independent,820,6,826,0.07,15 - Barrackpur (West Bengal),25,15
13.0,UDAY VEER CHOUDHURY,Independent,745,12,757,0.07,15 - Barrackpur (West Bengal),25,15
14.0,AMIT KUMAR CHOUBEY,Independent,717,4,721,0.06,15 - Barrackpur (West Bengal),25,15
15.0,NOTA,None of the Above,11043,39,11082,0.97,15 - Barrackpur (West Bengal),25,15
,Total,,1137819,4041,1141860,,15 - Barrackpur (West Bengal),25,15
1.0,SOUGATA RAY,All India Trinamool Congress,526289,2290,528579,41.95,16 - Dum dum (West Bengal),25,16
2.0,SILBHADRA DATTA,Bharatiya Janata Party,456138,1781,457919,36.34,16 - Dum dum (West Bengal),25,16
3.0,SUJAN CHAKRABORTY,Communist Party of India (Marxist),239418,1366,240784,19.11,16 - Dum dum (West Bengal),25,16
4.0,SHEKH IMANUR RAHMAN,Independent,6410,1,6411,0.51,16 - Dum dum (West Bengal),25,16
5.0,SWAMINATH KORI,Bahujan Samaj Party,3749,17,3766,0.3,16 - Dum dum (West Bengal),25,16
6.0,HIRAK SINHA,Independent,3144,3,3147,0.25,16 - Dum dum (West Bengal),25,16
7.0,BANAMALI PANDA,Socialist Unity Centre Of India (COMMUNIST),1728,11,1739,0.14,16 - Dum dum (West Bengal),25,16
8.0,DULU DEY,Independent,1688,6,1694,0.13,16 - Dum dum (West Bengal),25,16
9.0,MANIKA MUKHERJEE,Bharatiya Nyay-Adhikar Raksha Party,1231,6,1237,0.1,16 - Dum dum (West Bengal),25,16
10.0,SANTANU MANDAL,Democratic Socialist Party of India,880,5,885,0.07,16 - Dum dum (West Bengal),25,16
11.0,TRIDIB BHUNIA,Independent,765,7,772,0.06,16 - Dum dum (West Bengal),25,16
12.0,GOURI BISWAS,Independent,698,3,701,0.06,16 - Dum dum (West Bengal),25,16
13.0,SUBRATA BHOWMIK,Mera Bharat Mahan Party,602,2,604,0.05,16 - Dum dum (West Bengal),25,16
14.0,HARI PADA BISWAS,Mulnibasi Party of India,465,9,474,0.04,16 - Dum dum (West Bengal),25,16
15.0,NOTA,None of the Above,11256,78,11334,0.9,16 - Dum dum (West Bengal),25,16
,Total,,1254461,5585,1260046,,16 - Dum dum (West Bengal),25,16
1.0,KAKOLI GHOSH DASTIDAR,All India Trinamool Congress,689513,2497,692010,45.15,17 - Barasat (West Bengal),25,17
2.0,SWAPAN MAJUMDER,Bharatiya Janata Party,576024,1797,577821,37.7,17 - Barasat (West Bengal),25,17
3.0,TAPAS BANERJEE,All India Secular Front,121355,85,121440,7.92,17 - Barasat (West Bengal),25,17
4.0,SANJIB CHATTERJEE,All India Forward Bloc,99456,544,100000,6.52,17 - Barasat (West Bengal),25,17
5.0,SMRITIKANA HAOLADAR,Bahujan Samaj Party,5759,28,5787,0.38,17 - Barasat (West Bengal),25,17
6.0,SAIFUDDIN MONDAL,Independent,3823,4,3827,0.25,17 - Barasat (West Bengal),25,17
7.0,SWAPAN MAJUMDAR,Independent,3083,2,3085,0.2,17 - Barasat (West Bengal),25,17
8.0,S MUKHTAR AHMED,Independent,2639,8,2647,0.17,17 - Barasat (West Bengal),25,17
9.0,SEFALI DEY,Bharatiya Nyay-Adhikar Raksha Party,2244,8,2252,0.15,17 - Barasat (West Bengal),25,17
10.0,SADHAN GHOSH,Socialist Unity Centre Of India (COMMUNIST),2025,22,2047,0.13,17 - Barasat (West Bengal),25,17
11.0,BIKASH SARKAR,Mulnibasi Party of India,1928,1,1929,0.13,17 - Barasat (West Bengal),25,17
12.0,MOHAN LAL ADHIKARY,Independent,1850,14,1864,0.12,17 - Barasat (West Bengal),25,17
13.0,NOTA,None of the Above,17834,58,17892,1.17,17 - Barasat (West Bengal),25,17
,Total,,1527533,5068,1532601,,17 - Barasat (West Bengal),25,17
1.0,SK NURUL ISLAM,All India Trinamool Congress,801542,2220,803762,52.76,18 - Basirhat (West Bengal),25,18
2.0,REKHA PATRA,Bharatiya Janata Party,468593,1622,470215,30.87,18 - Basirhat (West Bengal),25,18
3.0,AKHTAR RAHAMAN BISWAS,All India Secular Front,123432,68,123500,8.11,18 - Basirhat (West Bengal),25,18
4.0,NIRAPADA SARDAR,Communist Party of India (Marxist),77611,288,77899,5.11,18 - Basirhat (West Bengal),25,18
5.0,MAFIJUL MOLLA,Independent,11833,-,11833,0.78,18 - Basirhat (West Bengal),25,18
6.0,PRIYAMA DAS,Independent,6606,14,6620,0.43,18 - Basirhat (West Bengal),25,18
7.0,MIRAZ MOLLA,Independent,5902,-,5902,0.39,18 - Basirhat (West Bengal),25,18
8.0,MD ABUL KALAM MOLLA,Bahujan Samaj Party,4451,13,4464,0.29,18 - Basirhat (West Bengal),25,18
9.0,BIDYUT GAYEN,Independent,3625,9,3634,0.24,18 - Basirhat (West Bengal),25,18
10.0,IMRAN ALI SARDAR,Bharatheeya Jawan Kisan Party,2548,5,2553,0.17,18 - Basirhat (West Bengal),25,18
11.0,PIYARUL ISLAM,Independent,2388,3,2391,0.16,18 - Basirhat (West Bengal),25,18
12.0,SARAVAN SINGH,Independent,2020,1,2021,0.13,18 - Basirhat (West Bengal),25,18
13.0,DAUD ALI GAZI,Socialist Unity Centre Of India (COMMUNIST),1163,4,1167,0.08,18 - Basirhat (West Bengal),25,18
14.0,KINKAR KANTI ROY,Independent,1115,3,1118,0.07,18 - Basirhat (West Bengal),25,18
15.0,BIPUL CHANDRA BISWAS,Mulnibasi Party of India,1070,4,1074,0.07,18 - Basirhat (West Bengal),25,18
16.0,NOTA,None of the Above,5229,19,5248,0.34,18 - Basirhat (West Bengal),25,18
,Total,,1519128,4273,1523401,,18 - Basirhat (West Bengal),25,18
1.0,PRATIMA MONDAL,All India Trinamool Congress,891053,3259,894312,60.32,19 - Joynagar (West Bengal),25,19
2.0,ASHOK KANDARY,Bharatiya Janata Party,422546,1547,424093,28.6,19 - Joynagar (West Bengal),25,19
3.0,MEGHNATH HALDER,All India Secular Front,65316,56,65372,4.41,19 - Joynagar (West Bengal),25,19
4.0,SAMARENDRA NATH MONDAL,Revolutionary Socialist Party,39927,186,40113,2.71,19 - Joynagar (West Bengal),25,19
5.0,NIRANJAN NASKAR,Socialist Unity Centre Of India (COMMUNIST),14547,75,14622,0.99,19 - Joynagar (West Bengal),25,19
6.0,SUJAN SARDAR,Independent,10779,15,10794,0.73,19 - Joynagar (West Bengal),25,19
7.0,SINDHUPADA BAIRAGI,Independent,9150,12,9162,0.62,19 - Joynagar (West Bengal),25,19
8.0,SHANKAR DEB MONDAL,Bahujan Samaj Party,6363,28,6391,0.43,19 - Joynagar (West Bengal),25,19
9.0,JURAN CHANDRA PANDEY,Mulnibasi Party of India,3750,19,3769,0.25,19 - Joynagar (West Bengal),25,19
10.0,MILAN NASKAR,Independent,2129,7,2136,0.14,19 - Joynagar (West Bengal),25,19
11.0,PRATIMA MONDAL,Independent,2052,27,2079,0.14,19 - Joynagar (West Bengal),25,19
12.0,NOTA,None of the Above,9756,32,9788,0.66,19 - Joynagar (West Bengal),25,19
,Total,,1477368,5263,1482631,,19 - Joynagar (West Bengal),25,19
1.0,BAPI HALDAR,All India Trinamool Congress,752486,3245,755731,50.52,20 - Mathurapur (West Bengal),25,20
2.0,ASHOK PURKAIT,Bharatiya Janata Party,552798,1876,554674,37.08,20 - Mathurapur (West Bengal),25,20
3.0,AJAY KUMAR DAS,All India Secular Front,87530,76,87606,5.86,20 - Mathurapur (West Bengal),25,20
4.0,DR SARAT CHANDRA HALDER,Communist Party of India (Marxist),60778,322,61100,4.08,20 - Mathurapur (West Bengal),25,20
5.0,BAPI HALDER,Independent,8922,12,8934,0.6,20 - Mathurapur (West Bengal),25,20
6.0,BAPI HALDAR,Independent,5607,19,5626,0.38,20 - Mathurapur (West Bengal),25,20
7.0,BISWANATH SARDAR,Socialist Unity Centre Of India (COMMUNIST),4505,29,4534,0.3,20 - Mathurapur (West Bengal),25,20
8.0,PANKAJ KUMAR HALDER,Bahujan Samaj Party,4238,19,4257,0.28,20 - Mathurapur (West Bengal),25,20
9.0,ASHOKE PUROKAIT,Independent,1489,12,1501,0.1,20 - Mathurapur (West Bengal),25,20
10.0,ASHOKE SARDAR,Independent,1474,27,1501,0.1,20 - Mathurapur (West Bengal),25,20
11.0,BAPPA DAS,Party for Democratic Socialism,1203,6,1209,0.08,20 - Mathurapur (West Bengal),25,20
12.0,RUDRA PRASAD MANDAL,Mulnibasi Party of India,707,13,720,0.05,20 - Mathurapur (West Bengal),25,20
13.0,NOTA,None of the Above,8593,38,8631,0.58,20 - Mathurapur (West Bengal),25,20
,Total,,1490330,5694,1496024,,20 - Mathurapur (West Bengal),25,20
1.0,ABHISHEK BANERJEE,All India Trinamool Congress,1043493,4737,1048230,68.48,21 - Diamond harbour (West Bengal),25,21
2.0,ABHIJIT DAS (BOBBY),Bharatiya Janata Party,336068,1232,337300,22.03,21 - Diamond harbour (West Bengal),25,21
3.0,PRATIK UR RAHAMAN,Communist Party of India (Marxist),86507,446,86953,5.68,21 - Diamond harbour (West Bengal),25,21
4.0,MAJNU LASKAR,All India Secular Front,21109,30,21139,1.38,21 - Diamond harbour (West Bengal),25,21
5.0,SUBRATA BOSE,Independent,9819,6,9825,0.64,21 - Diamond harbour (West Bengal),25,21
6.0,DASARATHI PAIK,Bahujan Samaj Party,7082,29,7111,0.46,21 - Diamond harbour (West Bengal),25,21
7.0,MALAY GUHA ROY,Independent,2963,8,2971,0.19,21 - Diamond harbour (West Bengal),25,21
8.0,PULAKESH MONDAL,Independent,1945,3,1948,0.13,21 - Diamond harbour (West Bengal),25,21
9.0,KALIMUDDIN SK,Indian National Socialistic Action Forces,1579,11,1590,0.1,21 - Diamond harbour (West Bengal),25,21
10.0,RAMKUMAR MONDAL,Socialist Unity Centre Of India (COMMUNIST),1411,7,1418,0.09,21 - Diamond harbour (West Bengal),25,21
11.0,ANISUR RAHAMAN SK,Independent,1152,7,1159,0.08,21 - Diamond harbour (West Bengal),25,21
12.0,KASHINATH MONDAL,Independent,961,24,985,0.06,21 - Diamond harbour (West Bengal),25,21
13.0,NOTA,None of the Above,10134,54,10188,0.67,21 - Diamond harbour (West Bengal),25,21
,Total,,1524223,6594,1530817,,21 - Diamond harbour (West Bengal),25,21
1.0,SAYANI GHOSH,All India Trinamool Congress,714049,3850,717899,45.83,22 - Jadavpur (West Bengal),25,22
2.0,DR. ANIRBAN GANGULY,Bharatiya Janata Party,457307,2391,459698,29.35,22 - Jadavpur (West Bengal),25,22
3.0,SRIJAN BHATTACHARYYA,Communist Party of India (Marxist),256951,1761,258712,16.52,22 - Jadavpur (West Bengal),25,22
4.0,NUR ALAM KHAN,All India Secular Front,83291,71,83362,5.32,22 - Jadavpur (West Bengal),25,22
5.0,RANJIT KUMAR MANDAL,Independent,13021,9,13030,0.83,22 - Jadavpur (West Bengal),25,22
6.0,HOSEN GAZI,Independent,4925,2,4927,0.31,22 - Jadavpur (West Bengal),25,22
7.0,SANDIP NATH,Bahujan Samaj Party,4434,28,4462,0.28,22 - Jadavpur (West Bengal),25,22
8.0,KALPANA NASKAR DATTA,Socialist Unity Centre Of India (COMMUNIST),4416,35,4451,0.28,22 - Jadavpur (West Bengal),25,22
9.0,BALARAM MANDAL,Independent,2829,6,2835,0.18,22 - Jadavpur (West Bengal),25,22
10.0,TANUSHREE MONDAL,Independent,2419,8,2427,0.15,22 - Jadavpur (West Bengal),25,22
11.0,SHANKAR MANDAL,Independent,1439,3,1442,0.09,22 - Jadavpur (West Bengal),25,22
12.0,SRI GOPAN SARDAR,Mulnibasi Party of India,1366,7,1373,0.09,22 - Jadavpur (West Bengal),25,22
13.0,PURNIMA DEBNATH,Independent,1301,24,1325,0.08,22 - Jadavpur (West Bengal),25,22
14.0,CHANDRACHUR GOSWAMI,Independent,1112,2,1114,0.07,22 - Jadavpur (West Bengal),25,22
15.0,ARUN SARKAR,Independent,1107,3,1110,0.07,22 - Jadavpur (West Bengal),25,22
16.0,DIPAK SARDAR,Independent,924,3,927,0.06,22 - Jadavpur (West Bengal),25,22
17.0,NOTA,None of the Above,7316,99,7415,0.47,22 - Jadavpur (West Bengal),25,22
,Total,,1558207,8302,1566509,,22 - Jadavpur (West Bengal),25,22
1.0,MALA ROY,All India Trinamool Congress,612725,2549,615274,49.48,23 - Kolkata Dakshin (West Bengal),25,23
2.0,DEBASREE CHAUDHURI,Bharatiya Janata Party,426459,1584,428043,34.42,23 - Kolkata Dakshin (West Bengal),25,23
3.0,SAIRA SHAH HALIM,Communist Party of India (Marxist),167771,760,168531,13.55,23 - Kolkata Dakshin (West Bengal),25,23
4.0,NIRAJ AGARWAL,Independent,4028,4,4032,0.32,23 - Kolkata Dakshin (West Bengal),25,23
5.0,FIROZA KHATUN,Bahujan Samaj Party,3958,17,3975,0.32,23 - Kolkata Dakshin (West Bengal),25,23
6.0,SANTANU ROY,Independent,2918,2,2920,0.23,23 - Kolkata Dakshin (West Bengal),25,23
7.0,ZUBAIR RABBANI,Socialist Unity Centre Of India (COMMUNIST),2290,10,2300,0.18,23 - Kolkata Dakshin (West Bengal),25,23
8.0,SUSANTA MONDAL,Independent,2090,1,2091,0.17,23 - Kolkata Dakshin (West Bengal),25,23
9.0,MUMTAZ ALI,Independent,1960,9,1969,0.16,23 - Kolkata Dakshin (West Bengal),25,23
10.0,MUKTI,Right to Recall Party,1537,7,1544,0.12,23 - Kolkata Dakshin (West Bengal),25,23
11.0,SANJOY (RANA) CHANDA,Kisan Mazdoor Sangharsh Party,1186,7,1193,0.1,23 - Kolkata Dakshin (West Bengal),25,23
12.0,SANJANA RAM,Independent,1052,4,1056,0.08,23 - Kolkata Dakshin (West Bengal),25,23
13.0,YASMIN ISLAM,Social Democratic Party Of India,981,4,985,0.08,23 - Kolkata Dakshin (West Bengal),25,23
14.0,ATANU DAS,Independent,969,2,971,0.08,23 - Kolkata Dakshin (West Bengal),25,23
15.0,MRIDUL OJHA,Independent,856,6,862,0.07,23 - Kolkata Dakshin (West Bengal),25,23
16.0,DIPENDU HAZRA,Independent,794,10,804,0.06,23 - Kolkata Dakshin (West Bengal),25,23
17.0,MD. SHAKIL WARSI,Independent,503,1,504,0.04,23 - Kolkata Dakshin (West Bengal),25,23
18.0,NOTA,None of the Above,6348,75,6423,0.52,23 - Kolkata Dakshin (West Bengal),25,23
,Total,,1238425,5052,1243477,,23 - Kolkata Dakshin (West Bengal),25,23
1.0,BANDYOPADHYAY SUDIP,All India Trinamool Congress,453177,1519,454696,47.44,24 - Kolkata Uttar (West Bengal),25,24
2.0,TAPAS ROY,Bharatiya Janata Party,361268,868,362136,37.78,24 - Kolkata Uttar (West Bengal),25,24
3.0,PRADIP BHATTACHARYA,Indian National Congress,114556,426,114982,12.0,24 - Kolkata Uttar (West Bengal),25,24
4.0,DR. BIPLAB CHANDRA,Socialist Unity Centre Of India (COMMUNIST),3640,18,3658,0.38,24 - Kolkata Uttar (West Bengal),25,24
5.0,OMPRAKASH PRAJAPATI,Bahujan Samaj Party,3133,47,3180,0.33,24 - Kolkata Uttar (West Bengal),25,24
6.0,PRANATI PAUL,Independent,2267,5,2272,0.24,24 - Kolkata Uttar (West Bengal),25,24
7.0,SURENDRA KUMAR KABRA,Independent,1317,5,1322,0.14,24 - Kolkata Uttar (West Bengal),25,24
8.0,SWAPAN DAS,Independent,1163,3,1166,0.12,24 - Kolkata Uttar (West Bengal),25,24
9.0,MISBAHUS SALAM,Independent,975,6,981,0.1,24 - Kolkata Uttar (West Bengal),25,24
10.0,SAMPA GUHA,Bharatiya Nyay-Adhikar Raksha Party,912,4,916,0.1,24 - Kolkata Uttar (West Bengal),25,24
11.0,RAJKUMAR PALIT,Mission Naya Digant Party,768,4,772,0.08,24 - Kolkata Uttar (West Bengal),25,24
12.0,SMT. RINKU GUPTA,Pyramid Party of India,649,10,659,0.07,24 - Kolkata Uttar (West Bengal),25,24
13.0,AMAL KUMAR DEY,Independent,582,9,591,0.06,24 - Kolkata Uttar (West Bengal),25,24
14.0,ANUJIT KUMAR NAN,Independent,555,2,557,0.06,24 - Kolkata Uttar (West Bengal),25,24
15.0,BINOY KRISHNA CHATTERJEE,Independent,500,1,501,0.05,24 - Kolkata Uttar (West Bengal),25,24
16.0,NOTA,None of the Above,10004,40,10044,1.05,24 - Kolkata Uttar (West Bengal),25,24
,Total,,955466,2967,958433,,24 - Kolkata Uttar (West Bengal),25,24
1.0,PRASUN BANERJEE,All India Trinamool Congress,625229,1264,626493,49.26,25 - Howrah (West Bengal),25,25
2.0,DR RATHIN CHAKRAVARTY,Bharatiya Janata Party,455996,1055,457051,35.94,25 - Howrah (West Bengal),25,25
3.0,SABYASACHI CHATTERJEE,Communist Party of India (Marxist),151483,522,152005,11.95,25 - Howrah (West Bengal),25,25
4.0,PALASH BACHAR,Bahujan Samaj Party,6342,12,6354,0.5,25 - Howrah (West Bengal),25,25
5.0,SEIKH SAKIRUL ISLAM,Independent,5271,-,5271,0.41,25 - Howrah (West Bengal),25,25
6.0,SHIWA MALLICK,Independent,3218,2,3220,0.25,25 - Howrah (West Bengal),25,25
7.0,UTTAM CHATTERJEE,Socialist Unity Centre Of India (COMMUNIST),2319,6,2325,0.18,25 - Howrah (West Bengal),25,25
8.0,SHAMPA DAS,Bharatiya Nyay-Adhikar Raksha Party,2053,12,2065,0.16,25 - Howrah (West Bengal),25,25
9.0,RATHIN GANGULY,Independent,1884,3,1887,0.15,25 - Howrah (West Bengal),25,25
10.0,PRASUN LAHIRI,Independent,1323,3,1326,0.1,25 - Howrah (West Bengal),25,25
11.0,RAJESH KUMAR PRASAD,All India Arya Mahasabha,1268,4,1272,0.1,25 - Howrah (West Bengal),25,25
12.0,ADARSHA MONDAL,Independent,939,6,945,0.07,25 - Howrah (West Bengal),25,25
13.0,AJAZ AHMED ANSARI,Independent,856,1,857,0.07,25 - Howrah (West Bengal),25,25
14.0,TAPAS BARUI,Independent,637,4,641,0.05,25 - Howrah (West Bengal),25,25
15.0,NOTA,None of the Above,10036,48,10084,0.79,25 - Howrah (West Bengal),25,25
,Total,,1268854,2942,1271796,,25 - Howrah (West Bengal),25,25
1.0,SAJDA AHMED,All India Trinamool Congress,722586,2036,724622,52.1,26 - Uluberia (West Bengal),25,26
2.0,ARUNUDAY PAULCHOWDHURY,Bharatiya Janata Party,504611,1338,505949,36.38,26 - Uluberia (West Bengal),25,26
3.0,AZAHAR MOLLICK,Indian National Congress,78304,285,78589,5.65,26 - Uluberia (West Bengal),25,26
4.0,MOFIKUL ISLAM,All India Secular Front,38971,20,38991,2.8,26 - Uluberia (West Bengal),25,26
5.0,ARIT KARAK,Independent,7287,5,7292,0.52,26 - Uluberia (West Bengal),25,26
6.0,AMAL KUMAR DEYATI,Bharatiya Nyay-Adhikar Raksha Party,5445,6,5451,0.39,26 - Uluberia (West Bengal),25,26
7.0,RAMESH KHANRA,Independent,5094,10,5104,0.37,26 - Uluberia (West Bengal),25,26
8.0,BIMALESH KUMAR HELA,Bahujan Samaj Party,4867,8,4875,0.35,26 - Uluberia (West Bengal),25,26
9.0,SK. SAPIYAR ALI,Independent,2924,-,2924,0.21,26 - Uluberia (West Bengal),25,26
10.0,NIKHIL BERA,Socialist Unity Centre Of India (COMMUNIST),2095,12,2107,0.15,26 - Uluberia (West Bengal),25,26
11.0,AMAL KUMAR BARMAN,Independent,1997,3,2000,0.14,26 - Uluberia (West Bengal),25,26
12.0,RAMPRASAD GHORAI,Indian Unity Centre,1568,4,1572,0.11,26 - Uluberia (West Bengal),25,26
13.0,NOTA,None of the Above,11263,55,11318,0.81,26 - Uluberia (West Bengal),25,26
,Total,,1387012,3782,1390794,,26 - Uluberia (West Bengal),25,26
1.0,KALYAN BANERJEE,All India Trinamool Congress,671865,2105,673970,45.65,27 - Srerampur (West Bengal),25,27
2.0,KABIR SHANKAR BOSE,Bharatiya Janata Party,497720,1420,499140,33.8,27 - Srerampur (West Bengal),25,27
3.0,DIPSITA DHAR,Communist Party of India (Marxist),238131,1015,239146,16.2,27 - Srerampur (West Bengal),25,27
4.0,SAHARIAR MULLICK (BAPI),All India Secular Front,25659,18,25677,1.74,27 - Srerampur (West Bengal),25,27
5.0,SUNDAR PATRA,Independent,9897,5,9902,0.67,27 - Srerampur (West Bengal),25,27
6.0,SASANKA CHAKRABORTY,Independent,3933,5,3938,0.27,27 - Srerampur (West Bengal),25,27
7.0,SUPRIYA BISWAS,Bahujan Samaj Party,3572,17,3589,0.24,27 - Srerampur (West Bengal),25,27
8.0,KALYAN PAUL,Independent,1749,9,1758,0.12,27 - Srerampur (West Bengal),25,27
9.0,PRADYUT CHOWDHURI,Socialist Unity Centre Of India (COMMUNIST),1671,9,1680,0.11,27 - Srerampur (West Bengal),25,27
10.0,KALYAN SAMANTA,Independent,1421,19,1440,0.1,27 - Srerampur (West Bengal),25,27
11.0,SARKAR MANGAL,Bahujan Maha Party,1256,2,1258,0.09,27 - Srerampur (West Bengal),25,27
12.0,NOTA,None of the Above,14964,70,15034,1.02,27 - Srerampur (West Bengal),25,27
,Total,,1471838,4694,1476532,,27 - Srerampur (West Bengal),25,27
1.0,RACHNA BANERJEE,All India Trinamool Congress,700120,2624,702744,46.31,28 - Hooghly (West Bengal),25,28
2.0,LOCKET CHATTERJEE,Bharatiya Janata Party,623867,2024,625891,41.24,28 - Hooghly (West Bengal),25,28
3.0,MANADIP GHOSH,Communist Party of India (Marxist),139250,669,139919,9.22,28 - Hooghly (West Bengal),25,28
4.0,SURAJIT HEMBRAM,Independent,9257,11,9268,0.61,28 - Hooghly (West Bengal),25,28
5.0,SAMIM ALI MOLLICK,Independent,6555,12,6567,0.43,28 - Hooghly (West Bengal),25,28
6.0,JAMINI BHAR,Bahujan Samaj Party,4684,34,4718,0.31,28 - Hooghly (West Bengal),25,28
7.0,AJANTA SARKAR,Bharatiya National Janata Dal,3619,20,3639,0.24,28 - Hooghly (West Bengal),25,28
8.0,SK KAMALUDDIN,Independent,2755,11,2766,0.18,28 - Hooghly (West Bengal),25,28
9.0,SANCHITA BERA,Independent,2632,17,2649,0.17,28 - Hooghly (West Bengal),25,28
10.0,PABAN MAZUMDER,Socialist Unity Centre Of India (COMMUNIST),2367,13,2380,0.16,28 - Hooghly (West Bengal),25,28
11.0,PRADIP PAL,Bharatiya Nyay-Adhikar Raksha Party,2205,15,2220,0.15,28 - Hooghly (West Bengal),25,28
12.0,MRINAL KANTI DAS,Independent,1387,11,1398,0.09,28 - Hooghly (West Bengal),25,28
13.0,NOTA,None of the Above,13250,102,13352,0.88,28 - Hooghly (West Bengal),25,28
,Total,,1511948,5563,1517511,,28 - Hooghly (West Bengal),25,28
1.0,BAG MITALI,All India Trinamool Congress,710432,2155,712587,45.71,29 - Arambagh (West Bengal),25,29
2.0,ARUP KANTI DIGAR,Bharatiya Janata Party,704124,2064,706188,45.3,29 - Arambagh (West Bengal),25,29
3.0,BIPLAB KUMAR MOITRA,Communist Party of India (Marxist),92073,429,92502,5.93,29 - Arambagh (West Bengal),25,29
4.0,RAGHU MALLIK,Independent,16123,7,16130,1.03,29 - Arambagh (West Bengal),25,29
5.0,SUBIR KUMAR ROY,Bahujan Samaj Party,3807,24,3831,0.25,29 - Arambagh (West Bengal),25,29
6.0,VASKAR MALIK,Independent,3662,3,3665,0.24,29 - Arambagh (West Bengal),25,29
7.0,SUKANTA POREL,Socialist Unity Centre Of India (COMMUNIST),1807,9,1816,0.12,29 - Arambagh (West Bengal),25,29
8.0,BABLU GHANTI,Independent,1610,19,1629,0.1,29 - Arambagh (West Bengal),25,29
9.0,ABHIJIT MAJI,Independent,1600,6,1606,0.1,29 - Arambagh (West Bengal),25,29
10.0,ALOK DOLAI,Independent,1081,13,1094,0.07,29 - Arambagh (West Bengal),25,29
11.0,NOTA,None of the Above,17981,50,18031,1.16,29 - Arambagh (West Bengal),25,29
,Total,,1554300,4779,1559079,,29 - Arambagh (West Bengal),25,29
1.0,ABHIJIT GANGOPADHYAY,Bharatiya Janata Party,761183,4401,765584,48.54,30 - Tamluk (West Bengal),25,30
2.0,DEBANGSHU BHATTACHARYA,All India Trinamool Congress,683955,3896,687851,43.61,30 - Tamluk (West Bengal),25,30
3.0,SAYAN BANERJEE,Communist Party of India (Marxist),84774,615,85389,5.41,30 - Tamluk (West Bengal),25,30
4.0,MOHIUDDIN AHMED MAHI,All India Secular Front,12303,36,12339,0.78,30 - Tamluk (West Bengal),25,30
5.0,SURYANEEL DAS,Independent,6012,2,6014,0.38,30 - Tamluk (West Bengal),25,30
6.0,NARAYAN CHANDRA NAYAK,Socialist Unity Centre Of India (COMMUNIST),5633,49,5682,0.36,30 - Tamluk (West Bengal),25,30
7.0,SABITRI BISHAI,Bahujan Samaj Party,3724,30,3754,0.24,30 - Tamluk (West Bengal),25,30
8.0,DEBAPRASAD JANA,Independent,1460,7,1467,0.09,30 - Tamluk (West Bengal),25,30
9.0,KALIPADA DAS,Independent,947,27,974,0.06,30 - Tamluk (West Bengal),25,30
10.0,NOTA,None of the Above,8223,42,8265,0.52,30 - Tamluk (West Bengal),25,30
,Total,,1568214,9105,1577319,,30 - Tamluk (West Bengal),25,30
1.0,ADHIKARI SOUMENDU,Bharatiya Janata Party,757906,5289,763195,49.85,31 - Kanthi (West Bengal),25,31
2.0,UTTAM BARIK SON OF LATE BIRENDRA BARIK,All India Trinamool Congress,709763,5668,715431,46.73,31 - Kanthi (West Bengal),25,31
3.0,URBASI BANERJEE,Indian National Congress,30737,385,31122,2.03,31 - Kanthi (West Bengal),25,31
4.0,BIDESH BASU MAITY,Independent,5633,21,5654,0.37,31 - Kanthi (West Bengal),25,31
5.0,MANAS PRADHAN,Socialist Unity Centre Of India (COMMUNIST),2489,40,2529,0.17,31 - Kanthi (West Bengal),25,31
6.0,UTTAM BARIK SON OF LATE NARAYAN BARIK,Independent,1963,35,1998,0.13,31 - Kanthi (West Bengal),25,31
7.0,MAKHAN LAL MAHAPATRA,Bahujan Samaj Party,1792,12,1804,0.12,31 - Kanthi (West Bengal),25,31
8.0,MD AHAMADULLAH KHAN,Independent,530,56,586,0.04,31 - Kanthi (West Bengal),25,31
9.0,ARJUN KUMAR MAITY,Independent,504,40,544,0.04,31 - Kanthi (West Bengal),25,31
10.0,NOTA,None of the Above,8075,59,8134,0.53,31 - Kanthi (West Bengal),25,31
,Total,,1519392,11605,1530997,,31 - Kanthi (West Bengal),25,31
1.0,ADHIKARI DEEPAK (DEV),All India Trinamool Congress,834558,3432,837990,52.36,32 - Ghatal (West Bengal),25,32
2.0,DR. HIRANMOY CHATTOPADHYAYA,Bharatiya Janata Party,652098,3024,655122,40.93,32 - Ghatal (West Bengal),25,32
3.0,TAPAN GANGULI,Communist Party of India,74399,509,74908,4.68,32 - Ghatal (West Bengal),25,32
4.0,SOUMEN MADRAJI,Bahujan Samaj Party,7916,25,7941,0.5,32 - Ghatal (West Bengal),25,32
5.0,GOPAL MONDAL,Independent,4238,6,4244,0.27,32 - Ghatal (West Bengal),25,32
6.0,DINESH MAIKAP,Socialist Unity Centre Of India (COMMUNIST),4124,24,4148,0.26,32 - Ghatal (West Bengal),25,32
7.0,SAHEB CHOWDHURY,Independent,3228,9,3237,0.2,32 - Ghatal (West Bengal),25,32
8.0,NOTA,None of the Above,12889,77,12966,0.81,32 - Ghatal (West Bengal),25,32
,Total,,1593450,7106,1600556,,32 - Ghatal (West Bengal),25,32
1.0,KALIPADA SAREN (KHERWAL),All India Trinamool Congress,740132,3346,743478,49.87,33 - Jhargram (West Bengal),25,33
2.0,DR. PRANAT TUDU,Bharatiya Janata Party,566553,2877,569430,38.2,33 - Jhargram (West Bengal),25,33
3.0,SONAMANI TUDU,Communist Party of India (Marxist),76850,452,77302,5.19,33 - Jhargram (West Bengal),25,33
4.0,SURYA SINGH BESRA,Jharkhand People's Party,19408,86,19494,1.31,33 - Jhargram (West Bengal),25,33
5.0,BARUN MAHATO,Independent,12029,58,12087,0.81,33 - Jhargram (West Bengal),25,33
6.0,ARUNKUMAR HANSDA,Bahujan Samaj Party,11949,40,11989,0.8,33 - Jhargram (West Bengal),25,33
7.0,SURENDRANATH SING,Independent,10781,6,10787,0.72,33 - Jhargram (West Bengal),25,33
8.0,RAMANATH ORANG,Independent,7178,10,7188,0.48,33 - Jhargram (West Bengal),25,33
9.0,BIPLAB HEMBRAM,Independent,7156,14,7170,0.48,33 - Jhargram (West Bengal),25,33
10.0,BAPI SOREN,All India Secular Front,5854,41,5895,0.4,33 - Jhargram (West Bengal),25,33
11.0,BIRSABIR BASKEY,Ambedkarite Party of India,4344,18,4362,0.29,33 - Jhargram (West Bengal),25,33
12.0,SUSHIL MANDI,Socialist Unity Centre Of India (COMMUNIST),2879,13,2892,0.19,33 - Jhargram (West Bengal),25,33
13.0,GUNADHAR SING,Independent,2818,31,2849,0.19,33 - Jhargram (West Bengal),25,33
14.0,NOTA,None of the Above,15871,49,15920,1.07,33 - Jhargram (West Bengal),25,33
,Total,,1483802,7041,1490843,,33 - Jhargram (West Bengal),25,33
1.0,JUNE MALIAH,All India Trinamool Congress,699562,2630,702192,47.4,34 - Medinipur (West Bengal),25,34
2.0,AGNIMITRA PAUL,Bharatiya Janata Party,671328,3673,675001,45.56,34 - Medinipur (West Bengal),25,34
3.0,BIPLAB BHATTA,Communist Party of India,57345,440,57785,3.9,34 - Medinipur (West Bengal),25,34
4.0,ANINDITA JANA,Socialist Unity Centre Of India (COMMUNIST),9744,47,9791,0.66,34 - Medinipur (West Bengal),25,34
5.0,SANJIB DEY,Independent,8703,8,8711,0.59,34 - Medinipur (West Bengal),25,34
6.0,ANJAN (BABALU) MANDAL,Bahujan Samaj Party,6483,20,6503,0.44,34 - Medinipur (West Bengal),25,34
7.0,KAMALESH MAHATA,Independent,4229,21,4250,0.29,34 - Medinipur (West Bengal),25,34
8.0,SUKESH CHANDRA PALMAL,Independent,2757,5,2762,0.19,34 - Medinipur (West Bengal),25,34
9.0,BISWAJIT DAS,Independent,2141,3,2144,0.14,34 - Medinipur (West Bengal),25,34
10.0,NOTA,None of the Above,12362,62,12424,0.84,34 - Medinipur (West Bengal),25,34
,Total,,1474654,6909,1481563,,34 - Medinipur (West Bengal),25,34
1.0,JYOTIRMAY SINGH MAHATO,Bharatiya Janata Party,576246,2243,578489,40.34,35 - Purulia (West Bengal),25,35
2.0,SHANTIRAM MAHATO,All India Trinamool Congress,559325,2085,561410,39.15,35 - Purulia (West Bengal),25,35
3.0,NEPAL CHANDRA MAHATO,Indian National Congress,128565,592,129157,9.01,35 - Purulia (West Bengal),25,35
4.0,AJIT PRASAD MAHATA,Independent,98381,277,98658,6.88,35 - Purulia (West Bengal),25,35
5.0,DHIRENDRANATH MAHATO,All India Forward Bloc,14498,74,14572,1.02,35 - Purulia (West Bengal),25,35
6.0,SONTOSH RAJOWARD,Bahujan Samaj Party,7739,21,7760,0.54,35 - Purulia (West Bengal),25,35
7.0,SUSMITA MAHATO,Socialist Unity Centre Of India (COMMUNIST),6078,31,6109,0.43,35 - Purulia (West Bengal),25,35
8.0,GORISH ROY,Independent,4800,9,4809,0.34,35 - Purulia (West Bengal),25,35
9.0,BHAGWAT DASS SHASTRI,Independent,4508,4,4512,0.31,35 - Purulia (West Bengal),25,35
10.0,ASIT BARAN MAHATO,Party for Democratic Socialism,3868,9,3877,0.27,35 - Purulia (West Bengal),25,35
11.0,PIJUSH KANTI RAJAK,Independent,3408,10,3418,0.24,35 - Purulia (West Bengal),25,35
12.0,AJIT MAHATO,Independent,3309,9,3318,0.23,35 - Purulia (West Bengal),25,35
13.0,NOTA,None of the Above,17871,58,17929,1.25,35 - Purulia (West Bengal),25,35
,Total,,1428596,5422,1434018,,35 - Purulia (West Bengal),25,35
1.0,ARUP CHAKRABORTY,All India Trinamool Congress,637465,4348,641813,44.33,36 - Bankura (West Bengal),25,36
2.0,DR. SUBHAS SARKAR,Bharatiya Janata Party,604836,4199,609035,42.07,36 - Bankura (West Bengal),25,36
3.0,NILANJAN DASGUPTA,Communist Party of India (Marxist),104534,825,105359,7.28,36 - Bankura (West Bengal),25,36
4.0,SURAJIT SINGH KURMALI,Independent,18507,62,18569,1.28,36 - Bankura (West Bengal),25,36
5.0,GOPAL MURMU,Ambedkarite Party of India,9047,54,9101,0.63,36 - Bankura (West Bengal),25,36
6.0,DIPA BOURI,Bahujan Samaj Party,8709,87,8796,0.61,36 - Bankura (West Bengal),25,36
7.0,MARSHAL TUDU,Independent,6682,35,6717,0.46,36 - Bankura (West Bengal),25,36
8.0,TARA SHANKAR GOPE,Socialist Unity Centre Of India (COMMUNIST),5490,39,5529,0.38,36 - Bankura (West Bengal),25,36
9.0,SANDIP KUMAR DEY,Independent,4610,12,4622,0.32,36 - Bankura (West Bengal),25,36
10.0,SAMAR KUMAR BISWAS,Kisan Mazdoor Sangharsh Party,3512,29,3541,0.24,36 - Bankura (West Bengal),25,36
11.0,JIBAN CHAKRABORTY,Independent,3483,23,3506,0.24,36 - Bankura (West Bengal),25,36
12.0,KARTIK CHANDRA BAURI,Independent,2741,55,2796,0.19,36 - Bankura (West Bengal),25,36
13.0,GOUR CHANDRA HEMBRAM,Independent,2064,17,2081,0.14,36 - Bankura (West Bengal),25,36
14.0,NOTA,None of the Above,26126,83,26209,1.81,36 - Bankura (West Bengal),25,36
,Total,,1437806,9868,1447674,,36 - Bankura (West Bengal),25,36
1.0,KHAN SAUMITRA,Bharatiya Janata Party,677320,2810,680130,44.93,37 - Bishnupur (West Bengal),25,37
2.0,SUJATA MONDAL,All India Trinamool Congress,671148,3415,674563,44.56,37 - Bishnupur (West Bengal),25,37
3.0,SITAL CHANDRA KAIBARTYA,Communist Party of India (Marxist),104895,516,105411,6.96,37 - Bishnupur (West Bengal),25,37
4.0,SADANANDA MANDAL,Socialist Unity Centre Of India (COMMUNIST),16046,28,16074,1.06,37 - Bishnupur (West Bengal),25,37
5.0,JOYDEV DHANK,Bahujan Samaj Party,9027,52,9079,0.6,37 - Bishnupur (West Bengal),25,37
6.0,BASUDEB SIKARI,Independent,5093,13,5106,0.34,37 - Bishnupur (West Bengal),25,37
7.0,NARENDRANATH RAY,Independent,4360,17,4377,0.29,37 - Bishnupur (West Bengal),25,37
8.0,NOTA,None of the Above,19062,70,19132,1.26,37 - Bishnupur (West Bengal),25,37
,Total,,1506951,6921,1513872,,37 - Bishnupur (West Bengal),25,37
1.0,DR. SHARMILA SARKAR,All India Trinamool Congress,717881,2421,720302,48.11,38 - Bardhaman Purba (West Bengal),25,38
2.0,ASIM KUMAR SARKAR,Bharatiya Janata Party,557943,1787,559730,37.38,38 - Bardhaman Purba (West Bengal),25,38
3.0,NIRAB KHAN,Communist Party of India (Marxist),176358,541,176899,11.81,38 - Bardhaman Purba (West Bengal),25,38
4.0,NIRMAL MAJHI,Socialist Unity Centre Of India (COMMUNIST),10964,12,10976,0.73,38 - Bardhaman Purba (West Bengal),25,38
5.0,MUKUL BISWAS,Bahujan Samaj Party,7610,21,7631,0.51,38 - Bardhaman Purba (West Bengal),25,38
6.0,SHARMILA SARKAR,Independent,4875,18,4893,0.33,38 - Bardhaman Purba (West Bengal),25,38
7.0,SAJAL KUMAR DE,Communist Party of India (Marxist-Leninist) (Liberation),4163,19,4182,0.28,38 - Bardhaman Purba (West Bengal),25,38
8.0,NOTA,None of the Above,12654,43,12697,0.85,38 - Bardhaman Purba (West Bengal),25,38
,Total,,1492448,4862,1497310,,38 - Bardhaman Purba (West Bengal),25,38
1.0,AZAD KIRTI JHA,All India Trinamool Congress,717069,3598,720667,47.99,39 - Bardhaman-Durgapur (West Bengal),25,39
2.0,DILIP GHOSH,Bharatiya Janata Party,579609,3077,582686,38.8,39 - Bardhaman-Durgapur (West Bengal),25,39
3.0,SUKRITI GHOSAL,Communist Party of India (Marxist),152851,978,153829,10.24,39 - Bardhaman-Durgapur (West Bengal),25,39
4.0,LUXMI NARAYAN KORA,Independent,7138,4,7142,0.48,39 - Bardhaman-Durgapur (West Bengal),25,39
5.0,PRABHU NATH SAH,Bahujan Samaj Party,6822,34,6856,0.46,39 - Bardhaman-Durgapur (West Bengal),25,39
6.0,TASBIRUL ISLAM,Socialist Unity Centre Of India (COMMUNIST),3450,19,3469,0.23,39 - Bardhaman-Durgapur (West Bengal),25,39
7.0,REENA LEONG,Independent,3100,11,3111,0.21,39 - Bardhaman-Durgapur (West Bengal),25,39
8.0,MIR SAKIMUDDIN,The National Road Map Party of India,2413,5,2418,0.16,39 - Bardhaman-Durgapur (West Bengal),25,39
9.0,NOTA,None of the Above,21532,63,21595,1.44,39 - Bardhaman-Durgapur (West Bengal),25,39
,Total,,1493984,7789,1501773,,39 - Bardhaman-Durgapur (West Bengal),25,39
1.0,SHATRUGHAN PRASAD SINHA,All India Trinamool Congress,603105,2540,605645,46.53,40 - Asansol (West Bengal),25,40
2.0,SURENDRAJEET SINGH AHLUWALIA,Bharatiya Janata Party,544077,2004,546081,41.96,40 - Asansol (West Bengal),25,40
3.0,JAHANARA KHAN,Communist Party of India (Marxist),105454,510,105964,8.14,40 - Asansol (West Bengal),25,40
4.0,DIPIKA BAURI,Independent,10623,24,10647,0.82,40 - Asansol (West Bengal),25,40
5.0,SUNNY KUMAR SAH,Bahujan Samaj Party,8546,29,8575,0.66,40 - Asansol (West Bengal),25,40
6.0,SUJIT PAL,Independent,4749,11,4760,0.37,40 - Asansol (West Bengal),25,40
7.0,AMARNATH CHOWDHURY,Socialist Unity Centre Of India (COMMUNIST),4330,28,4358,0.33,40 - Asansol (West Bengal),25,40
8.0,NOTA,None of the Above,15448,62,15510,1.19,40 - Asansol (West Bengal),25,40
,Total,,1296332,5208,1301540,,40 - Asansol (West Bengal),25,40
1.0,ASIT KUMAR MAL,All India Trinamool Congress,851209,4424,855633,55.98,41 - Bolpur (West Bengal),25,41
2.0,PIYA SAHA,Bharatiya Janata Party,525463,2917,528380,34.57,41 - Bolpur (West Bengal),25,41
3.0,SHYAMALI PRADHAN,Communist Party of India (Marxist),98819,564,99383,6.5,41 - Bolpur (West Bengal),25,41
4.0,ATUL CHANDRA BAURI,Independent,7811,18,7829,0.51,41 - Bolpur (West Bengal),25,41
5.0,DR MANIK CHANDRA PRODHAN,Bahujan Samaj Party,7011,28,7039,0.46,41 - Bolpur (West Bengal),25,41
6.0,SHANTA DAS,Mulnibasi Party of India,3633,7,3640,0.24,41 - Bolpur (West Bengal),25,41
7.0,BIJOY DOLUI,Socialist Unity Centre Of India (COMMUNIST),2774,18,2792,0.18,41 - Bolpur (West Bengal),25,41
8.0,MANTU DHIBAR,Hindustan Shakti Sena,2048,4,2052,0.13,41 - Bolpur (West Bengal),25,41
9.0,NOTA,None of the Above,21640,82,21722,1.42,41 - Bolpur (West Bengal),25,41
,Total,,1520408,8062,1528470,,41 - Bolpur (West Bengal),25,41
1.0,SATABDI ROY,All India Trinamool Congress,714972,2989,717961,47.0,42 - Birbhum (West Bengal),25,42
2.0,DEBTANU BHATTACHARYA,Bharatiya Janata Party,517761,2550,520311,34.06,42 - Birbhum (West Bengal),25,42
3.0,MILTON RASHID,Indian National Congress,225572,688,226260,14.81,42 - Birbhum (West Bengal),25,42
4.0,AMIY GHOSH,Independent,11950,8,11958,0.78,42 - Birbhum (West Bengal),25,42
5.0,LAKSHMI HEMBROM,Ambedkarite Party of India,7677,10,7687,0.5,42 - Birbhum (West Bengal),25,42
6.0,AYESHA KHATUN,Socialist Unity Centre Of India (COMMUNIST),6761,18,6779,0.44,42 - Birbhum (West Bengal),25,42
7.0,RAJNATH SARKAR,Bahujan Samaj Party,5866,16,5882,0.39,42 - Birbhum (West Bengal),25,42
8.0,SAURAV MUDI,Independent,4249,7,4256,0.28,42 - Birbhum (West Bengal),25,42
9.0,ABDUL IMRAN,Independent,3823,9,3832,0.25,42 - Birbhum (West Bengal),25,42
10.0,BISWAJIT MISHRA,All India Arya Mahasabha,3806,17,3823,0.25,42 - Birbhum (West Bengal),25,42
11.0,MD. JAKIR HOSSAIN,Bharatiya National Janata Dal,2547,10,2557,0.17,42 - Birbhum (West Bengal),25,42
12.0,DOLA SARKAR,Indian National Socialistic Action Forces,2027,6,2033,0.13,42 - Birbhum (West Bengal),25,42
13.0,NOTA,None of the Above,14037,56,14093,0.92,42 - Birbhum (West Bengal),25,42
,Total,,1521048,6384,1527432,,42 - Birbhum (West Bengal),25,42
1.0,CHINTAMANI MAHARAJ,Bharatiya Janata Party,712172,1028,713200,49.01,1 - SURGUJA (Chhattisgarh),26,1
2.0,SHASHI SINGH KORAM,Indian National Congress,647329,1049,648378,44.55,1 - SURGUJA (Chhattisgarh),26,1
3.0,DR. L. S. UDAY SINGH,Gondvana Gantantra Party,15626,25,15651,1.08,1 - SURGUJA (Chhattisgarh),26,1
4.0,SANJAY KUMAR,Bahujan Samaj Party,15182,17,15199,1.04,1 - SURGUJA (Chhattisgarh),26,1
5.0,RAMADHAR SINGH,Independent,10857,4,10861,0.75,1 - SURGUJA (Chhattisgarh),26,1
6.0,PRINCE ABHISHEK KUJUR,Independent,6803,12,6815,0.47,1 - SURGUJA (Chhattisgarh),26,1
7.0,URMILA SINGH,Independent,5779,5,5784,0.4,1 - SURGUJA (Chhattisgarh),26,1
8.0,ARVIND KACHHAP,Independent,4166,18,4184,0.29,1 - SURGUJA (Chhattisgarh),26,1
9.0,KANTA MINJ,Akhil Bhartiya Parivar Party,4008,8,4016,0.28,1 - SURGUJA (Chhattisgarh),26,1
10.0,JEROME MINJ,Bharat Adivasi Party,3035,25,3060,0.21,1 - SURGUJA (Chhattisgarh),26,1
11.0,NOTA,None of the Above,28107,14,28121,1.93,1 - SURGUJA (Chhattisgarh),26,1
,Total,,1453064,2205,1455269,,1 - SURGUJA (Chhattisgarh),26,1
1.0,RADHESHYAM RATHIYA,Bharatiya Janata Party,806667,1608,808275,55.63,2 - RAIGARH (Chhattisgarh),26,2
2.0,DR. MENKA DEVI SINGH,Indian National Congress,566487,1397,567884,39.08,2 - RAIGARH (Chhattisgarh),26,2
3.0,INNOCENT KUJUR - BIDANA ORAON,Bahujan Samaj Party,15493,107,15600,1.07,2 - RAIGARH (Chhattisgarh),26,2
4.0,ALBERT MING,Hamar Raj Party,10915,44,10959,0.75,2 - RAIGARH (Chhattisgarh),26,2
5.0,PRAKASH KUMAR URANW,Independent,7719,3,7722,0.53,2 - RAIGARH (Chhattisgarh),26,2
6.0,RUPNARAYAN EKKA,Independent,7410,10,7420,0.51,2 - RAIGARH (Chhattisgarh),26,2
7.0,GOWARDHAN RATHIA,Independent,4591,2,4593,0.32,2 - RAIGARH (Chhattisgarh),26,2
8.0,POOJA SIDAR,Independent,4159,8,4167,0.29,2 - RAIGARH (Chhattisgarh),26,2
9.0,MADAN PRASAD GOND,Gondvana Gantantra Party,3007,8,3015,0.21,2 - RAIGARH (Chhattisgarh),26,2
10.0,GULESHWAR PAINKRA,Bhartiya Shakti Chetna Party,2618,8,2626,0.18,2 - RAIGARH (Chhattisgarh),26,2
11.0,UDAY KUMAR RATHIA,Independent,2127,2,2129,0.15,2 - RAIGARH (Chhattisgarh),26,2
12.0,ABHAY KUMAR EKKA,Independent,1808,17,1825,0.13,2 - RAIGARH (Chhattisgarh),26,2
13.0,BADAL EKKA,Sarv Adi Dal,1714,14,1728,0.12,2 - RAIGARH (Chhattisgarh),26,2
14.0,NOTA,None of the Above,14993,29,15022,1.03,2 - RAIGARH (Chhattisgarh),26,2
,Total,,1449708,3257,1452965,,2 - RAIGARH (Chhattisgarh),26,2
1.0,KAMLESH JANGDE,Bharatiya Janata Party,675740,2459,678199,48.71,3 - JANJGIR-CHAMPA (Chhattisgarh),26,3
2.0,DR. SHIVKUMAR DAHARIYA,Indian National Congress,616131,2068,618199,44.4,3 - JANJGIR-CHAMPA (Chhattisgarh),26,3
3.0,DR. ROHIT DAHARIA,Bahujan Samaj Party,48089,412,48501,3.48,3 - JANJGIR-CHAMPA (Chhattisgarh),26,3
4.0,ENGINEER REVA KURREY,Independent,8158,1,8159,0.59,3 - JANJGIR-CHAMPA (Chhattisgarh),26,3
5.0,AD. T.R. NIRALA,Independent,5792,2,5794,0.42,3 - JANJGIR-CHAMPA (Chhattisgarh),26,3
6.0,ANIL MANHAR,Hamar Raj Party,5770,10,5780,0.42,3 - JANJGIR-CHAMPA (Chhattisgarh),26,3
7.0,VIDYA DEVI SONI,Independent,4877,4,4881,0.35,3 - JANJGIR-CHAMPA (Chhattisgarh),26,3
8.0,MINA CHAUHAN,Independent,2929,2,2931,0.21,3 - JANJGIR-CHAMPA (Chhattisgarh),26,3
9.0,ANAND GILHARE,Independent,2876,1,2877,0.21,3 - JANJGIR-CHAMPA (Chhattisgarh),26,3
10.0,DEEPAK KUMAR KHUNTE,Aazad Samaj Party (Kanshi Ram),1822,7,1829,0.13,3 - JANJGIR-CHAMPA (Chhattisgarh),26,3
11.0,ARVIND KUMAR,Independent,1710,5,1715,0.12,3 - JANJGIR-CHAMPA (Chhattisgarh),26,3
12.0,GOPAL PRASAD KHUNTE,Bhartiya Shakti Chetna Party,1471,12,1483,0.11,3 - JANJGIR-CHAMPA (Chhattisgarh),26,3
13.0,VIJAYLAXMI SURYAWANSHI NAT,Asankhya Samaj Party,1417,5,1422,0.1,3 - JANJGIR-CHAMPA (Chhattisgarh),26,3
14.0,SIMA MAHILANGE,Independent,1333,3,1336,0.1,3 - JANJGIR-CHAMPA (Chhattisgarh),26,3
15.0,ADVOCATE SHAILENDRA BANJARE (SHAKTIPUTRA),Shakti Sena (Bharat Desh),1248,5,1253,0.09,3 - JANJGIR-CHAMPA (Chhattisgarh),26,3
16.0,VIJAY KUMAR KURRE,Rashtriya Jansabha Party,981,2,983,0.07,3 - JANJGIR-CHAMPA (Chhattisgarh),26,3
17.0,BRINDA CHAUHAN,Chhattisgarh Vikas Ganga Rashtriya Party,921,3,924,0.07,3 - JANJGIR-CHAMPA (Chhattisgarh),26,3
18.0,JAGJIVAN RAM SATNAMI,Azad Janata Party,833,4,837,0.06,3 - JANJGIR-CHAMPA (Chhattisgarh),26,3
19.0,NOTA,None of the Above,5098,39,5137,0.37,3 - JANJGIR-CHAMPA (Chhattisgarh),26,3
,Total,,1387196,5044,1392240,,3 - JANJGIR-CHAMPA (Chhattisgarh),26,3
1.0,JYOTSNA CHARANDAS MAHANT,Indian National Congress,569098,1084,570182,46.53,4 - KORBA (Chhattisgarh),26,4
2.0,SAROJ PANDEY,Bharatiya Janata Party,525733,1166,526899,43.0,4 - KORBA (Chhattisgarh),26,4
3.0,SHYAM SINGH MARKAM,Gondvana Gantantra Party,48498,89,48587,3.97,4 - KORBA (Chhattisgarh),26,4
4.0,NIRDOSH KUMAR YADAV,Independent,11267,1,11268,0.92,4 - KORBA (Chhattisgarh),26,4
5.0,DUJRAM BOUDDH,Bahujan Samaj Party,10689,50,10739,0.88,4 - KORBA (Chhattisgarh),26,4
6.0,JAICHANDRA SONPAKAR,Independent,6181,1,6182,0.5,4 - KORBA (Chhattisgarh),26,4
7.0,PALAN SINGH,Independent,5706,3,5709,0.47,4 - KORBA (Chhattisgarh),26,4
8.0,KAMAL DEV,Bhartiya Shakti Chetna Party,4985,3,4988,0.41,4 - KORBA (Chhattisgarh),26,4
9.0,DILIP MIRI,Independent,3897,5,3902,0.32,4 - KORBA (Chhattisgarh),26,4
10.0,KAUSHALYA BAI PORTE,Independent,3630,2,3632,0.3,4 - KORBA (Chhattisgarh),26,4
11.0,PRATAP BHANU,Independent,2500,4,2504,0.2,4 - KORBA (Chhattisgarh),26,4
12.0,SANTOSH SHARMA,Independent,2475,2,2477,0.2,4 - KORBA (Chhattisgarh),26,4
13.0,AMRIKA KARPE,Independent,2227,5,2232,0.18,4 - KORBA (Chhattisgarh),26,4
14.0,RAJGURU KEWAL GOSWAMI,Independent,2202,-,2202,0.18,4 - KORBA (Chhattisgarh),26,4
15.0,SHOBRAN SINGH SAIMA,Independent,2072,1,2073,0.17,4 - KORBA (Chhattisgarh),26,4
16.0,KALYAN SINGH TANWAR,Independent,1960,4,1964,0.16,4 - KORBA (Chhattisgarh),26,4
17.0,RAJESH PANDEY,Independent,1814,-,1814,0.15,4 - KORBA (Chhattisgarh),26,4
18.0,SUSHIL KUMAR VISHWAKARMA,Bhartiya Janta Secular Party,1684,1,1685,0.14,4 - KORBA (Chhattisgarh),26,4
19.0,PRASHANT DANIEL,Sarv Adi Dal,1369,23,1392,0.11,4 - KORBA (Chhattisgarh),26,4
20.0,REKHA TIWARI,Chhattisgarh Vikas Ganga Rashtriya Party,1289,5,1294,0.11,4 - KORBA (Chhattisgarh),26,4
21.0,PURUSHOTTAM MANIKPURI,Independent,1212,-,1212,0.1,4 - KORBA (Chhattisgarh),26,4
22.0,PRIYANKA PATEL,Republican Party of India (A),1197,7,1204,0.1,4 - KORBA (Chhattisgarh),26,4
23.0,MAHENDRA KUMAR SHRIWAS (MANJU),Independent,1187,-,1187,0.1,4 - KORBA (Chhattisgarh),26,4
24.0,SHEKH RAUF,Independent,1168,-,1168,0.1,4 - KORBA (Chhattisgarh),26,4
25.0,SHIVPUJAN SINGH,Independent,1036,-,1036,0.08,4 - KORBA (Chhattisgarh),26,4
26.0,SHANTI BAI MARAVI,Independent,858,3,861,0.07,4 - KORBA (Chhattisgarh),26,4
27.0,RAMESH DAS MAHANT,Independent,823,-,823,0.07,4 - KORBA (Chhattisgarh),26,4
28.0,NOTA,None of the Above,6076,21,6097,0.5,4 - KORBA (Chhattisgarh),26,4
,Total,,1222833,2480,1225313,,4 - KORBA (Chhattisgarh),26,4
1.0,TOKHAN SAHU,Bharatiya Janata Party,723194,1743,724937,53.25,5 - BILASPUR (Chhattisgarh),26,5
2.0,DEVENDRA YADAV,Indian National Congress,558942,1437,560379,41.16,5 - BILASPUR (Chhattisgarh),26,5
3.0,ASHWANI RAJAK,Bahujan Samaj Party,13175,47,13222,0.97,5 - BILASPUR (Chhattisgarh),26,5
4.0,ANAND URAWAN,Independent,5894,4,5898,0.43,5 - BILASPUR (Chhattisgarh),26,5
5.0,ANILESH MISHRA (MAHARAJ),Independent,5374,2,5376,0.39,5 - BILASPUR (Chhattisgarh),26,5
6.0,KULESH KUMAR SAHU,Independent,4439,4,4443,0.33,5 - BILASPUR (Chhattisgarh),26,5
7.0,ASHAVANT SAHOO,Bhartiya Shakti Chetna Party,4345,9,4354,0.32,5 - BILASPUR (Chhattisgarh),26,5
8.0,SHRIKANT MALHWAYR (KASER),Loktantra Congress Party,4197,4,4201,0.31,5 - BILASPUR (Chhattisgarh),26,5
9.0,VIKRAMPRASAD JOGI,Independent,2862,-,2862,0.21,5 - BILASPUR (Chhattisgarh),26,5
10.0,KESHAV PRASAD,Independent,2765,2,2767,0.2,5 - BILASPUR (Chhattisgarh),26,5
11.0,SUDIEP SHRIVASTAVA,Hamar Raj Party,2310,2,2312,0.17,5 - BILASPUR (Chhattisgarh),26,5
12.0,RUPRAM SAHU,Independent,2261,-,2261,0.17,5 - BILASPUR (Chhattisgarh),26,5
13.0,KRISHNA NANDAN SINGH,Independent,2020,-,2020,0.15,5 - BILASPUR (Chhattisgarh),26,5
14.0,ROSHAN KUMAR,Independent,1920,-,1920,0.14,5 - BILASPUR (Chhattisgarh),26,5
15.0,DINESH PRATAP SINGH KHUSRO NIKHIL,Rashtriya Gondvana Party,1792,16,1808,0.13,5 - BILASPUR (Chhattisgarh),26,5
16.0,RAMESHWAR SAHU,Independent,1761,-,1761,0.13,5 - BILASPUR (Chhattisgarh),26,5
17.0,VIJAY KUMAR,Independent,1625,1,1626,0.12,5 - BILASPUR (Chhattisgarh),26,5
18.0,YASHUTOSH LAHARE,Ambedkarite Party of India,1271,3,1274,0.09,5 - BILASPUR (Chhattisgarh),26,5
19.0,GHANSHYAM URF SADHELAL BHARDWAJ,Independent,1251,-,1251,0.09,5 - BILASPUR (Chhattisgarh),26,5
20.0,VEDMANI SINGH KSHATRIYA (THAKUR),Independent,1163,-,1163,0.09,5 - BILASPUR (Chhattisgarh),26,5
21.0,SHEKHAR BANJARE,Independent,1160,-,1160,0.09,5 - BILASPUR (Chhattisgarh),26,5
22.0,SIDDHRAM LAHARE,Rashtriya Jansabha Party,1149,1,1150,0.08,5 - BILASPUR (Chhattisgarh),26,5
23.0,RAMPYARE RAI,Independent,1112,-,1112,0.08,5 - BILASPUR (Chhattisgarh),26,5
24.0,NAND KISHORE RAJ,Gondvana Gantantra Party,1049,12,1061,0.08,5 - BILASPUR (Chhattisgarh),26,5
25.0,BHUNESHWAR MARKO,Independent,967,3,970,0.07,5 - BILASPUR (Chhattisgarh),26,5
26.0,RAJKUMAR SAHU,Independent,828,1,829,0.06,5 - BILASPUR (Chhattisgarh),26,5
27.0,BHAGWAT PATRE,Prabuddha Republican Party,710,2,712,0.05,5 - BILASPUR (Chhattisgarh),26,5
28.0,LAKSHMAN PATHAK,Ekam Sanatan Bharat Dal,698,1,699,0.05,5 - BILASPUR (Chhattisgarh),26,5
29.0,ADVOCATE SHAILENDRA BANJARE (SHAKTIPUTRA),Shakti Sena (Bharat Desh),690,-,690,0.05,5 - BILASPUR (Chhattisgarh),26,5
30.0,RAJENDRA KUMAR TANDAN,Independent,654,2,656,0.05,5 - BILASPUR (Chhattisgarh),26,5
31.0,SALIK RAM JOGI,Independent,575,1,576,0.04,5 - BILASPUR (Chhattisgarh),26,5
32.0,BASANT BANSL,Independent,564,-,564,0.04,5 - BILASPUR (Chhattisgarh),26,5
33.0,DEEPMALA CHOUHAN,Chhattisgarh Vikas Ganga Rashtriya Party,559,6,565,0.04,5 - BILASPUR (Chhattisgarh),26,5
34.0,MAHESH KUMAR SONWANI,Independent,559,1,560,0.04,5 - BILASPUR (Chhattisgarh),26,5
35.0,DEV PRASAD BRAIHA,Independent,511,-,511,0.04,5 - BILASPUR (Chhattisgarh),26,5
36.0,SANJAY PRAKASH SAHU,Independent,435,1,436,0.03,5 - BILASPUR (Chhattisgarh),26,5
37.0,PARAS RAM YADAV,Independent,414,1,415,0.03,5 - BILASPUR (Chhattisgarh),26,5
38.0,NOTA,None of the Above,2842,7,2849,0.21,5 - BILASPUR (Chhattisgarh),26,5
,Total,,1358037,3313,1361350,,5 - BILASPUR (Chhattisgarh),26,5
1.0,SANTOSH PANDEY,Bharatiya Janata Party,711439,618,712057,49.25,6 - RAJNANDGAON (Chhattisgarh),26,6
2.0,BHUPESH BAGHEL,Indian National Congress,667078,568,667646,46.18,6 - RAJNANDGAON (Chhattisgarh),26,6
3.0,A.H. SIDDIQUI,Independent,10737,-,10737,0.74,6 - RAJNANDGAON (Chhattisgarh),26,6
4.0,DEVLAL SINHA (SONVANSHI),Bahujan Samaj Party,9659,9,9668,0.67,6 - RAJNANDGAON (Chhattisgarh),26,6
5.0,NARAD PRASAD NISHAD,Shakti Sena (Bharat Desh),8029,1,8030,0.56,6 - RAJNANDGAON (Chhattisgarh),26,6
6.0,SUKHDEV SINHA,Independent,7998,3,8001,0.55,6 - RAJNANDGAON (Chhattisgarh),26,6
7.0,VISHESH DHAMGAYE,Independent,4872,1,4873,0.34,6 - RAJNANDGAON (Chhattisgarh),26,6
8.0,BHUVAN SAHU,Independent,4171,3,4174,0.29,6 - RAJNANDGAON (Chhattisgarh),26,6
9.0,LALITA KANWAR,Hamar Raj Party,2139,10,2149,0.15,6 - RAJNANDGAON (Chhattisgarh),26,6
10.0,ER. BASANT KUMAR MESHRAM,Independent,1818,2,1820,0.13,6 - RAJNANDGAON (Chhattisgarh),26,6
11.0,RAMESH RAJPUT,Bhartiya Shakti Chetna Party,1735,2,1737,0.12,6 - RAJNANDGAON (Chhattisgarh),26,6
12.0,TRIVENI PADOTI,Independent,1607,6,1613,0.11,6 - RAJNANDGAON (Chhattisgarh),26,6
13.0,RAMFAL PATIL,Nyaydharmsabha,1535,2,1537,0.11,6 - RAJNANDGAON (Chhattisgarh),26,6
14.0,AJAY PALI,Independent,1114,-,1114,0.08,6 - RAJNANDGAON (Chhattisgarh),26,6
15.0,LAKHAN SING TANDAN,Rashtriya Jansabha Party,1056,-,1056,0.07,6 - RAJNANDGAON (Chhattisgarh),26,6
16.0,NOTA,None of the Above,9152,401,9553,0.66,6 - RAJNANDGAON (Chhattisgarh),26,6
,Total,,1444139,1626,1445765,,6 - RAJNANDGAON (Chhattisgarh),26,6
1.0,VIJAY BAGHEL,Bharatiya Janata Party,954356,2141,956497,62.0,7 - DURG (Chhattisgarh),26,7
2.0,RAJENDRA SAHU,Indian National Congress,517277,994,518271,33.59,7 - DURG (Chhattisgarh),26,7
3.0,DILIP RAMTEKE,Bahujan Samaj Party,13290,43,13333,0.86,7 - DURG (Chhattisgarh),26,7
4.0,ANOOP KUMAR PANDEY,Independent,7765,1,7766,0.5,7 - DURG (Chhattisgarh),26,7
5.0,DR. ANJU KEME,Ekam Sanatan Bharat Dal,5237,4,5241,0.34,7 - DURG (Chhattisgarh),26,7
6.0,ALI HUSSAIN SIDDIQUI,Independent,5046,4,5050,0.33,7 - DURG (Chhattisgarh),26,7
7.0,ARUN JOSHI,Independent,4751,2,4753,0.31,7 - DURG (Chhattisgarh),26,7
8.0,DHRUV KUMAR SONI URF LANGUR SONI,Independent,3813,2,3815,0.25,7 - DURG (Chhattisgarh),26,7
9.0,KHILANAND JASPAL,Independent,3280,1,3281,0.21,7 - DURG (Chhattisgarh),26,7
10.0,SUKHADEV TANDON,Rashtriya Jansabha Party,2615,2,2617,0.17,7 - DURG (Chhattisgarh),26,7
11.0,ASHOK JAIN,Independent,1902,-,1902,0.12,7 - DURG (Chhattisgarh),26,7
12.0,BALDEV SAHU,Independent,1610,3,1613,0.1,7 - DURG (Chhattisgarh),26,7
13.0,PUSHPA MAIRISHA,Ambedkarite Party of India,1556,5,1561,0.1,7 - DURG (Chhattisgarh),26,7
14.0,HARICHAND THAKUR,Independent,1451,1,1452,0.09,7 - DURG (Chhattisgarh),26,7
15.0,SAVITA SHAILENDRA BANJARE,Shakti Sena (Bharat Desh),1393,3,1396,0.09,7 - DURG (Chhattisgarh),26,7
16.0,RAKESH SAHU,Nyaydharmsabha,1261,1,1262,0.08,7 - DURG (Chhattisgarh),26,7
17.0,SHITKARAN MAHILWAR,Aazad Samaj Party (Kanshi Ram),1181,2,1183,0.08,7 - DURG (Chhattisgarh),26,7
18.0,DR. HARISHCHANDRA SAHU,Independent,1116,-,1116,0.07,7 - DURG (Chhattisgarh),26,7
19.0,SHANKAR THAKUR,Gondvana Gantantra Party,1064,9,1073,0.07,7 - DURG (Chhattisgarh),26,7
20.0,YASHWANT SITARAM SAHU,Bhartiya Shakti Chetna Party,899,2,901,0.06,7 - DURG (Chhattisgarh),26,7
21.0,SHYAM SUNDER SAHU,Loktantra Congress Party,897,2,899,0.06,7 - DURG (Chhattisgarh),26,7
22.0,VIKAS SHARMA,Lokshahi Ekta Party,798,-,798,0.05,7 - DURG (Chhattisgarh),26,7
23.0,SANTOSH KUMAR MARKANDE,Independent,646,4,650,0.04,7 - DURG (Chhattisgarh),26,7
24.0,BHAGBALI SIVARE,Independent,388,1,389,0.03,7 - DURG (Chhattisgarh),26,7
25.0,BHANUPRATAP CHATURVEDI,Independent,351,-,351,0.02,7 - DURG (Chhattisgarh),26,7
26.0,NOTA,None of the Above,5596,21,5617,0.36,7 - DURG (Chhattisgarh),26,7
,Total,,1539539,3248,1542787,,7 - DURG (Chhattisgarh),26,7
1.0,BRIJMOHAN AGRAWAL,Bharatiya Janata Party,1047447,2904,1050351,66.19,8 - RAIPUR (Chhattisgarh),26,8
2.0,VIKAS UPADHYAY,Indian National Congress,473656,1410,475066,29.94,8 - RAIPUR (Chhattisgarh),26,8
3.0,MAMTA RANI SAHU,Bahujan Samaj Party,9201,98,9299,0.59,8 - RAIPUR (Chhattisgarh),26,8
4.0,SAVITA SHAILENDRA BANJARE,Shakti Sena (Bharat Desh),8765,3,8768,0.55,8 - RAIPUR (Chhattisgarh),26,8
5.0,RADHESHWARI GAIKWAD,Independent,4629,1,4630,0.29,8 - RAIPUR (Chhattisgarh),26,8
6.0,SURESH KUMAR NETAM,Hamar Raj Party,3492,7,3499,0.22,8 - RAIPUR (Chhattisgarh),26,8
7.0,ANIL MAHOBIA,Right to Recall Party,2914,2,2916,0.18,8 - RAIPUR (Chhattisgarh),26,8
8.0,ENGI. LAL BAHADUR YADAV,Gondvana Gantantra Party,2859,6,2865,0.18,8 - RAIPUR (Chhattisgarh),26,8
9.0,RAMKRISHNA VERMA,Independent,2182,3,2185,0.14,8 - RAIPUR (Chhattisgarh),26,8
10.0,YAKUB KHAN,Independent,2054,-,2054,0.13,8 - RAIPUR (Chhattisgarh),26,8
11.0,VISHWAJIT HARODE,Socialist Unity Centre Of India (COMMUNIST),1920,-,1920,0.12,8 - RAIPUR (Chhattisgarh),26,8
12.0,AMARNATH CHANDRAKAR,Independent,1608,-,1608,0.1,8 - RAIPUR (Chhattisgarh),26,8
13.0,LAKHAMOO RAM TANDON,Rashtriya Jansabha Party,1347,4,1351,0.09,8 - RAIPUR (Chhattisgarh),26,8
14.0,YASHUTOSH LAHARE,Ambedkarite Party of India,1312,-,1312,0.08,8 - RAIPUR (Chhattisgarh),26,8
15.0,RAJESH DHRUV,Independent,1187,6,1193,0.08,8 - RAIPUR (Chhattisgarh),26,8
16.0,BODHAN LAL FARIKAR,Independent,1059,-,1059,0.07,8 - RAIPUR (Chhattisgarh),26,8
17.0,DAYA SHANKER NISHAD,Bhartiya Shakti Chetna Party,1051,11,1062,0.07,8 - RAIPUR (Chhattisgarh),26,8
18.0,PILARAM ANANT,Sunder Samaj Party,1033,3,1036,0.07,8 - RAIPUR (Chhattisgarh),26,8
19.0,ROHIT KUMAR PATIL,Independent,960,-,960,0.06,8 - RAIPUR (Chhattisgarh),26,8
20.0,HIRA NAND NAGWANI (ASHOK BHAIYA),Republican Party of India (A),958,2,960,0.06,8 - RAIPUR (Chhattisgarh),26,8
21.0,BHANJAN JANGADE (ADHIWAKTA),Bharatiya Bahujan Congress,818,3,821,0.05,8 - RAIPUR (Chhattisgarh),26,8
22.0,MO. AMIN,Bhrashtachar Mukti Morcha,765,1,766,0.05,8 - RAIPUR (Chhattisgarh),26,8
23.0,MANOJ VERMA,Independent,723,1,724,0.05,8 - RAIPUR (Chhattisgarh),26,8
24.0,PITAMBAR JANGDE,Aazad Samaj Party (Kanshi Ram),701,4,705,0.04,8 - RAIPUR (Chhattisgarh),26,8
25.0,ASHISH KUMAR TIWARI,Aap Sabki Apni Party,525,3,528,0.03,8 - RAIPUR (Chhattisgarh),26,8
26.0,ENGI. BHANU PRATAP TANDE,Independent,500,3,503,0.03,8 - RAIPUR (Chhattisgarh),26,8
27.0,MO. IMRAN KHAN,Independent,466,1,467,0.03,8 - RAIPUR (Chhattisgarh),26,8
28.0,NEERAJ SAINI PUJARI,Dhoom Sena,434,-,434,0.03,8 - RAIPUR (Chhattisgarh),26,8
29.0,SUDHANSHU BHUSHAN,Independent,413,1,414,0.03,8 - RAIPUR (Chhattisgarh),26,8
30.0,RAMPRASAD PRAJAPATI,Independent,391,-,391,0.02,8 - RAIPUR (Chhattisgarh),26,8
31.0,PRAVIN JAIN,Independent,369,-,369,0.02,8 - RAIPUR (Chhattisgarh),26,8
32.0,VINAYAK DHAMGAYE,Independent,349,-,349,0.02,8 - RAIPUR (Chhattisgarh),26,8
33.0,NANDNI NAYAK,Independent,336,1,337,0.02,8 - RAIPUR (Chhattisgarh),26,8
34.0,PRAVISHANT SALOMAN,Independent,310,-,310,0.02,8 - RAIPUR (Chhattisgarh),26,8
35.0,SAYED IRSHAD,Independent,295,-,295,0.02,8 - RAIPUR (Chhattisgarh),26,8
36.0,DR. OMPRAKASH SAHU,Independent,291,3,294,0.02,8 - RAIPUR (Chhattisgarh),26,8
37.0,MO. NASIR,Independent,254,-,254,0.02,8 - RAIPUR (Chhattisgarh),26,8
38.0,NURI KHAN,Independent,252,-,252,0.02,8 - RAIPUR (Chhattisgarh),26,8
39.0,NOTA,None of the Above,4414,34,4448,0.28,8 - RAIPUR (Chhattisgarh),26,8
,Total,,1582240,4515,1586755,,8 - RAIPUR (Chhattisgarh),26,8
1.0,ROOP KUMARI CHOUDHARY,Bharatiya Janata Party,701291,2368,703659,53.06,9 - MAHASAMUND (Chhattisgarh),26,9
2.0,TAMRADHWAJ SAHU,Indian National Congress,556764,1439,558203,42.09,9 - MAHASAMUND (Chhattisgarh),26,9
3.0,PROFESSOR SURESH SAHU,Independent,11885,3,11888,0.9,9 - MAHASAMUND (Chhattisgarh),26,9
4.0,BASANT SINHA,Bahujan Samaj Party,8823,37,8860,0.67,9 - MAHASAMUND (Chhattisgarh),26,9
5.0,REKHRAM BAGH,Independent,7877,1,7878,0.59,9 - MAHASAMUND (Chhattisgarh),26,9
6.0,GANESH RAM DHRUW,Hamar Raj Party,6626,25,6651,0.5,9 - MAHASAMUND (Chhattisgarh),26,9
7.0,SANTOSH DARCHAND BANJARE,Independent,6049,5,6054,0.46,9 - MAHASAMUND (Chhattisgarh),26,9
8.0,MUKESH KUMAR AGRAWAL,Independent,3689,2,3691,0.28,9 - MAHASAMUND (Chhattisgarh),26,9
9.0,SUKHNANDAN DESHKAR,Independent,3554,1,3555,0.27,9 - MAHASAMUND (Chhattisgarh),26,9
10.0,NITESH KUMAR RATRE,Sunder Samaj Party,2366,7,2373,0.18,9 - MAHASAMUND (Chhattisgarh),26,9
11.0,DR. VIRENDRA CHAUDHRI,Bhartiya Shakti Chetna Party,2093,6,2099,0.16,9 - MAHASAMUND (Chhattisgarh),26,9
12.0,KALIYA PRASAD SETH,Independent,1528,3,1531,0.12,9 - MAHASAMUND (Chhattisgarh),26,9
13.0,MAHESH SWARN,Independent,1484,2,1486,0.11,9 - MAHASAMUND (Chhattisgarh),26,9
14.0,CHAMPA LAL PATEL GURUJI DHARTI PAKD,Right to Recall Party,1376,3,1379,0.1,9 - MAHASAMUND (Chhattisgarh),26,9
15.0,FARID QURAISHI,Gondvana Gantantra Party,1074,3,1077,0.08,9 - MAHASAMUND (Chhattisgarh),26,9
16.0,ISHWAR MARKANDE,Independent,957,-,957,0.07,9 - MAHASAMUND (Chhattisgarh),26,9
17.0,NARAD PRASAD NISHAD,Shakti Sena (Bharat Desh),897,2,899,0.07,9 - MAHASAMUND (Chhattisgarh),26,9
18.0,NOTA,None of the Above,3801,39,3840,0.29,9 - MAHASAMUND (Chhattisgarh),26,9
,Total,,1322134,3946,1326080,,9 - MAHASAMUND (Chhattisgarh),26,9
1.0,MAHESH KASHYAP,Bharatiya Janata Party,456573,1825,458398,45.5,10 - BASTAR (Chhattisgarh),26,10
2.0,KAWASI LAKHMA,Indian National Congress,402378,775,403153,40.02,10 - BASTAR (Chhattisgarh),26,10
3.0,PHULSINGH KACHLAM,Communist Party of India,35850,37,35887,3.56,10 - BASTAR (Chhattisgarh),26,10
4.0,AYTU RAM MANDAVI,Bahujan Samaj Party,19615,32,19647,1.95,10 - BASTAR (Chhattisgarh),26,10
5.0,SUNDAR BAGHEL,Independent,14203,4,14207,1.41,10 - BASTAR (Chhattisgarh),26,10
6.0,PRAKASH KUMAR GOTA,Independent,11209,36,11245,1.12,10 - BASTAR (Chhattisgarh),26,10
7.0,KANWAL SINGH BAGHEL,Rashtriya Jansabha Party,8785,15,8800,0.87,10 - BASTAR (Chhattisgarh),26,10
8.0,SHIVRAM NAG,Sarv Adi Dal,8269,10,8279,0.82,10 - BASTAR (Chhattisgarh),26,10
9.0,NARENDRA BURKA,Hamar Raj Party,4382,5,4387,0.44,10 - BASTAR (Chhattisgarh),26,10
10.0,JAGDISH NAG,Azad Janata Party,3569,23,3592,0.36,10 - BASTAR (Chhattisgarh),26,10
11.0,TIKAM NAGWANSHI,Gondvana Gantantra Party,3030,12,3042,0.3,10 - BASTAR (Chhattisgarh),26,10
12.0,NOTA,None of the Above,36733,25,36758,3.65,10 - BASTAR (Chhattisgarh),26,10
,Total,,1004596,2799,1007395,,10 - BASTAR (Chhattisgarh),26,10
1.0,BHOJRAJ NAG,Bharatiya Janata Party,595185,2439,597624,47.23,11 - KANKER (Chhattisgarh),26,11
2.0,BIRESH THAKUR,Indian National Congress,593268,2472,595740,47.08,11 - KANKER (Chhattisgarh),26,11
3.0,TILAK RAM MARKAM,Bahujan Samaj Party,11694,76,11770,0.93,11 - KANKER (Chhattisgarh),26,11
4.0,SONSINGH,Ambedkarite Party of India,11351,11,11362,0.9,11 - KANKER (Chhattisgarh),26,11
5.0,JIVAN LAL MATLAM,Sarv Adi Dal,8935,14,8949,0.71,11 - KANKER (Chhattisgarh),26,11
6.0,SUKCHAND NETAM,Gondvana Gantantra Party,8617,106,8723,0.69,11 - KANKER (Chhattisgarh),26,11
7.0,VINOD NAGWANSHI,Hamar Raj Party,4958,51,5009,0.4,11 - KANKER (Chhattisgarh),26,11
8.0,THAKESH MAHLA,Bhartiya Shakti Chetna Party,4201,21,4222,0.33,11 - KANKER (Chhattisgarh),26,11
9.0,BHOJRAM MANDAVI,Rashtriya Jansabha Party,3326,35,3361,0.27,11 - KANKER (Chhattisgarh),26,11
10.0,NOTA,None of the Above,18618,51,18669,1.48,11 - KANKER (Chhattisgarh),26,11
,Total,,1260153,5276,1265429,,11 - KANKER (Chhattisgarh),26,11
1.0,VIJAY KUMAR HANSDAK,Jharkhand Mukti Morcha,607293,6078,613371,50.35,1 - Rajmahal (Jharkhand),27,1
2.0,TALA MARANDI,Bharatiya Janata Party,430544,4563,435107,35.72,1 - Rajmahal (Jharkhand),27,1
3.0,LOBIN HEMBRAM,Independent,41592,548,42140,3.46,1 - Rajmahal (Jharkhand),27,1
4.0,GOPIN SOREN,Communist Party of India (Marxist),37191,100,37291,3.06,1 - Rajmahal (Jharkhand),27,1
5.0,MAHESH PAHARIYA,Independent,14950,28,14978,1.23,1 - Rajmahal (Jharkhand),27,1
6.0,AJIT MARANDI,Rashtriya Jansambhavna Party,11243,8,11251,0.92,1 - Rajmahal (Jharkhand),27,1
7.0,SEBASTION HEMBROM,Independent,9492,1,9493,0.78,1 - Rajmahal (Jharkhand),27,1
8.0,MARIYAM MARANDI,Bahujan Samaj Party,8225,34,8259,0.68,1 - Rajmahal (Jharkhand),27,1
9.0,PAUL SOREN,All India Majlis-E-Ittehadul Muslimeen,7854,48,7902,0.65,1 - Rajmahal (Jharkhand),27,1
10.0,DIPA TUDU,Independent,6847,9,6856,0.56,1 - Rajmahal (Jharkhand),27,1
11.0,KHALIFA KISKU,Peoples Party of India (Democratic),4092,15,4107,0.34,1 - Rajmahal (Jharkhand),27,1
12.0,VINOD KUMAR MANDAL,Lokhit Adhikar Party,3774,35,3809,0.31,1 - Rajmahal (Jharkhand),27,1
13.0,MUNSHI KISKU,Navyug Pragatisheel Morcha,2777,2,2779,0.23,1 - Rajmahal (Jharkhand),27,1
14.0,LILI HANSDA,Samata Party,2682,7,2689,0.22,1 - Rajmahal (Jharkhand),27,1
15.0,NOTA,None of the Above,18119,98,18217,1.5,1 - Rajmahal (Jharkhand),27,1
,Total,,1206675,11574,1218249,,1 - Rajmahal (Jharkhand),27,1
1.0,NALIN SOREN,Jharkhand Mukti Morcha,542299,5071,547370,46.23,2 - Dumka (Jharkhand),27,2
2.0,SITA MURMU,Bharatiya Janata Party,520714,4129,524843,44.32,2 - Dumka (Jharkhand),27,2
3.0,MAHASHON MURMU,Independent,21371,1,21372,1.8,2 - Dumka (Jharkhand),27,2
4.0,BABYLATA TUDU,Independent,19275,85,19360,1.63,2 - Dumka (Jharkhand),27,2
5.0,RAJESH KISKU,Communist Party of India,11484,22,11506,0.97,2 - Dumka (Jharkhand),27,2
6.0,DR. SRILAL KISKU,Independent,9414,2,9416,0.8,2 - Dumka (Jharkhand),27,2
7.0,PARESH MARANDI,Bahujan Samaj Party,7713,20,7733,0.65,2 - Dumka (Jharkhand),27,2
8.0,ANIL TUDU,Lokhit Adhikar Party,6811,7,6818,0.58,2 - Dumka (Jharkhand),27,2
9.0,SUSHANTI HEMBROM,Independent,5150,2,5152,0.44,2 - Dumka (Jharkhand),27,2
10.0,MANOJ HEMBROM,Independent,4814,2,4816,0.41,2 - Dumka (Jharkhand),27,2
11.0,BIREN MOHLI,Independent,4416,2,4418,0.37,2 - Dumka (Jharkhand),27,2
12.0,RAJU EMANUEL MURMU,Ambedkarite Party of India,3056,4,3060,0.26,2 - Dumka (Jharkhand),27,2
13.0,KAMISHNAR MURMU,Independent,2509,7,2516,0.21,2 - Dumka (Jharkhand),27,2
14.0,BAGHRAI SOREN,Independent,2255,1,2256,0.19,2 - Dumka (Jharkhand),27,2
15.0,SANJAY TUDU,Independent,2171,3,2174,0.18,2 - Dumka (Jharkhand),27,2
16.0,MUNNI HANSDA,Samata Party,1753,5,1758,0.15,2 - Dumka (Jharkhand),27,2
17.0,NIRMAL SOREN,Independent,1707,6,1713,0.14,2 - Dumka (Jharkhand),27,2
18.0,ALESH HANSDA,Indian National Socialistic Action Forces,1666,8,1674,0.14,2 - Dumka (Jharkhand),27,2
19.0,JONATHAN MARDI,Peoples Party of India (Democratic),1650,1,1651,0.14,2 - Dumka (Jharkhand),27,2
20.0,NOTA,None of the Above,4453,73,4526,0.38,2 - Dumka (Jharkhand),27,2
,Total,,1174681,9451,1184132,,2 - Dumka (Jharkhand),27,2
1.0,NISHIKANT DUBEY,Bharatiya Janata Party,688879,4261,693140,49.57,3 - Godda (Jharkhand),27,3
2.0,PRADEEP YADAV,Indian National Congress,586104,5223,591327,42.29,3 - Godda (Jharkhand),27,3
3.0,UDAY SHANKAR KHAWARE,Independent,26831,6,26837,1.92,3 - Godda (Jharkhand),27,3
4.0,ARUN MARIK,Independent,17436,1,17437,1.25,3 - Godda (Jharkhand),27,3
5.0,NILESH KUMAR GUPTA,Independent,10485,3,10488,0.75,3 - Godda (Jharkhand),27,3
6.0,AVISEK ANAND JHA,Independent,9601,35,9636,0.69,3 - Godda (Jharkhand),27,3
7.0,BAJRANGI MAHTHA,Bahujan Samaj Party,8151,24,8175,0.58,3 - Godda (Jharkhand),27,3
8.0,MUKESH KUMAR JHA,Independent,7366,-,7366,0.53,3 - Godda (Jharkhand),27,3
9.0,KUMARI DILESHWARI,Ambedkarite Party of India,6578,3,6581,0.47,3 - Godda (Jharkhand),27,3
10.0,RAMESHWAR MANDAL,Peoples Party of India (Democratic),3315,1,3316,0.24,3 - Godda (Jharkhand),27,3
11.0,SURAJ KUMAR AMAN,Bhagidari Party(P),3070,3,3073,0.22,3 - Godda (Jharkhand),27,3
12.0,ARUN KUMAR,Nyaydharmsabha,2891,2,2893,0.21,3 - Godda (Jharkhand),27,3
13.0,DR. K. RANGAIAH,Independent,2205,5,2210,0.16,3 - Godda (Jharkhand),27,3
14.0,BRAJKISHORE PANDIT,Akhil Bhartiya Manavadhikar Vichar Manch Party,2102,6,2108,0.15,3 - Godda (Jharkhand),27,3
15.0,ANUP KUMAR,"Proutist Bloc, India",2003,4,2007,0.14,3 - Godda (Jharkhand),27,3
16.0,KALIPADA MURMU,Socialist Unity Centre Of India (COMMUNIST),1935,6,1941,0.14,3 - Godda (Jharkhand),27,3
17.0,KETAN KUMAR,Right to Recall Party,1896,2,1898,0.14,3 - Godda (Jharkhand),27,3
18.0,TIPLAL SAH,Lokhit Adhikar Party,1765,5,1770,0.13,3 - Godda (Jharkhand),27,3
19.0,GYANESHWAR JHA,Jagrook Janta Party,1637,3,1640,0.12,3 - Godda (Jharkhand),27,3
20.0,NOTA,None of the Above,4309,52,4361,0.31,3 - Godda (Jharkhand),27,3
,Total,,1388559,9645,1398204,,3 - Godda (Jharkhand),27,3
1.0,KALI CHARAN SINGH,Bharatiya Janata Party,568912,5644,574556,52.89,4 - Chatra (Jharkhand),27,4
2.0,KRISHNA NAND TRIPATHI,Indian National Congress,348110,5487,353597,32.55,4 - Chatra (Jharkhand),27,4
3.0,AMIT KUMAR SINGH,Independent,31976,15,31991,2.94,4 - Chatra (Jharkhand),27,4
4.0,ARJUN KUMAR,Communist Party of India,14062,60,14122,1.3,4 - Chatra (Jharkhand),27,4
5.0,DR. ABHISHEK KUMAR SINGH,Independent,14038,68,14106,1.3,4 - Chatra (Jharkhand),27,4
6.0,ARJUN PRAJAPATI,Independent,13320,8,13328,1.23,4 - Chatra (Jharkhand),27,4
7.0,DEEPAK KUMAR GUPTA,Independent,12384,182,12566,1.16,4 - Chatra (Jharkhand),27,4
8.0,NAGMANI,Bahujan Samaj Party,11798,152,11950,1.1,4 - Chatra (Jharkhand),27,4
9.0,CHANDAN KUMAR,Independent,6569,13,6582,0.61,4 - Chatra (Jharkhand),27,4
10.0,MD ABUZAR KHAN,Independent,5820,3,5823,0.54,4 - Chatra (Jharkhand),27,4
11.0,YOGESH KUMAR SINGH,Independent,5110,2,5112,0.47,4 - Chatra (Jharkhand),27,4
12.0,BIMAL LAKRA,Ambedkarite Party of India,4983,31,5014,0.46,4 - Chatra (Jharkhand),27,4
13.0,KARMLAL ORAON,Peoples Party of India (Democratic),3968,42,4010,0.37,4 - Chatra (Jharkhand),27,4
14.0,SUMIT KUMAR YADAV,Samata Party,3499,17,3516,0.32,4 - Chatra (Jharkhand),27,4
15.0,SANJAY KUMAR SNEHI,Lokhit Adhikar Party,3202,14,3216,0.3,4 - Chatra (Jharkhand),27,4
16.0,MAHESH BANDO,Bahujan Mukti Party,3159,42,3201,0.29,4 - Chatra (Jharkhand),27,4
17.0,SRIRAM SINGH,Independent,2991,2,2993,0.28,4 - Chatra (Jharkhand),27,4
18.0,DARSHAN GANJHU,Jharkhand Party,2780,37,2817,0.26,4 - Chatra (Jharkhand),27,4
19.0,DULESHWAR SAW,Bharatheeya Jawan Kisan Party,2376,9,2385,0.22,4 - Chatra (Jharkhand),27,4
20.0,LAW KUMAR PANDIT,Bhagidari Party(P),2372,8,2380,0.22,4 - Chatra (Jharkhand),27,4
21.0,KAMDEO DIHO RANA,Rashtriya Jan Utkarsh Party,2297,12,2309,0.21,4 - Chatra (Jharkhand),27,4
22.0,VIKRANT KUMAR SINGH,Independent,2288,1,2289,0.21,4 - Chatra (Jharkhand),27,4
23.0,NOTA,None of the Above,8435,76,8511,0.78,4 - Chatra (Jharkhand),27,4
,Total,,1074449,11925,1086374,,4 - Chatra (Jharkhand),27,4
1.0,ANNPURNA DEVI,Bharatiya Janata Party,787185,4472,791657,57.79,5 - Kodarma (Jharkhand),27,5
2.0,VINOD KUMAR SINGH,Communist Party of India (Marxist-Leninist) (Liberation),410945,3698,414643,30.27,5 - Kodarma (Jharkhand),27,5
3.0,MANOJ KUMAR,Independent,28310,302,28612,2.09,5 - Kodarma (Jharkhand),27,5
4.0,JAI PRAKASH VERMA,Independent,22843,380,23223,1.7,5 - Kodarma (Jharkhand),27,5
5.0,SITAN RABIDAS,Bahujan Samaj Party,13067,107,13174,0.96,5 - Kodarma (Jharkhand),27,5
6.0,SURENDRA KUMAR AGRAWAL,Independent,9646,10,9656,0.7,5 - Kodarma (Jharkhand),27,5
7.0,SAHADAT ANSARI,Independent,8217,15,8232,0.6,5 - Kodarma (Jharkhand),27,5
8.0,JAYNARAYAN DAS,Bahujan Mukti Party,6701,37,6738,0.49,5 - Kodarma (Jharkhand),27,5
9.0,AKLESHWAR SAW,Lokhit Adhikar Party,5574,27,5601,0.41,5 - Kodarma (Jharkhand),27,5
10.0,JITLAL KISKU,Independent,5299,34,5333,0.39,5 - Kodarma (Jharkhand),27,5
11.0,MD. SAGIR,Independent,5041,3,5044,0.37,5 - Kodarma (Jharkhand),27,5
12.0,AJAY KRISHNA,Moolniwasi Samaj Party,4526,15,4541,0.33,5 - Kodarma (Jharkhand),27,5
13.0,RAJESH,Independent,4230,3,4233,0.31,5 - Kodarma (Jharkhand),27,5
14.0,RAMESHWAR PRASAD YADAV,Independent,4227,2,4229,0.31,5 - Kodarma (Jharkhand),27,5
15.0,ASHISH KUMAR,Right to Recall Party,2892,4,2896,0.21,5 - Kodarma (Jharkhand),27,5
16.0,NOTA,None of the Above,42089,63,42152,3.08,5 - Kodarma (Jharkhand),27,5
,Total,,1360792,9172,1369964,,5 - Kodarma (Jharkhand),27,5
1.0,CHANDRA PRAKASH CHOUDHARY,AJSU Party,447896,3243,451139,35.67,6 - Giridih (Jharkhand),27,6
2.0,MATHURA PRASAD MAHATO,Jharkhand Mukti Morcha,367197,3062,370259,29.27,6 - Giridih (Jharkhand),27,6
3.0,JAIRAM KUMAR MAHATO,Independent,342241,5081,347322,27.46,6 - Giridih (Jharkhand),27,6
4.0,KAMAL PRASAD,Bahujan Samaj Party,13971,103,14074,1.11,6 - Giridih (Jharkhand),27,6
5.0,SUBODH KUMAR YADAV,Independent,13093,13,13106,1.04,6 - Giridih (Jharkhand),27,6
6.0,RAMESHWAR DUSADH,Independent,11011,9,11020,0.87,6 - Giridih (Jharkhand),27,6
7.0,SUNITA TUDU,Independent,10899,45,10944,0.87,6 - Giridih (Jharkhand),27,6
8.0,MD AINUL ANSARI,Bahujan Mukti Party,6919,20,6939,0.55,6 - Giridih (Jharkhand),27,6
9.0,DWARAKA PRASAD LALA,Independent,5617,10,5627,0.44,6 - Giridih (Jharkhand),27,6
10.0,KALAWATI DEVI,Independent,5414,16,5430,0.43,6 - Giridih (Jharkhand),27,6
11.0,GYANESHWAR PRASAD,Lokhit Adhikar Party,5348,8,5356,0.42,6 - Giridih (Jharkhand),27,6
12.0,SHIVJI PRASAD,Right to Recall Party,4248,6,4254,0.34,6 - Giridih (Jharkhand),27,6
13.0,PRAMOD RAM,Peoples Party of India (Democratic),3805,20,3825,0.3,6 - Giridih (Jharkhand),27,6
14.0,USHA SINGH,Independent,3703,58,3761,0.3,6 - Giridih (Jharkhand),27,6
15.0,PAPPU KUMAR NISHAD,Bhartiya Lokmat Rashtrwadi Party,3203,13,3216,0.25,6 - Giridih (Jharkhand),27,6
16.0,SUBHASH KUMAR THAKUR,Sarv Samaj Party,2513,4,2517,0.2,6 - Giridih (Jharkhand),27,6
17.0,NOTA,None of the Above,5927,117,6044,0.48,6 - Giridih (Jharkhand),27,6
,Total,,1253005,11828,1264833,,6 - Giridih (Jharkhand),27,6
1.0,DULU MAHATO,Bharatiya Janata Party,782423,6749,789172,55.26,7 - Dhanbad (Jharkhand),27,7
2.0,ANUPAMA SINGH,Indian National Congress,452358,5231,457589,32.04,7 - Dhanbad (Jharkhand),27,7
3.0,MD. EKLAK ANSARI,Independent,78885,768,79653,5.58,7 - Dhanbad (Jharkhand),27,7
4.0,JAGDISH RAWANI,Independent,27499,136,27635,1.94,7 - Dhanbad (Jharkhand),27,7
5.0,JANAK SAH GOND,Independent,12761,3,12764,0.89,7 - Dhanbad (Jharkhand),27,7
6.0,MD. ZAHIRUDDIN KHAN,Independent,6499,1,6500,0.46,7 - Dhanbad (Jharkhand),27,7
7.0,MOHAN SINGH,Bahujan Samaj Party,5594,45,5639,0.39,7 - Dhanbad (Jharkhand),27,7
8.0,TULSI MAHTO,Independent,5371,4,5375,0.38,7 - Dhanbad (Jharkhand),27,7
9.0,KAMASHEVAR PRA. VERMA,Independent,4002,2,4004,0.28,7 - Dhanbad (Jharkhand),27,7
10.0,SUNAINA KINNAR,Independent,3430,32,3462,0.24,7 - Dhanbad (Jharkhand),27,7
11.0,AKBAR ALI,Akhil Bhartiya Parivar Party,3031,10,3041,0.21,7 - Dhanbad (Jharkhand),27,7
12.0,KRISHNA CHANDRA SINGH RAJ,Samata Party,2818,3,2821,0.2,7 - Dhanbad (Jharkhand),27,7
13.0,ANINDITA DAS,Independent,2655,19,2674,0.19,7 - Dhanbad (Jharkhand),27,7
14.0,REZAUL HAQUE,Lokhit Adhikar Party,2642,7,2649,0.19,7 - Dhanbad (Jharkhand),27,7
15.0,LAKSHMI DEVI,Independent,2600,5,2605,0.18,7 - Dhanbad (Jharkhand),27,7
16.0,UMESH PASWAN,Independent,2554,6,2560,0.18,7 - Dhanbad (Jharkhand),27,7
17.0,MOHAMMAD FAISHAL KHAN,Independent,1994,2,1996,0.14,7 - Dhanbad (Jharkhand),27,7
18.0,RAJIB TIWARI,Socialist Unity Centre Of India (COMMUNIST),1880,10,1890,0.13,7 - Dhanbad (Jharkhand),27,7
19.0,DEEPAK KUMAR DAS,Peoples Party of India (Democratic),1720,15,1735,0.12,7 - Dhanbad (Jharkhand),27,7
20.0,NITAI DUTTA,Independent,1695,48,1743,0.12,7 - Dhanbad (Jharkhand),27,7
21.0,SANJAY KUMAR GIRI,Akhil Bharat Hindu Mahasabha,1617,10,1627,0.11,7 - Dhanbad (Jharkhand),27,7
22.0,PERWEZ NEYYAR,Aazad Samaj Party (Kanshi Ram),1157,4,1161,0.08,7 - Dhanbad (Jharkhand),27,7
23.0,TRIDEV KR MAHTO,Independent,1126,18,1144,0.08,7 - Dhanbad (Jharkhand),27,7
24.0,MOHAMMAD TAFAZUL HUSSAIN,Independent,681,-,681,0.05,7 - Dhanbad (Jharkhand),27,7
25.0,PREM PRAKASH PASWAN,Independent,516,17,533,0.04,7 - Dhanbad (Jharkhand),27,7
26.0,NOTA,None of the Above,7202,152,7354,0.51,7 - Dhanbad (Jharkhand),27,7
,Total,,1414710,13297,1428007,,7 - Dhanbad (Jharkhand),27,7
1.0,SANJAY SETH,Bharatiya Janata Party,658975,5757,664732,45.91,8 - Ranchi (Jharkhand),27,8
2.0,YASHASWINI SAHAY,Indian National Congress,537646,6574,544220,37.59,8 - Ranchi (Jharkhand),27,8
3.0,DEVENDRA NATH MAHTO,Independent,130526,2121,132647,9.16,8 - Ranchi (Jharkhand),27,8
4.0,SOMA SINGH,Jai Maha Bharath Party,10340,1,10341,0.71,8 - Ranchi (Jharkhand),27,8
5.0,NIPU SINGH,Rashtriya Jansangharsh Swaraj Party,7793,10,7803,0.54,8 - Ranchi (Jharkhand),27,8
6.0,DHANANJAY BHAGAT “GANDHI“,Mera Adhikaar Rashtriya Dal,6784,15,6799,0.47,8 - Ranchi (Jharkhand),27,8
7.0,SHYAM BIHARI PRAJAPATI,Bhagidari Party(P),6524,6,6530,0.45,8 - Ranchi (Jharkhand),27,8
8.0,MANOJ KUMAR,Bahujan Samaj Party,6383,44,6427,0.44,8 - Ranchi (Jharkhand),27,8
9.0,RAMHARI GOPE,Ambedkarite Party of India,6304,5,6309,0.44,8 - Ranchi (Jharkhand),27,8
10.0,ANJANI PANDEY,Independent,5386,11,5397,0.37,8 - Ranchi (Jharkhand),27,8
11.0,SARWESHWARI SAHU,Ekam Sanatan Bharat Dal,4794,8,4802,0.33,8 - Ranchi (Jharkhand),27,8
12.0,HARINATH SAHU,Lokhit Adhikar Party,4120,16,4136,0.29,8 - Ranchi (Jharkhand),27,8
13.0,HEMNTI DEVI,Samata Party,4069,11,4080,0.28,8 - Ranchi (Jharkhand),27,8
14.0,RANJANA GIRI,Republican Party of India (A),3206,2,3208,0.22,8 - Ranchi (Jharkhand),27,8
15.0,BIRENDRA NATH MANJHI,Abua Jharkhand Party,3130,25,3155,0.22,8 - Ranchi (Jharkhand),27,8
16.0,DHARMENDRA TIWARY,Bhartiya Jantantra Morcha,3072,22,3094,0.21,8 - Ranchi (Jharkhand),27,8
17.0,PRAWEEN KACHHAP,Sampoorna Bharat Kranti Party,2870,74,2944,0.2,8 - Ranchi (Jharkhand),27,8
18.0,PRABEEN CHANDRA MAHATO,Independent,2852,7,2859,0.2,8 - Ranchi (Jharkhand),27,8
19.0,SANTOSH KUMAR JAISWAL,Independent,2782,5,2787,0.19,8 - Ranchi (Jharkhand),27,8
20.0,PANKAJ KUMAR RAVI,Peoples Party of India (Democratic),2756,7,2763,0.19,8 - Ranchi (Jharkhand),27,8
21.0,MANORANJAN BHATTACHARYA,Independent,2537,2,2539,0.18,8 - Ranchi (Jharkhand),27,8
22.0,AINUL ANSARI,Independent,2533,4,2537,0.18,8 - Ranchi (Jharkhand),27,8
23.0,BINOD ORAON,Bahujan Mukti Party,2523,66,2589,0.18,8 - Ranchi (Jharkhand),27,8
24.0,MINTU PASWAN,Socialist Unity Centre Of India (COMMUNIST),2151,13,2164,0.15,8 - Ranchi (Jharkhand),27,8
25.0,KOLESHWAR MAHTO,Independent,1702,6,1708,0.12,8 - Ranchi (Jharkhand),27,8
26.0,KAMESHWAR PRASAD SAW,Independent,1644,2,1646,0.11,8 - Ranchi (Jharkhand),27,8
27.0,ARSHAD AYUB,Independent,1411,1,1412,0.1,8 - Ranchi (Jharkhand),27,8
28.0,NOTA,None of the Above,8046,107,8153,0.56,8 - Ranchi (Jharkhand),27,8
,Total,,1432859,14922,1447781,,8 - Ranchi (Jharkhand),27,8
1.0,BIDYUT BARAN MAHATO,Bharatiya Janata Party,719891,6283,726174,56.84,9 - Jamshedpur (Jharkhand),27,9
2.0,SAMIR KUMAR MOHANTY,Jharkhand Mukti Morcha,459997,6395,466392,36.5,9 - Jamshedpur (Jharkhand),27,9
3.0,INDRA DEO PRASAD,Independent,8463,6,8469,0.66,9 - Jamshedpur (Jharkhand),27,9
4.0,ARUN MAHATO,Independent,7337,7,7344,0.57,9 - Jamshedpur (Jharkhand),27,9
5.0,ANAND MUKHI,Independent,6346,6,6352,0.5,9 - Jamshedpur (Jharkhand),27,9
6.0,PRANAV KUMAR MAHTO,Bahujan Samaj Party,6090,61,6151,0.48,9 - Jamshedpur (Jharkhand),27,9
7.0,BISHWANATH MAHATO,Independent,5226,105,5331,0.42,9 - Jamshedpur (Jharkhand),27,9
8.0,ANGAD MAHATO,Amra Bangalee,4898,27,4925,0.39,9 - Jamshedpur (Jharkhand),27,9
9.0,JUJHAR SOREN,Independent,4262,53,4315,0.34,9 - Jamshedpur (Jharkhand),27,9
10.0,SUKUMAR SOREN,Bharat Adivasi Party,3860,34,3894,0.3,9 - Jamshedpur (Jharkhand),27,9
11.0,DHARMU TUDU,Ambedkarite Party of India,3274,17,3291,0.26,9 - Jamshedpur (Jharkhand),27,9
12.0,JITENDRA SINGH,Independent,3159,8,3167,0.25,9 - Jamshedpur (Jharkhand),27,9
13.0,SANAKA MAHATO,Socialist Unity Centre Of India (COMMUNIST),3137,38,3175,0.25,9 - Jamshedpur (Jharkhand),27,9
14.0,MANOJ GUPTA,Lokhit Adhikar Party,2355,7,2362,0.18,9 - Jamshedpur (Jharkhand),27,9
15.0,SADHU CHARAN PAUL,Independent,2291,26,2317,0.18,9 - Jamshedpur (Jharkhand),27,9
16.0,SAURAV VISHNU,Independent,2234,30,2264,0.18,9 - Jamshedpur (Jharkhand),27,9
17.0,SHAIKH AKHIRUDDIN,Bahujan Maha Party,2099,9,2108,0.16,9 - Jamshedpur (Jharkhand),27,9
18.0,ASHOK KUMAR,Peoples Party of India (Democratic),2038,10,2048,0.16,9 - Jamshedpur (Jharkhand),27,9
19.0,MAHESH KUMAR,Right to Recall Party,1952,8,1960,0.15,9 - Jamshedpur (Jharkhand),27,9
20.0,G JAYRAM DAS,Independent,1927,4,1931,0.15,9 - Jamshedpur (Jharkhand),27,9
21.0,ARUN KUMAR SHARMA,Bhartiya Azad Sena,1797,4,1801,0.14,9 - Jamshedpur (Jharkhand),27,9
22.0,DOMAN CHANDRA BHAKAT,Bhagidari Party(P),1343,5,1348,0.11,9 - Jamshedpur (Jharkhand),27,9
23.0,BABLU PRASAD DANGI,Independent,1144,8,1152,0.09,9 - Jamshedpur (Jharkhand),27,9
24.0,GYAN SAGAR PRASAD,Independent,1043,1,1044,0.08,9 - Jamshedpur (Jharkhand),27,9
25.0,PARWATI KISKU,Independent,972,16,988,0.08,9 - Jamshedpur (Jharkhand),27,9
26.0,NOTA,None of the Above,7105,221,7326,0.57,9 - Jamshedpur (Jharkhand),27,9
,Total,,1264240,13389,1277629,,9 - Jamshedpur (Jharkhand),27,9
1.0,JOBA MAJHI,Jharkhand Mukti Morcha,515989,4175,520164,51.62,10 - Singhbhum (Jharkhand),27,10
2.0,GEETA KORA,Bharatiya Janata Party,349006,2756,351762,34.91,10 - Singhbhum (Jharkhand),27,10
3.0,DAMODAR SINGH HANSDA,Independent,43838,454,44292,4.4,10 - Singhbhum (Jharkhand),27,10
4.0,MADHAV CHANDRA KUNKAL,Independent,19729,105,19834,1.97,10 - Singhbhum (Jharkhand),27,10
5.0,SANGRAM MARDI,Independent,16097,14,16111,1.6,10 - Singhbhum (Jharkhand),27,10
6.0,PARDESHI LAL MUNDA,Bahujan Samaj Party,8708,34,8742,0.87,10 - Singhbhum (Jharkhand),27,10
7.0,DURGA LAL MURMU,Independent,4912,12,4924,0.49,10 - Singhbhum (Jharkhand),27,10
8.0,CHITRASEN SINKU,Jharkhand Party,3188,22,3210,0.32,10 - Singhbhum (Jharkhand),27,10
9.0,BISHWA VIJAY MARDI,Ambedkarite Party of India,3067,3,3070,0.3,10 - Singhbhum (Jharkhand),27,10
10.0,ASHA KUMARI RUNDA,Independent,2736,18,2754,0.27,10 - Singhbhum (Jharkhand),27,10
11.0,KRISHNA MARDI,Jharkhand Mukti Morcha (Ulgulan),2597,18,2615,0.26,10 - Singhbhum (Jharkhand),27,10
12.0,SUDHA RANI BESRA,Peoples Party of India (Democratic),2398,11,2409,0.24,10 - Singhbhum (Jharkhand),27,10
13.0,BIR SINGH DEOGAM,Right to Recall Party,1919,8,1927,0.19,10 - Singhbhum (Jharkhand),27,10
14.0,PANMANI SINGH,Socialist Unity Centre Of India (COMMUNIST),1793,8,1801,0.18,10 - Singhbhum (Jharkhand),27,10
15.0,NOTA,None of the Above,23907,75,23982,2.38,10 - Singhbhum (Jharkhand),27,10
,Total,,999884,7713,1007597,,10 - Singhbhum (Jharkhand),27,10
1.0,KALI CHARAN MUNDA,Indian National Congress,503997,7650,511647,54.62,11 - Khunti (Jharkhand),27,11
2.0,ARJUN MUNDA,Bharatiya Janata Party,358076,3896,361972,38.64,11 - Khunti (Jharkhand),27,11
3.0,SAVITRI DEVI,Bahujan Samaj Party,12202,98,12300,1.31,11 - Khunti (Jharkhand),27,11
4.0,BASANT KUMAR LONGA,Independent,10735,20,10755,1.15,11 - Khunti (Jharkhand),27,11
5.0,ARPANA HANS,Jharkhand Party,8450,82,8532,0.91,11 - Khunti (Jharkhand),27,11
6.0,PASTAR SANJAY KUMAR TIRKEY,Independent,4944,19,4963,0.53,11 - Khunti (Jharkhand),27,11
7.0,BABITA KACHHAP,Bharat Adivasi Party,4507,87,4594,0.49,11 - Khunti (Jharkhand),27,11
8.0,NOTA,None of the Above,21814,105,21919,2.34,11 - Khunti (Jharkhand),27,11
,Total,,924725,11957,936682,,11 - Khunti (Jharkhand),27,11
1.0,SUKHDEO BHAGAT,Indian National Congress,476112,6926,483038,49.95,12 - Lohardaga (Jharkhand),27,12
2.0,SAMIR ORAON,Bharatiya Janata Party,339685,4215,343900,35.56,12 - Lohardaga (Jharkhand),27,12
3.0,CHAMRA LINDA,Independent,45082,916,45998,4.76,12 - Lohardaga (Jharkhand),27,12
4.0,MAHENDRA ORAON,Communist Party of India,16776,17,16793,1.74,12 - Lohardaga (Jharkhand),27,12
5.0,SHANIYA ORAON,Independent,10894,17,10911,1.13,12 - Lohardaga (Jharkhand),27,12
6.0,GIRJANANDAN URAON,Bahujan Samaj Party,9103,45,9148,0.95,12 - Lohardaga (Jharkhand),27,12
7.0,MARIANUS TIGGA,Independent,9100,31,9131,0.94,12 - Lohardaga (Jharkhand),27,12
8.0,STEPHAN KINDO,Independent,7594,5,7599,0.79,12 - Lohardaga (Jharkhand),27,12
9.0,BIHARI BHAGAT,Peoples Party of India (Democratic),7558,44,7602,0.79,12 - Lohardaga (Jharkhand),27,12
10.0,RANJEET BHAGAT,Independent,5510,17,5527,0.57,12 - Lohardaga (Jharkhand),27,12
11.0,RAMCHANDRA BHAGAT,Lokhit Adhikar Party,4303,7,4310,0.45,12 - Lohardaga (Jharkhand),27,12
12.0,PAWAN TIGGA,Independent,3685,28,3713,0.38,12 - Lohardaga (Jharkhand),27,12
13.0,ARPAN DEO BHAGAT,Independent,2796,18,2814,0.29,12 - Lohardaga (Jharkhand),27,12
14.0,ARJUN TOPPO,Independent,2706,41,2747,0.28,12 - Lohardaga (Jharkhand),27,12
15.0,MANI MUNDA,Bhagidari Party(P),2490,20,2510,0.26,12 - Lohardaga (Jharkhand),27,12
16.0,NOTA,None of the Above,11304,80,11384,1.18,12 - Lohardaga (Jharkhand),27,12
,Total,,954698,12427,967125,,12 - Lohardaga (Jharkhand),27,12
1.0,VISHNU DAYAL RAM,Bharatiya Janata Party,762290,8072,770362,55.39,13 - Palamau (Jharkhand),27,13
2.0,MAMTA BHUIYAN,Rashtriya Janata Dal,473668,7887,481555,34.63,13 - Palamau (Jharkhand),27,13
3.0,KAMESHWAR BAITHA,Bahujan Samaj Party,39267,733,40000,2.88,13 - Palamau (Jharkhand),27,13
4.0,SANAN RAM,Lokhit Adhikar Party,17849,26,17875,1.29,13 - Palamau (Jharkhand),27,13
5.0,GANESH RAVI,Independent,17669,30,17699,1.27,13 - Palamau (Jharkhand),27,13
6.0,BRAJESH KUMAR TURI,Rashtriya Samanta Dal,17542,24,17566,1.26,13 - Palamau (Jharkhand),27,13
7.0,VRINDA RAM,Peoples Party of India (Democratic),11205,65,11270,0.81,13 - Palamau (Jharkhand),27,13
8.0,MAHENDRA BAITHA,Socialist Unity Centre Of India (COMMUNIST),5097,18,5115,0.37,13 - Palamau (Jharkhand),27,13
9.0,RAM VACHAN RAM,Bahujan Mukti Party,4924,29,4953,0.36,13 - Palamau (Jharkhand),27,13
10.0,NOTA,None of the Above,24226,117,24343,1.75,13 - Palamau (Jharkhand),27,13
,Total,,1373737,17001,1390738,,13 - Palamau (Jharkhand),27,13
1.0,MANISH JAISWAL,Bharatiya Janata Party,647416,7197,654613,51.76,14 - Hazaribagh (Jharkhand),27,14
2.0,JAI PRAKASH BHAI PATEL,Indian National Congress,371641,6286,377927,29.88,14 - Hazaribagh (Jharkhand),27,14
3.0,SANJAY KUMAR MEHTA,Independent,156298,1679,157977,12.49,14 - Hazaribagh (Jharkhand),27,14
4.0,SHASHI BHUSHAN KESHRI,Independent,15373,13,15386,1.22,14 - Hazaribagh (Jharkhand),27,14
5.0,ANIRUDDH KUMAR,Communist Party of India,10428,40,10468,0.83,14 - Hazaribagh (Jharkhand),27,14
6.0,MD. MOIN UDDIN AHMAD,Bahujan Samaj Party,7395,43,7438,0.59,14 - Hazaribagh (Jharkhand),27,14
7.0,MD. SERAJ,Independent,5503,3,5506,0.44,14 - Hazaribagh (Jharkhand),27,14
8.0,VINOD KUMAR RANA,Independent,4831,10,4841,0.38,14 - Hazaribagh (Jharkhand),27,14
9.0,KUNJ BIHARI KUMAR,Lokhit Adhikar Party,4220,14,4234,0.33,14 - Hazaribagh (Jharkhand),27,14
10.0,CHHATHI DEVI,Akhil Bhartiya Parivar Party,3296,20,3316,0.26,14 - Hazaribagh (Jharkhand),27,14
11.0,ABHISHEK KUMAR,Independent,2963,9,2972,0.24,14 - Hazaribagh (Jharkhand),27,14
12.0,NISHANT KUMAR SINHA,Peoples Party of India (Democratic),2932,24,2956,0.23,14 - Hazaribagh (Jharkhand),27,14
13.0,MANOJ KUMAR BEDIA,Independent,2559,19,2578,0.2,14 - Hazaribagh (Jharkhand),27,14
14.0,BHUNESHWAR BEDIYA,Samata Party,2236,28,2264,0.18,14 - Hazaribagh (Jharkhand),27,14
15.0,RAJ KUMAR,Jharkhand Party,1885,50,1935,0.15,14 - Hazaribagh (Jharkhand),27,14
16.0,SHYAM BIHARI PRAJAPATI,Bhagidari Party(P),1818,21,1839,0.15,14 - Hazaribagh (Jharkhand),27,14
17.0,PRAKASH SONI,Bhartiya Azad Sena,1209,8,1217,0.1,14 - Hazaribagh (Jharkhand),27,14
18.0,NOTA,None of the Above,7090,110,7200,0.57,14 - Hazaribagh (Jharkhand),27,14
,Total,,1249093,15574,1264667,,14 - Hazaribagh (Jharkhand),27,14
1.0,MALA RAJYA LAKSHMI SHAH,Bharatiya Janata Party,455949,6654,462603,53.66,1 - Tehri Garhwal (Uttarakhand),28,1
2.0,JOT SINGH GUNSOLA,Indian National Congress,187602,2508,190110,22.05,1 - Tehri Garhwal (Uttarakhand),28,1
3.0,BOBY PANWAR,Independent,162469,5612,168081,19.5,1 - Tehri Garhwal (Uttarakhand),28,1
4.0,NAVNEET SINGH GOSAIN,Rashtriya Uttarakhand Party,9969,57,10026,1.16,1 - Tehri Garhwal (Uttarakhand),28,1
5.0,NEMCHAND,Bahujan Samaj Party,6786,122,6908,0.8,1 - Tehri Garhwal (Uttarakhand),28,1
6.0,BRIJ BHUSHAN KARANWAL,Bhartiya Rashtriya Ekta Dal,3545,25,3570,0.41,1 - Tehri Garhwal (Uttarakhand),28,1
7.0,SARDAR KHAN PAPPU,Independent,3268,7,3275,0.38,1 - Tehri Garhwal (Uttarakhand),28,1
8.0,VEPIN KUMAR AGGARWAL,Independent,3173,43,3216,0.37,1 - Tehri Garhwal (Uttarakhand),28,1
9.0,RAMPAL SINGH,Peoples Party of India (Democratic),2343,19,2362,0.27,1 - Tehri Garhwal (Uttarakhand),28,1
10.0,SUDESH TOMAR,Independent,2261,7,2268,0.26,1 - Tehri Garhwal (Uttarakhand),28,1
11.0,PREM DUTT SEMWAL,Independent,2134,30,2164,0.25,1 - Tehri Garhwal (Uttarakhand),28,1
12.0,NOTA,None of the Above,7304,154,7458,0.87,1 - Tehri Garhwal (Uttarakhand),28,1
,Total,,846803,15238,862041,,1 - Tehri Garhwal (Uttarakhand),28,1
1.0,ANIL BALUNI,Bharatiya Janata Party,418531,13628,432159,58.6,2 - Garhwal (Uttarakhand),28,2
2.0,GANESH GODIYAL,Indian National Congress,262692,5964,268656,36.43,2 - Garhwal (Uttarakhand),28,2
3.0,SONU KUMAR,Independent,4803,19,4822,0.65,2 - Garhwal (Uttarakhand),28,2
4.0,ASHUTOSH SINGH,Uttarakhand Kranti Dal,4182,379,4561,0.62,2 - Garhwal (Uttarakhand),28,2
5.0,DHEER SINGH,Bahujan Samaj Party,4007,115,4122,0.56,2 - Garhwal (Uttarakhand),28,2
6.0,MUKESH PRAKASH,Independent,3064,15,3079,0.42,2 - Garhwal (Uttarakhand),28,2
7.0,SURESHI DEVI,Peoples Party of India (Democratic),1472,40,1512,0.21,2 - Garhwal (Uttarakhand),28,2
8.0,DEEPENDRA SINGH NEGI,Independent,1408,232,1640,0.22,2 - Garhwal (Uttarakhand),28,2
9.0,ARJUN SINGH,Akhil Bhartiya Parivar Party,1308,70,1378,0.19,2 - Garhwal (Uttarakhand),28,2
10.0,RESHMA PANWAR,Socialist Unity Centre Of India (COMMUNIST),1168,125,1293,0.18,2 - Garhwal (Uttarakhand),28,2
11.0,DR MUKESH PANT,Sainik Samaj Party,1121,58,1179,0.16,2 - Garhwal (Uttarakhand),28,2
12.0,VINOD KUMAR SHARMA,Uttarakhand Samanta Party,838,46,884,0.12,2 - Garhwal (Uttarakhand),28,2
13.0,SHYAMLAL,Bahujan Mukti Party,743,28,771,0.1,2 - Garhwal (Uttarakhand),28,2
14.0,NOTA,None of the Above,11224,151,11375,1.54,2 - Garhwal (Uttarakhand),28,2
,Total,,716561,20870,737431,,2 - Garhwal (Uttarakhand),28,2
1.0,AJAY TAMTA,Bharatiya Janata Party,417535,11632,429167,64.2,3 - Almora (Uttarakhand),28,3
2.0,PRADEEP TAMTA,Indian National Congress,191642,3428,195070,29.18,3 - Almora (Uttarakhand),28,3
3.0,NARAYAN RAM,Bahujan Samaj Party,9840,235,10075,1.51,3 - Almora (Uttarakhand),28,3
4.0,KIRAN ARYA,Uttarakhand Parivartan Party,5528,250,5778,0.86,3 - Almora (Uttarakhand),28,3
5.0,ARJUN PRASAD,Independent,4591,116,4707,0.7,3 - Almora (Uttarakhand),28,3
6.0,DR PRAMOD KUMAR,Peoples Party of India (Democratic),4401,56,4457,0.67,3 - Almora (Uttarakhand),28,3
7.0,ER JYOTI PRAKASH TAMTA,Bahujan Mukti Party,2178,46,2224,0.33,3 - Almora (Uttarakhand),28,3
8.0,NOTA,None of the Above,16697,322,17019,2.55,3 - Almora (Uttarakhand),28,3
,Total,,652412,16085,668497,,3 - Almora (Uttarakhand),28,3
1.0,AJAY BHATT,Bharatiya Janata Party,766397,6274,772671,61.03,4 - Nainital-Udhamsingh Nagar (Uttarakhand),28,4
2.0,PRAKASH JOSHI,Indian National Congress,434916,3207,438123,34.61,4 - Nainital-Udhamsingh Nagar (Uttarakhand),28,4
3.0,AKHTAR ALI,Bahujan Samaj Party,23276,179,23455,1.85,4 - Nainital-Udhamsingh Nagar (Uttarakhand),28,4
4.0,AKHALESH KUMAR,Akhil Bhartiya Parivar Party,4871,31,4902,0.39,4 - Nainital-Udhamsingh Nagar (Uttarakhand),28,4
5.0,HITESH PATHAK,Independent,4287,28,4315,0.34,4 - Nainital-Udhamsingh Nagar (Uttarakhand),28,4
6.0,RAMESH KUMAR MAX,Independent,3271,29,3300,0.26,4 - Nainital-Udhamsingh Nagar (Uttarakhand),28,4
7.0,AMAR SINGH SAINI,Peoples Party of India (Democratic),2963,24,2987,0.24,4 - Nainital-Udhamsingh Nagar (Uttarakhand),28,4
8.0,JEEVAN CHANDRA UPRETI,Bharat Ki Lok Jimmedar Party,2292,18,2310,0.18,4 - Nainital-Udhamsingh Nagar (Uttarakhand),28,4
9.0,SHIB SINGH,Uttarakhand Kranti Dal,1809,46,1855,0.15,4 - Nainital-Udhamsingh Nagar (Uttarakhand),28,4
10.0,SURENDRA SINGH,Bhartiya Shakti Chetna Party,1655,18,1673,0.13,4 - Nainital-Udhamsingh Nagar (Uttarakhand),28,4
11.0,NOTA,None of the Above,10227,198,10425,0.82,4 - Nainital-Udhamsingh Nagar (Uttarakhand),28,4
,Total,,1255964,10052,1266016,,4 - Nainital-Udhamsingh Nagar (Uttarakhand),28,4
1.0,TRIVENDRA SINGH RAWAT,Bharatiya Janata Party,648498,5310,653808,50.19,5 - Haridwar (Uttarakhand),28,5
2.0,VIRENDRA RAWAT,Indian National Congress,487406,2346,489752,37.6,5 - Haridwar (Uttarakhand),28,5
3.0,UMESH KUMAR PATRAKAR,Independent,89958,1230,91188,7.0,5 - Haridwar (Uttarakhand),28,5
4.0,JAMIL AHMAD,Bahujan Samaj Party,42116,207,42323,3.25,5 - Haridwar (Uttarakhand),28,5
5.0,BALBIR SINGH BHANDARI,Uttarakhand Samanta Party,2943,18,2961,0.23,5 - Haridwar (Uttarakhand),28,5
6.0,MOHAN SINGH ASWAL,Uttarakhand Kranti Dal,2809,45,2854,0.22,5 - Haridwar (Uttarakhand),28,5
7.0,VIJAY KUMAR,Independent,2409,1,2410,0.19,5 - Haridwar (Uttarakhand),28,5
8.0,PAWAN KASHYAP,Independent,2170,8,2178,0.17,5 - Haridwar (Uttarakhand),28,5
9.0,KARAN SINGH SAINI ENGINEER,Independent,1963,11,1974,0.15,5 - Haridwar (Uttarakhand),28,5
10.0,AKRAM HUSSAIN,Independent,1678,7,1685,0.13,5 - Haridwar (Uttarakhand),28,5
11.0,LALIT KUMAR,Peoples Party of India (Democratic),1396,14,1410,0.11,5 - Haridwar (Uttarakhand),28,5
12.0,SURESH PAL,Bhartiya Rashtriya Ekta Dal,1150,12,1162,0.09,5 - Haridwar (Uttarakhand),28,5
13.0,ASHISH DHYANI,Independent,1107,10,1117,0.09,5 - Haridwar (Uttarakhand),28,5
14.0,AVNISH KUMAR,Independent,967,8,975,0.07,5 - Haridwar (Uttarakhand),28,5
15.0,NOTA,None of the Above,6663,163,6826,0.52,5 - Haridwar (Uttarakhand),28,5
,Total,,1293233,9390,1302623,,5 - Haridwar (Uttarakhand),28,5
1.0,GODAM NAGESH,Bharatiya Janata Party,558936,9232,568168,45.98,1 - Adilabad (Telangana),29,1
2.0,ATHRAM SUGUNA,Indian National Congress,472333,5183,477516,38.65,1 - Adilabad (Telangana),29,1
3.0,ATHRAM SAKKU,Bharat Rashtra Samithi,136463,837,137300,11.11,1 - Adilabad (Telangana),29,1
4.0,MALOTHU SYAMLAL NAYAK,Alliance of Democratic Reforms Party,7489,10,7499,0.61,1 - Adilabad (Telangana),29,1
5.0,MESRAM JANGUBAPU,Bahujan Samaj Party,6689,55,6744,0.55,1 - Adilabad (Telangana),29,1
6.0,RATHOD SUBASH,Independent,6434,94,6528,0.53,1 - Adilabad (Telangana),29,1
7.0,BUKYA JAIVANTH RAO,Independent,6427,19,6446,0.52,1 - Adilabad (Telangana),29,1
8.0,CHAVAN SUDHARSHAN,Anna YSR Congress Party,4618,26,4644,0.38,1 - Adilabad (Telangana),29,1
9.0,GANGADEVI MESRAM,Dharma Samaj Party,3445,23,3468,0.28,1 - Adilabad (Telangana),29,1
10.0,N. TIRUPATI,Vidhyarthula Rajakiya Party,2284,8,2292,0.19,1 - Adilabad (Telangana),29,1
11.0,KODAPA VAMAN RAO,Gondwana Dandkaranya Party,1677,8,1685,0.14,1 - Adilabad (Telangana),29,1
12.0,GEDAM. SAGAR,India Praja Bandhu Party,1537,8,1545,0.13,1 - Adilabad (Telangana),29,1
13.0,NOTA,None of the Above,11650,112,11762,0.95,1 - Adilabad (Telangana),29,1
,Total,,1219982,15615,1235597,,1 - Adilabad (Telangana),29,1
1.0,VAMSI KRISHNA GADDAM,Indian National Congress,470180,5407,475587,43.42,2 - Peddapalle (Telangana),29,2
2.0,SRINIVAS GOMASE,Bharatiya Janata Party,339107,5116,344223,31.43,2 - Peddapalle (Telangana),29,2
3.0,ESHWAR KOPPULA,Bharat Rashtra Samithi,191891,1465,193356,17.65,2 - Peddapalle (Telangana),29,2
4.0,ERUKULLA RAJA NARSAIAH,Bahujan Samaj Party,6730,69,6799,0.62,2 - Peddapalle (Telangana),29,2
5.0,VENUGOPAL MOYYI,Bahujan Mukti Party,5220,3,5223,0.48,2 - Peddapalle (Telangana),29,2
6.0,MOTHE NARESH,Peoples Party of India (Democratic),4998,9,5007,0.46,2 - Peddapalle (Telangana),29,2
7.0,RAMESH MANDA,Dharma Samaj Party,4314,20,4334,0.4,2 - Peddapalle (Telangana),29,2
8.0,AMBOJU SUMALATHA,Alliance of Democratic Reforms Party,3770,13,3783,0.35,2 - Peddapalle (Telangana),29,2
9.0,DURGAM RAMULU,Independent,3432,2,3434,0.31,2 - Peddapalle (Telangana),29,2
10.0,MULKALLA RAJENDRAPRASAD,Independent,2786,3,2789,0.25,2 - Peddapalle (Telangana),29,2
11.0,RAMCHANDAR NICHHAKOLA,Dalita Bahujana Party,2589,40,2629,0.24,2 - Peddapalle (Telangana),29,2
12.0,KANDI CHANDU,Rashtriya Manav Party,2409,1,2410,0.22,2 - Peddapalle (Telangana),29,2
13.0,RAMULA KARTHIK,Independent,2284,4,2288,0.21,2 - Peddapalle (Telangana),29,2
14.0,MOLUGU VENKATESH,New India Party,2234,35,2269,0.21,2 - Peddapalle (Telangana),29,2
15.0,ERUGURALA BHAGYALAXMI,Pyramid Party of India,2113,12,2125,0.19,2 - Peddapalle (Telangana),29,2
16.0,GADDAM MARUTHI,Independent,2073,8,2081,0.19,2 - Peddapalle (Telangana),29,2
17.0,NAVEEN NUKALA,Independent,2057,10,2067,0.19,2 - Peddapalle (Telangana),29,2
18.0,MEKALA AKSHAY KUMAR,Independent,1899,3,1902,0.17,2 - Peddapalle (Telangana),29,2
19.0,KATKURI SANDEEP,Independent,1867,5,1872,0.17,2 - Peddapalle (Telangana),29,2
20.0,BOTLA CHANDRAIAH,Independent,1744,3,1747,0.16,2 - Peddapalle (Telangana),29,2
21.0,ERIKILLA RAJESH,Independent,1731,3,1734,0.16,2 - Peddapalle (Telangana),29,2
22.0,AKKAPAKA THIRUPATHI,Independent,1662,7,1669,0.15,2 - Peddapalle (Telangana),29,2
23.0,DURGAM SANTHOSH,Prajarajya Samithi,1576,38,1614,0.15,2 - Peddapalle (Telangana),29,2
24.0,MAMIDIPALLY BAPAIAH,Independent,1501,3,1504,0.14,2 - Peddapalle (Telangana),29,2
25.0,DUDA MAHIPAL,Independent,1495,1,1496,0.14,2 - Peddapalle (Telangana),29,2
26.0,BOODIDHA THIRUPATHI,Independent,1392,1,1393,0.13,2 - Peddapalle (Telangana),29,2
27.0,DAGAM SRINIVAS,Independent,1384,4,1388,0.13,2 - Peddapalle (Telangana),29,2
28.0,KADASI SHEKHAR,Independent,1266,6,1272,0.12,2 - Peddapalle (Telangana),29,2
29.0,DR VASARLA NATHANIAL,Independent,1195,22,1217,0.11,2 - Peddapalle (Telangana),29,2
30.0,AARNAKONDA RAJU,Independent,1160,7,1167,0.11,2 - Peddapalle (Telangana),29,2
31.0,NARESH JANAGAMA,Independent,1117,6,1123,0.1,2 - Peddapalle (Telangana),29,2
32.0,CHILUKA ANAND,Yuva Taram Party,1089,4,1093,0.1,2 - Peddapalle (Telangana),29,2
33.0,TALLAPALLY NARESH,Independent,967,1,968,0.09,2 - Peddapalle (Telangana),29,2
34.0,KURMA MAHENDER,Independent,863,2,865,0.08,2 - Peddapalle (Telangana),29,2
35.0,CHANDANAGIRI SHRINIVAS,Independent,766,-,766,0.07,2 - Peddapalle (Telangana),29,2
36.0,KASHI SATHISH KUMAR,Anti Corruption Dynamic Party,745,6,751,0.07,2 - Peddapalle (Telangana),29,2
37.0,KANAKAIAH MULKALA,Socialist Party (India),709,11,720,0.07,2 - Peddapalle (Telangana),29,2
38.0,SRINIVAS PANTHUKALA,Independent,701,2,703,0.06,2 - Peddapalle (Telangana),29,2
39.0,KONKATI LINGA MURTHI,Independent,659,2,661,0.06,2 - Peddapalle (Telangana),29,2
40.0,JUPAKA KIRAN,Independent,649,4,653,0.06,2 - Peddapalle (Telangana),29,2
41.0,RAJKUMAR DURGAM,Independent,478,1,479,0.04,2 - Peddapalle (Telangana),29,2
42.0,RAJESHAM RACHARLA,Independent,422,1,423,0.04,2 - Peddapalle (Telangana),29,2
43.0,NOTA,None of the Above,5591,120,5711,0.52,2 - Peddapalle (Telangana),29,2
,Total,,1082815,12480,1095295,,2 - Peddapalle (Telangana),29,2
1.0,BANDI SANJAY KUMAR,Bharatiya Janata Party,578827,6289,585116,44.57,3 - Karimnagar (Telangana),29,3
2.0,VELCHALA RAJENDER RAO,Indian National Congress,357446,2461,359907,27.41,3 - Karimnagar (Telangana),29,3
3.0,VINOD KUMAR BOIANAPALLI,Bharat Rashtra Samithi,280867,1296,282163,21.49,3 - Karimnagar (Telangana),29,3
4.0,ABBADI BUCHI REDDY,Independent,11602,10,11612,0.88,3 - Karimnagar (Telangana),29,3
5.0,ARUNA THALLAPALLY,Alliance of Democratic Reforms Party,9043,21,9064,0.69,3 - Karimnagar (Telangana),29,3
6.0,KOTA SHYAM KUMAR,Independent,8744,12,8756,0.67,3 - Karimnagar (Telangana),29,3
7.0,ANOSE KATKOORI,Independent,8699,7,8706,0.66,3 - Karimnagar (Telangana),29,3
8.0,MAREPALLI MOGILAIAH,Bahujan Samaj Party,8010,99,8109,0.62,3 - Karimnagar (Telangana),29,3
9.0,RAJENDER POTHURI,Independent,3250,7,3257,0.25,3 - Karimnagar (Telangana),29,3
10.0,SRAVAN PEDDAPELLY,Bharathiya YuvaKula Dalam,3068,6,3074,0.23,3 - Karimnagar (Telangana),29,3
11.0,GADDA SATHISH,Independent,2936,9,2945,0.22,3 - Karimnagar (Telangana),29,3
12.0,ANILREDDY KADTHALA,National Nava Kranthi Party,2747,7,2754,0.21,3 - Karimnagar (Telangana),29,3
13.0,CHILUVERU SRIKANTH,Dharma Samaj Party,2553,33,2586,0.2,3 - Karimnagar (Telangana),29,3
14.0,AKSHAY KUMAR MEKALA,Independent,2219,5,2224,0.17,3 - Karimnagar (Telangana),29,3
15.0,JOURNALIST VIKRAM REDDY VEMULAA,Independent,2090,6,2096,0.16,3 - Karimnagar (Telangana),29,3
16.0,ASHOK PANCHIKA,Social Justice Party of India,1914,10,1924,0.15,3 - Karimnagar (Telangana),29,3
17.0,GAVVALA LAXMI,Independent,1738,6,1744,0.13,3 - Karimnagar (Telangana),29,3
18.0,GATTAIAH YADAV BARIGE,Independent,1688,6,1694,0.13,3 - Karimnagar (Telangana),29,3
19.0,RANAPRATAP GATTU,Socialist Party (India),1606,7,1613,0.12,3 - Karimnagar (Telangana),29,3
20.0,GUDISHE MOHAN,Independent,1471,3,1474,0.11,3 - Karimnagar (Telangana),29,3
21.0,MANASA PERALA,Independent,1106,19,1125,0.09,3 - Karimnagar (Telangana),29,3
22.0,PODISHETTI SAMMAIAH,Bahujan Mukti Party,994,-,994,0.08,3 - Karimnagar (Telangana),29,3
23.0,VENKATANARSAIAH DYAGALA @ DEGALA,Independent,926,2,928,0.07,3 - Karimnagar (Telangana),29,3
24.0,SHIVARATRI SRINIVAS,Independent,887,2,889,0.07,3 - Karimnagar (Telangana),29,3
25.0,CHINTHA ANILKUMAR,Pyramid Party of India,823,7,830,0.06,3 - Karimnagar (Telangana),29,3
26.0,CHEEKOTI VARUN KUMAR GUPTA,Telugu Congress Party,783,7,790,0.06,3 - Karimnagar (Telangana),29,3
27.0,RAPOLE RAMKUMAR BHARADWAJ,Independent,572,3,575,0.04,3 - Karimnagar (Telangana),29,3
28.0,DEVUNOORI SRINIVASU,Independent,465,-,465,0.04,3 - Karimnagar (Telangana),29,3
29.0,NOTA,None of the Above,5373,65,5438,0.41,3 - Karimnagar (Telangana),29,3
,Total,,1302447,10405,1312852,,3 - Karimnagar (Telangana),29,3
1.0,ARVIND DHARMAPURI,Bharatiya Janata Party,588244,4074,592318,48.02,4 - Nizamabad (Telangana),29,4
2.0,JEEVANREDDY THATIPARTHI,Indian National Congress,480501,2576,483077,39.16,4 - Nizamabad (Telangana),29,4
3.0,GOVERDHAN BAJIREDDY,Bharat Rashtra Samithi,101929,477,102406,8.3,4 - Nizamabad (Telangana),29,4
4.0,GANTA CHARITHA RAO,Independent,5707,3,5710,0.46,4 - Nizamabad (Telangana),29,4
5.0,YOUGENDAR GATLA,Alliance of Democratic Reforms Party,5439,14,5453,0.44,4 - Nizamabad (Telangana),29,4
6.0,KOTAGIRI SRINIVAS,Independent,5308,4,5312,0.43,4 - Nizamabad (Telangana),29,4
7.0,PUPPALA LIMBADRI,Bahujan Samaj Party,4220,43,4263,0.35,4 - Nizamabad (Telangana),29,4
8.0,TUTUKURU JEEVAN REDDY,Independent,4085,6,4091,0.33,4 - Nizamabad (Telangana),29,4
9.0,KANDELA SUMAN,Dharma Samaj Party,3842,44,3886,0.32,4 - Nizamabad (Telangana),29,4
10.0,GOLI. NARESH,Dalita Bahujana Party,3017,7,3024,0.25,4 - Nizamabad (Telangana),29,4
11.0,ARE RAJENDHAR,Independent,2906,1,2907,0.24,4 - Nizamabad (Telangana),29,4
12.0,KOTHAKONDA SHAKTI PRASAD,Independent,2103,3,2106,0.17,4 - Nizamabad (Telangana),29,4
13.0,VEMULAA VIKRAM REDDY,Independent,2073,1,2074,0.17,4 - Nizamabad (Telangana),29,4
14.0,GOPI CHENDRIAH,Independent,1721,2,1723,0.14,4 - Nizamabad (Telangana),29,4
15.0,ALI MANSOOR,Anna YSR Congress Party,1454,14,1468,0.12,4 - Nizamabad (Telangana),29,4
16.0,GUYYA SAIKRISHNA MURTHY,Yuga Thulasi Party,1123,6,1129,0.09,4 - Nizamabad (Telangana),29,4
17.0,SYED ASGAR,Independent,1046,2,1048,0.08,4 - Nizamabad (Telangana),29,4
18.0,MALAVAT VITHAL,Independent,919,-,919,0.07,4 - Nizamabad (Telangana),29,4
19.0,MOGILI RAJKUMAR,India Praja Bandhu Party,825,5,830,0.07,4 - Nizamabad (Telangana),29,4
20.0,RAPELLY SRINIVAS,Independent,791,2,793,0.06,4 - Nizamabad (Telangana),29,4
21.0,DESHABOINA LAXMINARAYANA,Independent,723,-,723,0.06,4 - Nizamabad (Telangana),29,4
22.0,ABBAGONI ASHOK GOUD,Bahujana Left Party,641,8,649,0.05,4 - Nizamabad (Telangana),29,4
23.0,DEVATHI SRINIVAS,Bahujan Mukti Party,624,12,636,0.05,4 - Nizamabad (Telangana),29,4
24.0,B B NAIK,Independent,581,-,581,0.05,4 - Nizamabad (Telangana),29,4
25.0,BHUKYA. NANDU,Vidhyarthula Rajakiya Party,574,6,580,0.05,4 - Nizamabad (Telangana),29,4
26.0,RAPALLY SATYANARAYANA,Independent,425,1,426,0.03,4 - Nizamabad (Telangana),29,4
27.0,RAGI ANIL,Independent,367,8,375,0.03,4 - Nizamabad (Telangana),29,4
28.0,PALAMURI SAI NIKHIL,Independent,303,4,307,0.02,4 - Nizamabad (Telangana),29,4
29.0,PRASHANTH KATRAJI,Independent,284,-,284,0.02,4 - Nizamabad (Telangana),29,4
30.0,NOTA,None of the Above,4440,43,4483,0.36,4 - Nizamabad (Telangana),29,4
,Total,,1226215,7366,1233581,,4 - Nizamabad (Telangana),29,4
1.0,SURESH KUMAR SHETKAR,Indian National Congress,523919,4499,528418,42.73,5 - Zahirabad (Telangana),29,5
2.0,B. B. PATIL,Bharatiya Janata Party,476023,6207,482230,39.0,5 - Zahirabad (Telangana),29,5
3.0,ANILKUMAR GALI,Bharat Rashtra Samithi,171412,666,172078,13.92,5 - Zahirabad (Telangana),29,5
4.0,KOTHA BALIJA BASWARAJ,Telangana Praja Shakthi Party,8362,11,8373,0.68,5 - Zahirabad (Telangana),29,5
5.0,CHAVAGANI MANI,Alliance of Democratic Reforms Party,6295,14,6309,0.51,5 - Zahirabad (Telangana),29,5
6.0,YAKUB SHARIF MD,Independent,5484,5,5489,0.44,5 - Zahirabad (Telangana),29,5
7.0,MAHADHEV SWAMI MATAM,Independent,5408,4,5412,0.44,5 - Zahirabad (Telangana),29,5
8.0,B. MARUTHI RAO,Independent,4248,4,4252,0.34,5 - Zahirabad (Telangana),29,5
9.0,S. RAJU,Independent,3511,3,3514,0.28,5 - Zahirabad (Telangana),29,5
10.0,SATYANARAYANA GOUD KOVURI,Independent,2875,1,2876,0.23,5 - Zahirabad (Telangana),29,5
11.0,RAMESH. SAJJAPUR.,Independent,2477,2,2479,0.2,5 - Zahirabad (Telangana),29,5
12.0,KAMMARI ANANDEESHWAR,Independent,2381,3,2384,0.19,5 - Zahirabad (Telangana),29,5
13.0,JAIPAL NAYAK JADAVATH,Independent,2217,51,2268,0.18,5 - Zahirabad (Telangana),29,5
14.0,GURRAPU MACHANDER,All India Forward Bloc,1760,9,1769,0.14,5 - Zahirabad (Telangana),29,5
15.0,T.D.S. MANI,Dharma Samaj Party,1628,27,1655,0.13,5 - Zahirabad (Telangana),29,5
16.0,MOHD SADDAM,Independent,1567,1,1568,0.13,5 - Zahirabad (Telangana),29,5
17.0,MALEPU MOHAN REDDY,Pyramid Party of India,1095,7,1102,0.09,5 - Zahirabad (Telangana),29,5
18.0,ASHOK TALARI,Independent,831,6,837,0.07,5 - Zahirabad (Telangana),29,5
19.0,ROMALA BABU DURGAIAH,India Praja Bandhu Party,601,2,603,0.05,5 - Zahirabad (Telangana),29,5
20.0,NOTA,None of the Above,2933,44,2977,0.24,5 - Zahirabad (Telangana),29,5
,Total,,1225027,11566,1236593,,5 - Zahirabad (Telangana),29,5
1.0,MADHAVANENI RAGHUNANDAN RAO,Bharatiya Janata Party,463777,7440,471217,33.99,6 - Medak (Telangana),29,6
2.0,NEELAM MADHU,Indian National Congress,427899,4179,432078,31.17,6 - Medak (Telangana),29,6
3.0,P. VENKATRAMA REDDY,Bharat Rashtra Samithi,395250,1540,396790,28.62,6 - Medak (Telangana),29,6
4.0,NANDA KISHORE TALLADA,Alliance of Democratic Reforms Party,17191,25,17216,1.24,6 - Medak (Telangana),29,6
5.0,SARA YADAGIRI GOUD,Praja Velugu Party,11056,4,11060,0.8,6 - Medak (Telangana),29,6
6.0,BODAPATLA ESHWAR,Bahujan Samaj Party,7423,40,7463,0.54,6 - Medak (Telangana),29,6
7.0,DUBALA SRI SAILAM,Independent,5161,5,5166,0.37,6 - Medak (Telangana),29,6
8.0,ADLA KUMAR,Independent,5113,3,5116,0.37,6 - Medak (Telangana),29,6
9.0,BANDAPALLY SRINIVAS,Socialist Unity Centre Of India (COMMUNIST),2366,-,2366,0.17,6 - Medak (Telangana),29,6
10.0,ANIL GOUD,Bharat Jodo Party,2128,4,2132,0.15,6 - Medak (Telangana),29,6
11.0,ABHILASH CHELIMELA,Independent,2031,-,2031,0.15,6 - Medak (Telangana),29,6
12.0,ATI ANJANEYULU,Independent,2029,9,2038,0.15,6 - Medak (Telangana),29,6
13.0,MAISANGARI SUNIL,India Praja Bandhu Party,2009,2,2011,0.15,6 - Medak (Telangana),29,6
14.0,PRADEEP,Independent,2006,4,2010,0.14,6 - Medak (Telangana),29,6
15.0,INDRAGOUD SILIVERI,National Nava Kranthi Party,1773,1,1774,0.13,6 - Medak (Telangana),29,6
16.0,NAGAMANI ACHA,Independent,1538,2,1540,0.11,6 - Medak (Telangana),29,6
17.0,A. KRANTHI KUMAR,Independent,1465,2,1467,0.11,6 - Medak (Telangana),29,6
18.0,MAREPALLY LAXMINARAYANA,Independent,1411,3,1414,0.1,6 - Medak (Telangana),29,6
19.0,BALESH UPPARI,Independent,1390,3,1393,0.1,6 - Medak (Telangana),29,6
20.0,VENKATESH BEJUGAM,Independent,1263,1,1264,0.09,6 - Medak (Telangana),29,6
21.0,BOMMALA VIJAY KUMAR,Independent,1194,2,1196,0.09,6 - Medak (Telangana),29,6
22.0,ANNELA LAXMAN,Dharma Samaj Party,1143,9,1152,0.08,6 - Medak (Telangana),29,6
23.0,ABHILASH SHIRNA,Independent,923,1,924,0.07,6 - Medak (Telangana),29,6
24.0,DODLA VENKAT,Telangana Praja Shakthi Party,915,2,917,0.07,6 - Medak (Telangana),29,6
25.0,ABISHEK GOUD THABETI,Jana Shankhaaraavam Party,792,5,797,0.06,6 - Medak (Telangana),29,6
26.0,MEDI SRINIVAS REDDI,Independent,791,2,793,0.06,6 - Medak (Telangana),29,6
27.0,VUTLA RAMESH,Independent,778,-,778,0.06,6 - Medak (Telangana),29,6
28.0,D. NARAHARI,Independent,674,1,675,0.05,6 - Medak (Telangana),29,6
29.0,GOLLAPALLY SAYA GOUD,Pyramid Party of India,656,2,658,0.05,6 - Medak (Telangana),29,6
30.0,SATYANARAYANA GOUD KOVURI,Independent,607,-,607,0.04,6 - Medak (Telangana),29,6
31.0,DASARI BHANUCHANDER,Independent,573,2,575,0.04,6 - Medak (Telangana),29,6
32.0,DADIGE RAJENDAR,Independent,556,3,559,0.04,6 - Medak (Telangana),29,6
33.0,C.H. NAVEEN KUMAR,Independent,529,2,531,0.04,6 - Medak (Telangana),29,6
34.0,KONDI ASHOK,Independent,509,-,509,0.04,6 - Medak (Telangana),29,6
35.0,URELLI YELLAIAH,Viduthalai Chiruthaigal Katchi,492,2,494,0.04,6 - Medak (Telangana),29,6
36.0,GONDHI BHUJANGAMU,Independent,430,1,431,0.03,6 - Medak (Telangana),29,6
37.0,MOHD AZHER,Independent,414,2,416,0.03,6 - Medak (Telangana),29,6
38.0,S RAJESH SAGAR,Independent,348,-,348,0.03,6 - Medak (Telangana),29,6
39.0,KASOJU SRIKANTH,Independent,344,-,344,0.02,6 - Medak (Telangana),29,6
40.0,K. LAXMINARAYANA,Independent,317,-,317,0.02,6 - Medak (Telangana),29,6
41.0,KOLKUR PRATAP,Independent,292,1,293,0.02,6 - Medak (Telangana),29,6
42.0,GADILA ANJANEYULU,Independent,289,1,290,0.02,6 - Medak (Telangana),29,6
43.0,GOUTI MALLESH,Independent,247,1,248,0.02,6 - Medak (Telangana),29,6
44.0,K.RAGHU,Independent,222,2,224,0.02,6 - Medak (Telangana),29,6
45.0,NOTA,None of the Above,4582,35,4617,0.33,6 - Medak (Telangana),29,6
,Total,,1372896,13343,1386239,,6 - Medak (Telangana),29,6
1.0,EATALA RAJENDER,Bharatiya Janata Party,980712,10330,991042,51.25,7 - Malkajgiri (Telangana),29,7
2.0,PATNAM SUNEETHA MAHENDER REDDY,Indian National Congress,593337,6230,599567,31.0,7 - Malkajgiri (Telangana),29,7
3.0,RAGIDI LAXMA REDDY,Bharat Rashtra Samithi,298697,1789,300486,15.54,7 - Malkajgiri (Telangana),29,7
4.0,THALLADA VENKATESWARLU,Independent,6784,16,6800,0.35,7 - Malkajgiri (Telangana),29,7
5.0,ANITHA REDDY SHEELAM,Bahujan Samaj Party,4718,61,4779,0.25,7 - Malkajgiri (Telangana),29,7
6.0,VAISHNAVI PRASAD,Independent,1894,18,1912,0.1,7 - Malkajgiri (Telangana),29,7
7.0,PAREE (PESARIKAYALA PAREEKSHITH REDDY),Independent,1831,4,1835,0.09,7 - Malkajgiri (Telangana),29,7
8.0,DONTHULA BIKSHAPATHI,Independent,1813,8,1821,0.09,7 - Malkajgiri (Telangana),29,7
9.0,BHARATHA SUDARSHAN,Independent,1639,4,1643,0.08,7 - Malkajgiri (Telangana),29,7
10.0,APPARAO KONDA,Rashtra Samanya Praja Party,1157,5,1162,0.06,7 - Malkajgiri (Telangana),29,7
11.0,MOUTAM SAMPATH,Independent,1135,2,1137,0.06,7 - Malkajgiri (Telangana),29,7
12.0,RAJESH MISHRA,Independent,1110,-,1110,0.06,7 - Malkajgiri (Telangana),29,7
13.0,BANJAPALLY SUDHA RANI,Independent,1064,5,1069,0.06,7 - Malkajgiri (Telangana),29,7
14.0,CHIRIPI REDDY RAMESH,Independent,986,1,987,0.05,7 - Malkajgiri (Telangana),29,7
15.0,PEDDAPALLI SANDEEP,Bharathiya YuvaKula Dalam,930,3,933,0.05,7 - Malkajgiri (Telangana),29,7
16.0,BOIN DURGA PRASAD YADAV,Dharma Samaj Party,778,11,789,0.04,7 - Malkajgiri (Telangana),29,7
17.0,CHAMAKURA RAJAIAH ALIAS PIDIKILI RAJU,Social Justice Party of India,722,1,723,0.04,7 - Malkajgiri (Telangana),29,7
18.0,NARRA SUKHENDER REDDY,Vidhyarthula Rajakiya Party,690,4,694,0.04,7 - Malkajgiri (Telangana),29,7
19.0,KANTE SAYANNA,Independent,539,-,539,0.03,7 - Malkajgiri (Telangana),29,7
20.0,JUVVA PHANI KUMAR CHOWDARY,Jai Bharat National Party,505,3,508,0.03,7 - Malkajgiri (Telangana),29,7
21.0,YADISHWAR NAKKA,Telangana Republican Party,492,2,494,0.03,7 - Malkajgiri (Telangana),29,7
22.0,R. SUBENDER SINGH,Independent,446,1,447,0.02,7 - Malkajgiri (Telangana),29,7
23.0,NOTA,None of the Above,13206,160,13366,0.69,7 - Malkajgiri (Telangana),29,7
,Total,,1915185,18658,1933843,,7 - Malkajgiri (Telangana),29,7
1.0,G. KISHAN REDDY,Bharatiya Janata Party,468311,4701,473012,45.15,8 - Secunderabad (Telangana),29,8
2.0,DANAM NAGENDER,Indian National Congress,420220,2848,423068,40.38,8 - Secunderabad (Telangana),29,8
3.0,PADMA RAO . T,Bharat Rashtra Samithi,128680,906,129586,12.37,8 - Secunderabad (Telangana),29,8
4.0,DR. BASWANANDAM DANDEPU,Bahujan Samaj Party,2248,20,2268,0.22,8 - Secunderabad (Telangana),29,8
5.0,SARARAPU SRISAILAM,Telangana Rajya Samithi,1726,1,1727,0.16,8 - Secunderabad (Telangana),29,8
6.0,SAPAVAT SUMAN,Independent,996,-,996,0.1,8 - Secunderabad (Telangana),29,8
7.0,R.S.J. THOMAS,Jai Swaraj Party,971,3,974,0.09,8 - Secunderabad (Telangana),29,8
8.0,RAASALA VINOD KUMAR,Dharma Samaj Party,820,6,826,0.08,8 - Secunderabad (Telangana),29,8
9.0,KOLISETTY SHIVA KUMAR,Yuga Thulasi Party,678,1,679,0.06,8 - Secunderabad (Telangana),29,8
10.0,MACHCHERLA VENKATA REDDY,Independent,672,1,673,0.06,8 - Secunderabad (Telangana),29,8
11.0,MOHAMMED AKRAM ALI KHAN,Independent,596,1,597,0.06,8 - Secunderabad (Telangana),29,8
12.0,MOHAMMED RAFIUDDIN KALEEM,All India Majlis-E-Inquilab-E-Millat,478,6,484,0.05,8 - Secunderabad (Telangana),29,8
13.0,LUNAVATH HARI RAM,Independent,474,-,474,0.05,8 - Secunderabad (Telangana),29,8
14.0,BOGGULA SUNIITHHA,Independent,417,1,418,0.04,8 - Secunderabad (Telangana),29,8
15.0,MOHAMMED AYUB ALI,Anna YSR Congress Party,406,4,410,0.04,8 - Secunderabad (Telangana),29,8
16.0,MOHAMMED FASI UDDIN,Independent,341,1,342,0.03,8 - Secunderabad (Telangana),29,8
17.0,PULIMAMIDI VENKATESH GUPTA,Independent,340,-,340,0.03,8 - Secunderabad (Telangana),29,8
18.0,IBRAHIM KHAN,Independent,315,5,320,0.03,8 - Secunderabad (Telangana),29,8
19.0,ANDRAPU SUDARSHAN,Independent,312,3,315,0.03,8 - Secunderabad (Telangana),29,8
20.0,JUNAID ANAM SIDDIQUI,Independent,294,1,295,0.03,8 - Secunderabad (Telangana),29,8
21.0,KRANTHI KUMAR BANDELA,Indian National Yuva Jana Party,283,2,285,0.03,8 - Secunderabad (Telangana),29,8
22.0,DR. R. GANGADHAR,Socialist Unity Centre Of India (COMMUNIST),280,1,281,0.03,8 - Secunderabad (Telangana),29,8
23.0,UTTAM PRAVEEN KUMAR,Independent,273,1,274,0.03,8 - Secunderabad (Telangana),29,8
24.0,GOWLIKAR SONY,Social Justice Party of India,269,3,272,0.03,8 - Secunderabad (Telangana),29,8
25.0,BATHULA RAVI,Independent,252,-,252,0.02,8 - Secunderabad (Telangana),29,8
26.0,P C LINGANNA,Independent,243,-,243,0.02,8 - Secunderabad (Telangana),29,8
27.0,MOHAMMED IBRAHIM AHMED,Independent,240,2,242,0.02,8 - Secunderabad (Telangana),29,8
28.0,SANGALA FLORY,Independent,223,-,223,0.02,8 - Secunderabad (Telangana),29,8
29.0,MOHAMMED ABDUL AZEEM,Independent,220,1,221,0.02,8 - Secunderabad (Telangana),29,8
30.0,GANESH BHARGAVI GUNDE,Jai Bharat National Party,220,3,223,0.02,8 - Secunderabad (Telangana),29,8
31.0,V. K. VIJAYA LAKSHMI,Independent,213,3,216,0.02,8 - Secunderabad (Telangana),29,8
32.0,CHEEKATI BHUPAL GOUD,All India Backward People Sunami Party,209,1,210,0.02,8 - Secunderabad (Telangana),29,8
33.0,BOMMAKANTI SOWMYA,Pyramid Party of India,201,4,205,0.02,8 - Secunderabad (Telangana),29,8
34.0,KRUPAVARAM GANDU,Independent,159,2,161,0.02,8 - Secunderabad (Telangana),29,8
35.0,PAMPARI NARENDER,Independent,143,-,143,0.01,8 - Secunderabad (Telangana),29,8
36.0,SYED KHADER,Independent,132,1,133,0.01,8 - Secunderabad (Telangana),29,8
37.0,B . SUNITHA RANI,Socialist Party (India),130,3,133,0.01,8 - Secunderabad (Telangana),29,8
38.0,CHALIKA CHANDRA SEKHAR,Independent,129,-,129,0.01,8 - Secunderabad (Telangana),29,8
39.0,PAGIDIPALLI SHYAMSON,Viduthalai Chiruthaigal Katchi,126,4,130,0.01,8 - Secunderabad (Telangana),29,8
40.0,REDDYMALLA PARVATHI,Independent,126,1,127,0.01,8 - Secunderabad (Telangana),29,8
41.0,VELAMARTHI. RAVI KIRAN,Independent,123,1,124,0.01,8 - Secunderabad (Telangana),29,8
42.0,K. MURALI KRISHNA,Independent,120,-,120,0.01,8 - Secunderabad (Telangana),29,8
43.0,DEVENDAR KONNE,Independent,117,-,117,0.01,8 - Secunderabad (Telangana),29,8
44.0,KONDOJU MOHAN,Independent,113,1,114,0.01,8 - Secunderabad (Telangana),29,8
45.0,MD KHALEEL UZ ZAMA,Independent,110,1,111,0.01,8 - Secunderabad (Telangana),29,8
46.0,NOTA,None of the Above,5092,74,5166,0.49,8 - Secunderabad (Telangana),29,8
,Total,,1039041,8618,1047659,,8 - Secunderabad (Telangana),29,8
1.0,ASADUDDIN OWAISI,All India Majlis-E-Ittehadul Muslimeen,659278,2703,661981,61.28,9 - Hyderabad (Telangana),29,9
2.0,MADHAVI LATHA KOMPELLA,Bharatiya Janata Party,320481,3413,323894,29.98,9 - Hyderabad (Telangana),29,9
3.0,MOHAMMED WALIULLAH SAMEER,Indian National Congress,62497,465,62962,5.83,9 - Hyderabad (Telangana),29,9
4.0,SRINIVAS YADAV GADDAM,Bharat Rashtra Samithi,18498,143,18641,1.73,9 - Hyderabad (Telangana),29,9
5.0,MEKALA RAGHUMA REDDY,Yuga Thulasi Party,2231,1,2232,0.21,9 - Hyderabad (Telangana),29,9
6.0,DR.J.PADMAJA,Viduthalai Chiruthaigal Katchi,899,1,900,0.08,9 - Hyderabad (Telangana),29,9
7.0,K.S.KRISHNA,Bahujan Samaj Party,763,6,769,0.07,9 - Hyderabad (Telangana),29,9
8.0,RAMESH KUMAR MATANGI,Sakala Janula Party,663,-,663,0.06,9 - Hyderabad (Telangana),29,9
9.0,KRANTHI KUMAR BANDELA,Indian National Yuva Jana Party,561,1,562,0.05,9 - Hyderabad (Telangana),29,9
10.0,M.JOHNSON,All India Mahila Empowerment Party,515,-,515,0.05,9 - Hyderabad (Telangana),29,9
11.0,JAMEEL SAYED,Alliance of Democratic Reforms Party,492,-,492,0.05,9 - Hyderabad (Telangana),29,9
12.0,ASHOK KUMAR MAMBA,Maa Telangana Party,422,1,423,0.04,9 - Hyderabad (Telangana),29,9
13.0,DR.LUBNA SARWATH,Vidhyarthula Rajakiya Party,410,1,411,0.04,9 - Hyderabad (Telangana),29,9
14.0,SARAF TULASI GUPTA,Praja Ektha Party,281,-,281,0.03,9 - Hyderabad (Telangana),29,9
15.0,V.SHANKER,Yuva Taram Party,275,1,276,0.03,9 - Hyderabad (Telangana),29,9
16.0,GADDAM HARISH GOUD,Dharma Samaj Party,269,2,271,0.03,9 - Hyderabad (Telangana),29,9
17.0,SYED ANWAR,Independent,251,-,251,0.02,9 - Hyderabad (Telangana),29,9
18.0,KHAJA MOINUDDIN,All India Majlis-E-Inquilab-E-Millat,233,1,234,0.02,9 - Hyderabad (Telangana),29,9
19.0,AMJAD KHAN,Independent,195,1,196,0.02,9 - Hyderabad (Telangana),29,9
20.0,AMBI HANUMANTH RAO,Socialist Party (India),161,1,162,0.01,9 - Hyderabad (Telangana),29,9
21.0,SHAIK BASHA,Dalita Bahujana Party,153,-,153,0.01,9 - Hyderabad (Telangana),29,9
22.0,M.K.AHMED,Independent,149,-,149,0.01,9 - Hyderabad (Telangana),29,9
23.0,SALVERU RAMESH,Indian Praja Congress,141,-,141,0.01,9 - Hyderabad (Telangana),29,9
24.0,L.ASHOKNATH,Telangana Prajaa Jeevana Rythu Party,141,-,141,0.01,9 - Hyderabad (Telangana),29,9
25.0,J.SHYAMSUNDER RAO,Independent,138,-,138,0.01,9 - Hyderabad (Telangana),29,9
26.0,ANDE USHA KANNA,Bahujan Mukti Party,133,-,133,0.01,9 - Hyderabad (Telangana),29,9
27.0,SATTI SHABABU REDDY,Independent,123,-,123,0.01,9 - Hyderabad (Telangana),29,9
28.0,ANIL SEN,Independent,111,-,111,0.01,9 - Hyderabad (Telangana),29,9
29.0,CHAITANYA KUMAR REDDY PELLAKURU,Independent,110,-,110,0.01,9 - Hyderabad (Telangana),29,9
30.0,SILIVERU NARESH,Telangana Jaghir Party,103,-,103,0.01,9 - Hyderabad (Telangana),29,9
31.0,NOTA,None of the Above,2867,39,2906,0.27,9 - Hyderabad (Telangana),29,9
,Total,,1073544,6780,1080324,,9 - Hyderabad (Telangana),29,9
1.0,KONDA VISHWESHWAR REDDY,Bharatiya Janata Party,798517,11365,809882,48.34,10 - Chevella (Telangana),29,10
2.0,DR GADDAM RANJITH REDDY,Indian National Congress,630861,6124,636985,38.02,10 - Chevella (Telangana),29,10
3.0,KASANI GYANESHWAR KASANI,Bharat Rashtra Samithi,177540,1428,178968,10.68,10 - Chevella (Telangana),29,10
4.0,RAMULU BINGI,Yuga Thulasi Party,4281,3,4284,0.26,10 - Chevella (Telangana),29,10
5.0,KONDA VISHVESHWAR REDDY,All India Forward Bloc,3736,12,3748,0.22,10 - Chevella (Telangana),29,10
6.0,SRIDEVI M,Alliance of Democratic Reforms Party,2684,4,2688,0.16,10 - Chevella (Telangana),29,10
7.0,MOHAMMED SALEEM,Rashtriya Praja Congress (Secular),2372,1,2373,0.14,10 - Chevella (Telangana),29,10
8.0,SAHITHI DASARI,Independent,1924,14,1938,0.12,10 - Chevella (Telangana),29,10
9.0,RANJIT REDDY GADE,Revolutionary Socialist Party,1693,5,1698,0.1,10 - Chevella (Telangana),29,10
10.0,MOHD SHAKEEL,Desh Janhit Party,1646,1,1647,0.1,10 - Chevella (Telangana),29,10
11.0,THOTLA RAGHAVENDER MUDIRAJ,Dharma Samaj Party,1599,49,1648,0.1,10 - Chevella (Telangana),29,10
12.0,JANAPALA DURGA PRASAD,Independent,1516,1,1517,0.09,10 - Chevella (Telangana),29,10
13.0,JALEEL AHMED,Independent,1508,2,1510,0.09,10 - Chevella (Telangana),29,10
14.0,B V RAMESH NAIDU,Socialist Party (India),1494,1,1495,0.09,10 - Chevella (Telangana),29,10
15.0,PHANI PRASAD KATAKAM,Social Justice Party of India,1425,1,1426,0.09,10 - Chevella (Telangana),29,10
16.0,SUGURU SRINIVAS,Jai Swaraj Party,1385,1,1386,0.08,10 - Chevella (Telangana),29,10
17.0,G MALLESHAM GOUD,Independent,1239,1,1240,0.07,10 - Chevella (Telangana),29,10
18.0,KATHULA YADAIAH,Independent,1155,-,1155,0.07,10 - Chevella (Telangana),29,10
19.0,DURGA PRASAD T,Praja Velugu Party,1134,5,1139,0.07,10 - Chevella (Telangana),29,10
20.0,V PANDU,Independent,1070,5,1075,0.06,10 - Chevella (Telangana),29,10
21.0,SANEM RAJU GOUD,Praja Ektha Party,970,1,971,0.06,10 - Chevella (Telangana),29,10
22.0,GONE SRINIVAS REDDY,Independent,752,-,752,0.04,10 - Chevella (Telangana),29,10
23.0,GOVIND LAL,Independent,661,-,661,0.04,10 - Chevella (Telangana),29,10
24.0,MOHAMMED ABDUL QAVI ABBASI,All India Majlis-E-Inquilab-E-Millat,635,-,635,0.04,10 - Chevella (Telangana),29,10
25.0,MOHAMMAD PASHA,Independent,628,-,628,0.04,10 - Chevella (Telangana),29,10
26.0,P GOVIND,Bahujan Mukti Party,600,11,611,0.04,10 - Chevella (Telangana),29,10
27.0,EESARI SURYAPRAKASH REDDY,Independent,581,2,583,0.03,10 - Chevella (Telangana),29,10
28.0,SUDHAKAR VANAM,Marxist Communist Party of India (United),578,3,581,0.03,10 - Chevella (Telangana),29,10
29.0,NARASIMHA REDDY DYAPA,Telangana Republican Party,524,1,525,0.03,10 - Chevella (Telangana),29,10
30.0,MOHAMMED IQBAL,Independent,493,1,494,0.03,10 - Chevella (Telangana),29,10
31.0,VISHWAKARMA SAPTHAGIRI,Independent,489,-,489,0.03,10 - Chevella (Telangana),29,10
32.0,ANKAGALA PRAVEEN KUMAR,Independent,487,1,488,0.03,10 - Chevella (Telangana),29,10
33.0,ANJANEYULU NEERATI,Independent,446,3,449,0.03,10 - Chevella (Telangana),29,10
34.0,KANDIKEKAR SRINIVAS,Independent,445,1,446,0.03,10 - Chevella (Telangana),29,10
35.0,CHINTALAGARI VENKAT SWAMY,Blue India Party,431,5,436,0.03,10 - Chevella (Telangana),29,10
36.0,PALAMAKULA MADHU,India Praja Bandhu Party,428,2,430,0.03,10 - Chevella (Telangana),29,10
37.0,KAVALI SUKUMAR,Independent,392,5,397,0.02,10 - Chevella (Telangana),29,10
38.0,SERUBAI VASANTH KUMAR,Rashtra Samanya Praja Party,311,1,312,0.02,10 - Chevella (Telangana),29,10
39.0,MOHAMMED MUSTAFA RIZWAN,Independent,300,1,301,0.02,10 - Chevella (Telangana),29,10
40.0,MOHAMMAD RIAZUR REHMAN SHAIK,Independent,283,2,285,0.02,10 - Chevella (Telangana),29,10
41.0,MOHAMMED ALI,Independent,247,1,248,0.01,10 - Chevella (Telangana),29,10
42.0,AMIR SAJID,Independent,226,2,228,0.01,10 - Chevella (Telangana),29,10
43.0,MOHAMMED AFSAR QUDOOS,Independent,179,-,179,0.01,10 - Chevella (Telangana),29,10
44.0,NOTA,None of the Above,6313,110,6423,0.38,10 - Chevella (Telangana),29,10
,Total,,1656178,19176,1675354,,10 - Chevella (Telangana),29,10
1.0,ARUNA. D. K,Bharatiya Janata Party,506747,4000,510747,41.66,11 - Mahbubnagar (Telangana),29,11
2.0,CHALLA VAMSHI CHAND REDDY,Indian National Congress,503111,3136,506247,41.29,11 - Mahbubnagar (Telangana),29,11
3.0,MANNE SRINIVAS REDDY,Bharat Rashtra Samithi,154296,496,154792,12.62,11 - Mahbubnagar (Telangana),29,11
4.0,VENKATESWARLU TALLADA,Alliance of Democratic Reforms Party,6375,4,6379,0.52,11 - Mahbubnagar (Telangana),29,11
5.0,KINNERA YADAGIRI,Independent,4470,-,4470,0.36,11 - Mahbubnagar (Telangana),29,11
6.0,KURA VENKATAIAH,Independent,4248,1,4249,0.35,11 - Mahbubnagar (Telangana),29,11
7.0,HARINDER REDDY MALLELA,Independent,3814,1,3815,0.31,11 - Mahbubnagar (Telangana),29,11
8.0,KARUKONDA SRINIVAS YADAV,Independent,3450,1,3451,0.28,11 - Mahbubnagar (Telangana),29,11
9.0,HANUMESH,Independent,3225,-,3225,0.26,11 - Mahbubnagar (Telangana),29,11
10.0,MOHD ALAUDDIN,Bahujan Samaj Party,3056,21,3077,0.25,11 - Mahbubnagar (Telangana),29,11
11.0,GOVINDAMMA,Independent,2748,-,2748,0.22,11 - Mahbubnagar (Telangana),29,11
12.0,GANTLAVELLI RAKESH,Dharma Samaj Party,2600,18,2618,0.21,11 - Mahbubnagar (Telangana),29,11
13.0,UMASHANKAR NEMMIKANTI,Independent,2214,-,2214,0.18,11 - Mahbubnagar (Telangana),29,11
14.0,DINESH,Independent,1726,1,1727,0.14,11 - Mahbubnagar (Telangana),29,11
15.0,ANDHARI ANJAIAH,Independent,1669,6,1675,0.14,11 - Mahbubnagar (Telangana),29,11
16.0,SANGEPAGA SAROJANAMMA,Independent,1563,2,1565,0.13,11 - Mahbubnagar (Telangana),29,11
17.0,B. RAVINDER,Social Justice Party of India,1082,3,1085,0.09,11 - Mahbubnagar (Telangana),29,11
18.0,K. UDAY TEJ NAIK,Independent,1027,-,1027,0.08,11 - Mahbubnagar (Telangana),29,11
19.0,MARLA ANJANEYULU,Jai Swaraj Party,1019,1,1020,0.08,11 - Mahbubnagar (Telangana),29,11
20.0,NADIMINTI SRINIVASULU,Independent,983,2,985,0.08,11 - Mahbubnagar (Telangana),29,11
21.0,M. NAVEEN REDDY,Independent,951,1,952,0.08,11 - Mahbubnagar (Telangana),29,11
22.0,VIJAYA,Independent,592,4,596,0.05,11 - Mahbubnagar (Telangana),29,11
23.0,ANEESUR RAHMAN,Bahujan Mukti Party,503,-,503,0.04,11 - Mahbubnagar (Telangana),29,11
24.0,A. SRINIVASULU,Independent,437,1,438,0.04,11 - Mahbubnagar (Telangana),29,11
25.0,KADINTI SHANKAR REDDY,Viduthalai Chiruthaigal Katchi,427,5,432,0.04,11 - Mahbubnagar (Telangana),29,11
26.0,NARESH REDDY,Telangana Jaghir Party,420,-,420,0.03,11 - Mahbubnagar (Telangana),29,11
27.0,VENKATA RAMANA,Independent,352,1,353,0.03,11 - Mahbubnagar (Telangana),29,11
28.0,BANDA SATYANARAYANA,Independent,263,1,264,0.02,11 - Mahbubnagar (Telangana),29,11
29.0,PULLANGARI SANDEEP KUMAR REDDY,Independent,261,1,262,0.02,11 - Mahbubnagar (Telangana),29,11
30.0,VISHNU VARDHAN REDDY THAPALAKINDHI,Independent,227,2,229,0.02,11 - Mahbubnagar (Telangana),29,11
31.0,MUDAVATH BALARAJU NAIK,Independent,181,2,183,0.01,11 - Mahbubnagar (Telangana),29,11
32.0,NOTA,None of the Above,4286,44,4330,0.35,11 - Mahbubnagar (Telangana),29,11
,Total,,1218323,7755,1226078,,11 - Mahbubnagar (Telangana),29,11
1.0,DR.MALLU RAVI,Indian National Congress,459259,5813,465072,38.14,12 - Nagarkurnool (Telangana),29,12
2.0,BHARATH PRASAD POTHUGANTI,Bharatiya Janata Party,364898,5760,370658,30.4,12 - Nagarkurnool (Telangana),29,12
3.0,DR.R.S.PRAVEEN KUMAR,Bharat Rashtra Samithi,319216,2127,321343,26.36,12 - Nagarkurnool (Telangana),29,12
4.0,AMBOJU RAVI,Alliance of Democratic Reforms Party,12544,10,12554,1.03,12 - Nagarkurnool (Telangana),29,12
5.0,BESAMOLLA YOSEF,Bahujan Samaj Party,7138,80,7218,0.59,12 - Nagarkurnool (Telangana),29,12
6.0,PILLELA SRIKANTH,Independent,6403,1,6404,0.53,12 - Nagarkurnool (Telangana),29,12
7.0,BUDDHULA SRINIVAS,Independent,4358,3,4361,0.36,12 - Nagarkurnool (Telangana),29,12
8.0,PALADHI NAGARAJU,Independent,4056,2,4058,0.33,12 - Nagarkurnool (Telangana),29,12
9.0,AMARNATH,India Praja Bandhu Party,3703,6,3709,0.3,12 - Nagarkurnool (Telangana),29,12
10.0,PULJALA BALAIAH,Independent,3582,2,3584,0.29,12 - Nagarkurnool (Telangana),29,12
11.0,GALIMUDI GEETHA,Independent,3145,2,3147,0.26,12 - Nagarkurnool (Telangana),29,12
12.0,KARNE. SHIREESHA @ BARRELAKKA,Independent,3037,50,3087,0.25,12 - Nagarkurnool (Telangana),29,12
13.0,PAKIRA RAMULU,Independent,2833,6,2839,0.23,12 - Nagarkurnool (Telangana),29,12
14.0,BIKSHAPATHI LANDA,Independent,1980,1,1981,0.16,12 - Nagarkurnool (Telangana),29,12
15.0,AYYAPPA SUNIL,Rashtriya Praja Congress (Secular),1224,3,1227,0.1,12 - Nagarkurnool (Telangana),29,12
16.0,GADDAM VIJAY,Bahujan Mukti Party,1006,3,1009,0.08,12 - Nagarkurnool (Telangana),29,12
17.0,PRASANGI,Pyramid Party of India,892,-,892,0.07,12 - Nagarkurnool (Telangana),29,12
18.0,VAGGU VINAY,Vidhyarthula Rajakiya Party,768,2,770,0.06,12 - Nagarkurnool (Telangana),29,12
19.0,DASARI BHARATHI,Viduthalai Chiruthaigal Katchi,722,8,730,0.06,12 - Nagarkurnool (Telangana),29,12
20.0,NOTA,None of the Above,4511,69,4580,0.38,12 - Nagarkurnool (Telangana),29,12
,Total,,1205275,13948,1219223,,12 - Nagarkurnool (Telangana),29,12
1.0,KUNDURU RAGHUVEER,Indian National Congress,772264,12073,784337,60.5,13 - Nalgonda (Telangana),29,13
2.0,SAIDI REDDY SHANAMPUDI,Bharatiya Janata Party,219606,4826,224432,17.31,13 - Nalgonda (Telangana),29,13
3.0,KANCHARLA KRISHNA REDDY,Bharat Rashtra Samithi,216681,1736,218417,16.85,13 - Nalgonda (Telangana),29,13
4.0,JANAIAH NANDIPATI,Telangana Sakalajanula Party,10832,27,10859,0.84,13 - Nalgonda (Telangana),29,13
5.0,NAGARAJU BANDARU,Independent,7122,6,7128,0.55,13 - Nalgonda (Telangana),29,13
6.0,ANJAIAH VIRIGINENI,Bahujan Samaj Party,7075,102,7177,0.55,13 - Nalgonda (Telangana),29,13
7.0,MARAM VENKAT REDDY,Independent,5962,5,5967,0.46,13 - Nalgonda (Telangana),29,13
8.0,PANUGOTU LALASINGH,Independent,5277,9,5286,0.41,13 - Nalgonda (Telangana),29,13
9.0,THALARI RAMBABU,Dharma Samaj Party,5028,94,5122,0.4,13 - Nalgonda (Telangana),29,13
10.0,RAMESH SUNKARA,Independent,3566,3,3569,0.28,13 - Nalgonda (Telangana),29,13
11.0,POLISHETTY VENKATESHWARLU,Independent,3202,10,3212,0.25,13 - Nalgonda (Telangana),29,13
12.0,KUKKALA VENKANNA,Independent,2561,5,2566,0.2,13 - Nalgonda (Telangana),29,13
13.0,CHOLLETI PRABHAKAR,Independent,2482,22,2504,0.19,13 - Nalgonda (Telangana),29,13
14.0,GOLI SAIDULU,Independent,1770,9,1779,0.14,13 - Nalgonda (Telangana),29,13
15.0,MARRI NEHEMIAH,Independent,1653,9,1662,0.13,13 - Nalgonda (Telangana),29,13
16.0,RAVI PALAKURI,Independent,1545,2,1547,0.12,13 - Nalgonda (Telangana),29,13
17.0,VASKULA MATTAIAH,Marxist Communist Party of India (United),1033,7,1040,0.08,13 - Nalgonda (Telangana),29,13
18.0,KUNDARAPU SRIKANTH,Independent,940,7,947,0.07,13 - Nalgonda (Telangana),29,13
19.0,RACHA SUBHADRA REDDY,Socialist Party (India),835,11,846,0.07,13 - Nalgonda (Telangana),29,13
20.0,LINGAM KRISHNA,Independent,666,-,666,0.05,13 - Nalgonda (Telangana),29,13
21.0,KINNERA YADAIAH,Independent,654,7,661,0.05,13 - Nalgonda (Telangana),29,13
22.0,SHIRISHALA SRINAIAH,Independent,513,1,514,0.04,13 - Nalgonda (Telangana),29,13
23.0,NOTA,None of the Above,5869,217,6086,0.47,13 - Nalgonda (Telangana),29,13
,Total,,1277136,19188,1296324,,13 - Nalgonda (Telangana),29,13
1.0,CHAMALA KIRAN KUMAR REDDY,Indian National Congress,623762,5381,629143,44.89,14 - Bhongir (Telangana),29,14
2.0,DR. BOORA NARSAIAH GOUD,Bharatiya Janata Party,401513,5460,406973,29.04,14 - Bhongir (Telangana),29,14
3.0,KYAMA MALLESH,Bharat Rashtra Samithi,254838,1349,256187,18.28,14 - Bhongir (Telangana),29,14
4.0,MAHAMD JAHANGIR,Communist Party of India (Marxist),28412,318,28730,2.05,14 - Bhongir (Telangana),29,14
5.0,RAMESH GOUD THALLAPELLY,Alliance of Democratic Reforms Party,8130,16,8146,0.58,14 - Bhongir (Telangana),29,14
6.0,AITARAJU ABENDER,Bahujan Samaj Party,7703,66,7769,0.55,14 - Bhongir (Telangana),29,14
7.0,ASURA BALU,Independent,5747,3,5750,0.41,14 - Bhongir (Telangana),29,14
8.0,PULIGILLA BIXAPATHI YADAV,National Nava Kranthi Party,4718,-,4718,0.34,14 - Bhongir (Telangana),29,14
9.0,BUSHIPAKA VENKATAIAH,Independent,4674,1,4675,0.33,14 - Bhongir (Telangana),29,14
10.0,POOSA SRINIVAS,Telangana Rashtra Punahnirmana Samithi,4431,2,4433,0.32,14 - Bhongir (Telangana),29,14
11.0,NARENDRAA VEMULA,Jai Swaraj Party,4303,1,4304,0.31,14 - Bhongir (Telangana),29,14
12.0,KONGARI LINGA SWAMY,Dharma Samaj Party,4029,64,4093,0.29,14 - Bhongir (Telangana),29,14
13.0,TARIGOPPULA MAHENDER,Social Justice Party of India,3088,1,3089,0.22,14 - Bhongir (Telangana),29,14
14.0,KARINGULA YADAGIRI,Independent,2607,5,2612,0.19,14 - Bhongir (Telangana),29,14
15.0,BETHI NARENDER,Independent,2168,-,2168,0.15,14 - Bhongir (Telangana),29,14
16.0,M. GANESH,Pyramid Party of India,1996,14,2010,0.14,14 - Bhongir (Telangana),29,14
17.0,MALLEBOINA PARAMESH YADAV,Independent,1895,2,1897,0.14,14 - Bhongir (Telangana),29,14
18.0,LINGIDI. VENKATESWARLU,Prajavani Party,1792,-,1792,0.13,14 - Bhongir (Telangana),29,14
19.0,V. SADANANDA REDDY,People Protection Party,1734,3,1737,0.12,14 - Bhongir (Telangana),29,14
20.0,DHERAVATH GOPI NAIK,Jai Maha Bharath Party,1678,4,1682,0.12,14 - Bhongir (Telangana),29,14
21.0,PENTA RAMESH,Independent,1646,1,1647,0.12,14 - Bhongir (Telangana),29,14
22.0,RACHA SUBHADRA REDDY,Socialist Party (India),1444,21,1465,0.1,14 - Bhongir (Telangana),29,14
23.0,VARIKUPPALA. KRISHNA VADDERA,Independent,1361,5,1366,0.1,14 - Bhongir (Telangana),29,14
24.0,BASHABOINA LAKSHMAIAH,Independent,1319,1,1320,0.09,14 - Bhongir (Telangana),29,14
25.0,NUNE VENKAT SWAMY,Independent,919,4,923,0.07,14 - Bhongir (Telangana),29,14
26.0,NARRI. SWAMY KURUMA,Independent,897,1,898,0.06,14 - Bhongir (Telangana),29,14
27.0,JANGA. SUJATHANAVEEN REDDY,Independent,847,-,847,0.06,14 - Bhongir (Telangana),29,14
28.0,ERRA SURYAM,Viduthalai Chiruthaigal Katchi,777,1,778,0.06,14 - Bhongir (Telangana),29,14
29.0,"KONGARI, MALLAIAH",Independent,631,2,633,0.05,14 - Bhongir (Telangana),29,14
30.0,DR : MORIGADI KRISHNA,Independent,616,1,617,0.04,14 - Bhongir (Telangana),29,14
31.0,KANDE. RAMARAJU,Independent,577,2,579,0.04,14 - Bhongir (Telangana),29,14
32.0,KOTHOJU SRINIVASU,National Maha Sabha Party,567,2,569,0.04,14 - Bhongir (Telangana),29,14
33.0,AMIREDDY KIRAN REDDY,Independent,540,1,541,0.04,14 - Bhongir (Telangana),29,14
34.0,CHANDU NAYAK MEGAVATH,Independent,501,1,502,0.04,14 - Bhongir (Telangana),29,14
35.0,KADIRE KIRAN KUMAR,Bahujan Republican Socialist Party,476,2,478,0.03,14 - Bhongir (Telangana),29,14
36.0,KARUNAKAR REDDY NALLA,Jai Bharat National Party,446,1,447,0.03,14 - Bhongir (Telangana),29,14
37.0,KANDADI. MANIPAL REDDY,Telangana Republican Party,432,1,433,0.03,14 - Bhongir (Telangana),29,14
38.0,UDARI MALLESH,Independent,404,2,406,0.03,14 - Bhongir (Telangana),29,14
39.0,ANIL KUMAR GADEPAKA,Independent,390,3,393,0.03,14 - Bhongir (Telangana),29,14
40.0,NOTA,None of the Above,4571,75,4646,0.33,14 - Bhongir (Telangana),29,14
,Total,,1388579,12817,1401396,,14 - Bhongir (Telangana),29,14
1.0,KADIYAM KAVYA,Indian National Congress,575566,5728,581294,45.85,15 - Warangal (Telangana),29,15
2.0,AROORI RAMESH,Bharatiya Janata Party,355875,5080,360955,28.47,15 - Warangal (Telangana),29,15
3.0,Dr. MARAPALLY SUDHEER KUMAR,Bharat Rashtra Samithi,230820,1213,232033,18.3,15 - Warangal (Telangana),29,15
4.0,AMBOJU BUDDAIAH,Alliance of Democratic Reforms Party,11103,12,11115,0.88,15 - Warangal (Telangana),29,15
5.0,KALPANA PANJA,Bahujan Samaj Party,9230,97,9327,0.74,15 - Warangal (Telangana),29,15
6.0,KONGARA ANIL KUMAR,Independent,6259,-,6259,0.49,15 - Warangal (Telangana),29,15
7.0,ANIL KUMAR GADEPAKA,Independent,4482,4,4486,0.35,15 - Warangal (Telangana),29,15
8.0,BUNGA JYOTHI RAMANA,Aihra National Party,4262,3,4265,0.34,15 - Warangal (Telangana),29,15
9.0,MEKALA SUMAN,Dharma Samaj Party,3972,66,4038,0.32,15 - Warangal (Telangana),29,15
10.0,AR NENA PREM READY RIPEEKA,Mana Telangana Rashtra Samaikya Party,3625,9,3634,0.29,15 - Warangal (Telangana),29,15
11.0,KOYYADA NARESH,Independent,3283,3,3286,0.26,15 - Warangal (Telangana),29,15
12.0,PRAMEELA JANNU,Independent,3022,-,3022,0.24,15 - Warangal (Telangana),29,15
13.0,BARIGELA SHIVA,Independent,2947,2,2949,0.23,15 - Warangal (Telangana),29,15
14.0,S P K SAGAR,Jai Maha Bharath Party,2769,4,2773,0.22,15 - Warangal (Telangana),29,15
15.0,PASULA RAVI,Republican Party of India (Athawale),2220,19,2239,0.18,15 - Warangal (Telangana),29,15
16.0,DEVARAJU PENDELA,Rashtriya Praja Congress (Secular),2072,11,2083,0.16,15 - Warangal (Telangana),29,15
17.0,POTHARAJU NARASIMHARAJU,Independent,1955,-,1955,0.15,15 - Warangal (Telangana),29,15
18.0,BOLLAM VIJAY KUMAR,Independent,1821,4,1825,0.14,15 - Warangal (Telangana),29,15
19.0,MACHA DEVENDER,Viduthalai Chiruthaigal Katchi,1753,16,1769,0.14,15 - Warangal (Telangana),29,15
20.0,ROOPA POLEPAKA,Independent,1657,2,1659,0.13,15 - Warangal (Telangana),29,15
21.0,NARMADA PRAVEEN,Pyramid Party of India,1657,7,1664,0.13,15 - Warangal (Telangana),29,15
22.0,DHAYAKAR GAJJI,Independent,1637,1,1638,0.13,15 - Warangal (Telangana),29,15
23.0,POGULA ASHOK,Independent,1333,4,1337,0.11,15 - Warangal (Telangana),29,15
24.0,THANDRA ESHWAR,Independent,1290,2,1292,0.1,15 - Warangal (Telangana),29,15
25.0,MANDA NARESH,Independent,1044,7,1051,0.08,15 - Warangal (Telangana),29,15
26.0,KOTHAPALLI SAVITHRI,Marxist Communist Party of India (United),1018,5,1023,0.08,15 - Warangal (Telangana),29,15
27.0,PUTTA VINOD KUMAR,Independent,908,1,909,0.07,15 - Warangal (Telangana),29,15
28.0,BOCHU RAJU,Independent,905,8,913,0.07,15 - Warangal (Telangana),29,15
29.0,PAITHARA ACHYUTH,Independent,901,5,906,0.07,15 - Warangal (Telangana),29,15
30.0,MANGALAPELLI ASHAIAH,Independent,847,-,847,0.07,15 - Warangal (Telangana),29,15
31.0,GADDAM CHIRANJEEVI,Independent,825,1,826,0.07,15 - Warangal (Telangana),29,15
32.0,MOTHKUPELLY PRABHAKAR,Independent,818,1,819,0.06,15 - Warangal (Telangana),29,15
33.0,GANNARAPU RAVINDER,Independent,752,-,752,0.06,15 - Warangal (Telangana),29,15
34.0,GANIPAKA PRADEEP,Independent,710,3,713,0.06,15 - Warangal (Telangana),29,15
35.0,RAMESH BABU SHANIGARAPU,Independent,658,4,662,0.05,15 - Warangal (Telangana),29,15
36.0,Dr GADAM MALLESH,Jai Bharat National Party,563,4,567,0.04,15 - Warangal (Telangana),29,15
37.0,THALLAPALLY VENKATAIAH,Independent,538,-,538,0.04,15 - Warangal (Telangana),29,15
38.0,BASHIPAKA SUDHAKAR,Independent,503,2,505,0.04,15 - Warangal (Telangana),29,15
39.0,RK GANAPURAM,Independent,468,6,474,0.04,15 - Warangal (Telangana),29,15
40.0,CHILUVERU PRATHAP,Independent,399,2,401,0.03,15 - Warangal (Telangana),29,15
41.0,THATIKAYALA SATHISH BABU,Independent,382,2,384,0.03,15 - Warangal (Telangana),29,15
42.0,CHILUMULLA SUJATHA,Independent,377,2,379,0.03,15 - Warangal (Telangana),29,15
43.0,NOTA,None of the Above,8209,171,8380,0.66,15 - Warangal (Telangana),29,15
,Total,,1255435,12511,1267946,,15 - Warangal (Telangana),29,15
1.0,BALRAM NAIK PORIKA,Indian National Congress,608505,4269,612774,55.27,16 - Mahabubabad (Telangana),29,16
2.0,KAVITHA MALOTH,Bharat Rashtra Samithi,262416,1193,263609,23.77,16 - Mahabubabad (Telangana),29,16
3.0,PROFESSOR. AZMEERA SEETARAM NAIK,Bharatiya Janata Party,108775,1669,110444,9.96,16 - Mahabubabad (Telangana),29,16
4.0,ARUN KUMAR MYPATHI,All India Forward Bloc,38252,884,39136,3.53,16 - Mahabubabad (Telangana),29,16
5.0,RAGHU VARMA JATOTHU,Alliance of Democratic Reforms Party,11879,14,11893,1.07,16 - Mahabubabad (Telangana),29,16
6.0,DURGA PALVANCHA,Independent,10112,7,10119,0.91,16 - Mahabubabad (Telangana),29,16
7.0,KONETI SUJATHA,Bahujan Samaj Party,8058,35,8093,0.73,16 - Mahabubabad (Telangana),29,16
8.0,ANIL KUMAR BODA,Independent,6419,12,6431,0.58,16 - Mahabubabad (Telangana),29,16
9.0,CHANDA LINGAIAH,Independent,5075,25,5100,0.46,16 - Mahabubabad (Telangana),29,16
10.0,MOKALLA MURALIKRISHNA,Independent,4056,6,4062,0.37,16 - Mahabubabad (Telangana),29,16
11.0,SOYAM KANNA RAJU,Gondvana Gantantra Party,3727,28,3755,0.34,16 - Mahabubabad (Telangana),29,16
12.0,BANOTH PREM NAYAK [BPN],Independent,3707,5,3712,0.33,16 - Mahabubabad (Telangana),29,16
13.0,PAYAM.SINGARAJU,Independent,3192,4,3196,0.29,16 - Mahabubabad (Telangana),29,16
14.0,PADIGA YARRAIAH,Independent,2873,14,2887,0.26,16 - Mahabubabad (Telangana),29,16
15.0,DV NAIK,Independent,2780,1,2781,0.25,16 - Mahabubabad (Telangana),29,16
16.0,GUGULOTH SHEKAR NAIK,Independent,2533,9,2542,0.23,16 - Mahabubabad (Telangana),29,16
17.0,RAVVA. BHADRAMMA,Dharma Samaj Party,2234,10,2244,0.2,16 - Mahabubabad (Telangana),29,16
18.0,SODE VENKATESWARLU,Gondwana Dandkaranya Party,2154,18,2172,0.2,16 - Mahabubabad (Telangana),29,16
19.0,BANOTH LINGYA NAIK,Independent,1712,3,1715,0.15,16 - Mahabubabad (Telangana),29,16
20.0,BODA PRASHANTH,Independent,1588,2,1590,0.14,16 - Mahabubabad (Telangana),29,16
21.0,BURKA KRISHNAVENI,Socialist Party (India),1438,10,1448,0.13,16 - Mahabubabad (Telangana),29,16
22.0,BANOTHU LINGANNA,Blue India Party,1367,-,1367,0.12,16 - Mahabubabad (Telangana),29,16
23.0,VANKUDOTHU RAVI KUMAR (RAVANNA),Telangana Jaghir Party,1117,8,1125,0.1,16 - Mahabubabad (Telangana),29,16
24.0,NOTA,None of the Above,6511,80,6591,0.59,16 - Mahabubabad (Telangana),29,16
,Total,,1100480,8306,1108786,,16 - Mahabubabad (Telangana),29,16
1.0,RAMASAHAYAM RAGHURAM REDDY,Indian National Congress,759603,7326,766929,61.29,17 - Khammam (Telangana),29,17
2.0,NAMA NAGESWARA RAO,Bharat Rashtra Samithi,297592,1490,299082,23.9,17 - Khammam (Telangana),29,17
3.0,VINOD RAO TANDRA,Bharatiya Janata Party,117075,1561,118636,9.48,17 - Khammam (Telangana),29,17
4.0,VASAM RAMAKRISHNA DORA,Independent,6200,15,6215,0.5,17 - Khammam (Telangana),29,17
5.0,ULLENGALA YADAGIRI,Independent,6063,1,6064,0.48,17 - Khammam (Telangana),29,17
6.0,ADVOCATE YERRA KAAMESH,Bahujan Samaj Party,6030,71,6101,0.49,17 - Khammam (Telangana),29,17
7.0,KUKKALA NAGAIAH,Alliance of Democratic Reforms Party,5724,19,5743,0.46,17 - Khammam (Telangana),29,17
8.0,KATUKOJWALA NAGESWAR RAO,Independent,4111,3,4114,0.33,17 - Khammam (Telangana),29,17
9.0,CHILAKABATHINI STALIN,Independent,3112,1,3113,0.25,17 - Khammam (Telangana),29,17
10.0,SHAIK BAJI BABA,Independent,2422,2,2424,0.19,17 - Khammam (Telangana),29,17
11.0,KASIMALLA NAGESWARA RAO,Independent,2232,5,2237,0.18,17 - Khammam (Telangana),29,17
12.0,BANDARU NAGARAJU,Independent,2122,-,2122,0.17,17 - Khammam (Telangana),29,17
13.0,SHAIK KHALEEL PASHA,Independent,2023,5,2028,0.16,17 - Khammam (Telangana),29,17
14.0,EDURUGATLA CHITTI MALLU,Independent,1848,6,1854,0.15,17 - Khammam (Telangana),29,17
15.0,GANGIREDDY KOTI REDDY,Independent,1789,1,1790,0.14,17 - Khammam (Telangana),29,17
16.0,SHAIK SIRAJUDDIN,Independent,1661,2,1663,0.13,17 - Khammam (Telangana),29,17
17.0,SHAIK AJJULU,Independent,1342,-,1342,0.11,17 - Khammam (Telangana),29,17
18.0,KOPPULA SRINIVASA RAO,Jaibhim Rao Bharat Party,1271,2,1273,0.1,17 - Khammam (Telangana),29,17
19.0,MADDISETTY YERRAPPA @ AJAY,Independent,1043,10,1053,0.08,17 - Khammam (Telangana),29,17
20.0,SHAIK MOHMED RASOOL,Independent,1021,1,1022,0.08,17 - Khammam (Telangana),29,17
21.0,LINGALA RAVI KUMAR,Independent,1017,1,1018,0.08,17 - Khammam (Telangana),29,17
22.0,AVUTAPALLI RAMBABU,Independent,948,2,950,0.08,17 - Khammam (Telangana),29,17
23.0,TEJAVATH JOGRAM NAIK,Independent,914,5,919,0.07,17 - Khammam (Telangana),29,17
24.0,ANWAR RAICE,Socialist Party (India),754,-,754,0.06,17 - Khammam (Telangana),29,17
25.0,ANANDA PRASAD KASINA,Pyramid Party of India,714,4,718,0.06,17 - Khammam (Telangana),29,17
26.0,LINGAIAH DANDA,Independent,693,7,700,0.06,17 - Khammam (Telangana),29,17
27.0,ANIL KUMAR MADDINENI,Independent,689,4,693,0.06,17 - Khammam (Telangana),29,17
28.0,PAPETLA RAMAMURTHY,Sakala Janula Party,659,2,661,0.05,17 - Khammam (Telangana),29,17
29.0,ANTHONI SURESH,Bahujana Left Party,607,9,616,0.05,17 - Khammam (Telangana),29,17
30.0,M. RAVI CHANDAR CHOWHAN,Independent,597,4,601,0.05,17 - Khammam (Telangana),29,17
31.0,THAMBALLA RAVI,Independent,503,5,508,0.04,17 - Khammam (Telangana),29,17
32.0,BHATTU SRINIVAS,Jai Bharat National Party,472,4,476,0.04,17 - Khammam (Telangana),29,17
33.0,NAGESWARA RAO LAKAVATH,Independent,363,5,368,0.03,17 - Khammam (Telangana),29,17
34.0,MALAMPATI SURYANARAYANA,Independent,362,1,363,0.03,17 - Khammam (Telangana),29,17
35.0,MUTYAM ARJUNA RAJU,Independent,349,2,351,0.03,17 - Khammam (Telangana),29,17
36.0,NOTA,None of the Above,6657,125,6782,0.54,17 - Khammam (Telangana),29,17
,Total,,1240582,10701,1251283,,17 - Khammam (Telangana),29,17
1.0,BISHNU PADA RAY,Bharatiya Janata Party,102182,254,102436,50.58,1 - Andaman & Nicobar Islands (Andaman & Nicobar Islands),1,1
2.0,KULDEEP RAI SHARMA,Indian National Congress,77829,211,78040,38.54,1 - Andaman & Nicobar Islands (Andaman & Nicobar Islands),1,1
3.0,MANOJ PAUL,Andaman Nicobar Democratic Congress,8236,18,8254,4.08,1 - Andaman & Nicobar Islands (Andaman & Nicobar Islands),1,1
4.0,D AYYAPPAN,Communist Party of India (Marxist),6009,8,6017,2.97,1 - Andaman & Nicobar Islands (Andaman & Nicobar Islands),1,1
5.0,V.K. ABDUL AZIZ,Independent,2195,8,2203,1.09,1 - Andaman & Nicobar Islands (Andaman & Nicobar Islands),1,1
6.0,K J B SELVARAJ,All India Anna Dravida Munnetra Kazhagam,911,3,914,0.45,1 - Andaman & Nicobar Islands (Andaman & Nicobar Islands),1,1
7.0,DR ARUN KUMAR MALLIK,Bahujan Samaj Party,714,5,719,0.36,1 - Andaman & Nicobar Islands (Andaman & Nicobar Islands),1,1
8.0,RINKU MALA MONDAL,Independent,539,3,542,0.27,1 - Andaman & Nicobar Islands (Andaman & Nicobar Islands),1,1
9.0,K VENKAT RAM BABU,Independent,506,1,507,0.25,1 - Andaman & Nicobar Islands (Andaman & Nicobar Islands),1,1
10.0,USHA KUMARI,Independent,378,2,380,0.19,1 - Andaman & Nicobar Islands (Andaman & Nicobar Islands),1,1
11.0,SALAMAT MONDAL,Socialist Unity Centre Of India (COMMUNIST),349,2,351,0.17,1 - Andaman & Nicobar Islands (Andaman & Nicobar Islands),1,1
12.0,ANAND RAMNATH ARLEKAR,Independent,342,-,342,0.17,1 - Andaman & Nicobar Islands (Andaman & Nicobar Islands),1,1
13.0,NOTA,None of the Above,1802,7,1809,0.89,1 - Andaman & Nicobar Islands (Andaman & Nicobar Islands),1,1
,Total,,201992,522,202514,,1 - Andaman & Nicobar Islands (Andaman & Nicobar Islands),1,1
1.0,MANISH TEWARI,Indian National Congress,216350,307,216657,48.22,1 - Chandigarh (Chandigarh),2,1
2.0,SANJAY TANDON,Bharatiya Janata Party,213770,383,214153,47.67,1 - Chandigarh (Chandigarh),2,1
3.0,RITU SINGH,Bahujan Samaj Party,6697,11,6708,1.49,1 - Chandigarh (Chandigarh),2,1
4.0,LAKHVIR SINGH ALIAS KOTLA,Independent,2625,1,2626,0.58,1 - Chandigarh (Chandigarh),2,1
5.0,DEEPANSHU SHARMA,Akhil Bhartiya Parivar Party,1066,2,1068,0.24,1 - Chandigarh (Chandigarh),2,1
6.0,EX-ASSISTANT COMMANDANT RANPREET SINGH,Independent,1051,3,1054,0.23,1 - Chandigarh (Chandigarh),2,1
7.0,VINOD KUMAR,Independent,683,-,683,0.15,1 - Chandigarh (Chandigarh),2,1
8.0,SUNIL THAMAN,Haryana Jansena Party,576,1,577,0.13,1 - Chandigarh (Chandigarh),2,1
9.0,BALJEET SINGH ALIAS LADDI,Independent,434,2,436,0.1,1 - Chandigarh (Chandigarh),2,1
10.0,SUNIL KUMAR,Independent,321,-,321,0.07,1 - Chandigarh (Chandigarh),2,1
11.0,PARTAP SINGH RANA,Independent,306,1,307,0.07,1 - Chandigarh (Chandigarh),2,1
12.0,MAHANT RAVI KANT MUNI,Independent,295,-,295,0.07,1 - Chandigarh (Chandigarh),2,1
13.0,VIVEK SHARMA,Independent,294,-,294,0.07,1 - Chandigarh (Chandigarh),2,1
14.0,PIAR CHAND ALIAS KOUNDAL,Independent,253,2,255,0.06,1 - Chandigarh (Chandigarh),2,1
15.0,KISHOR KUMAR ALIAS BANTI BHAIYA,Independent,239,-,239,0.05,1 - Chandigarh (Chandigarh),2,1
16.0,RAJINDER KAUR,Sainik Samaj Party,215,2,217,0.05,1 - Chandigarh (Chandigarh),2,1
17.0,RAJ PRINCE SINGH,Super Power India Party,205,-,205,0.05,1 - Chandigarh (Chandigarh),2,1
18.0,PUSHPINDER SINGH ALIAS LOVELY ATTAWA,Independent,154,-,154,0.03,1 - Chandigarh (Chandigarh),2,1
19.0,KULDIP RAI ALIAS HAPPY SOOD MORINDA,Independent,114,-,114,0.03,1 - Chandigarh (Chandigarh),2,1
20.0,NOTA,None of the Above,2900,12,2912,0.65,1 - Chandigarh (Chandigarh),2,1
,Total,,448548,727,449275,,1 - Chandigarh (Chandigarh),2,1
1.0,PATEL UMESHBHAI BABUBHAI,Independent,42469,54,42523,46.02,1 - Daman & Diu (Dadra & Nagar Haveli and Daman & Diu),3,1
2.0,LALUBHAI BABUBHAI PATEL,Bharatiya Janata Party,36243,55,36298,39.28,1 - Daman & Diu (Dadra & Nagar Haveli and Daman & Diu),3,1
3.0,KETAN DAHYABHAI PATEL,Indian National Congress,11237,21,11258,12.18,1 - Daman & Diu (Dadra & Nagar Haveli and Daman & Diu),3,1
4.0,UMESH PATEL,Navsarjan Bharat Party,545,-,545,0.59,1 - Daman & Diu (Dadra & Nagar Haveli and Daman & Diu),3,1
5.0,SAKIL LATIF KHAN,Independent,323,-,323,0.35,1 - Daman & Diu (Dadra & Nagar Haveli and Daman & Diu),3,1
6.0,IDRISH G MULLA,Independent,247,-,247,0.27,1 - Daman & Diu (Dadra & Nagar Haveli and Daman & Diu),3,1
7.0,PATEL UMESHBHAI BABU,Independent,238,-,238,0.26,1 - Daman & Diu (Dadra & Nagar Haveli and Daman & Diu),3,1
8.0,NOTA,None of the Above,977,1,978,1.06,1 - Daman & Diu (Dadra & Nagar Haveli and Daman & Diu),3,1
,Total,,92279,131,92410,,1 - Daman & Diu (Dadra & Nagar Haveli and Daman & Diu),3,1
1.0,DELKAR KALABEN MOHANBHAI,Bharatiya Janata Party,120833,241,121074,58.89,2 - Dadar & Nagar Haveli (Dadra & Nagar Haveli and Daman & Diu),3,2
2.0,AJIT RAMJIBHAI MAHALA,Indian National Congress,63423,67,63490,30.88,2 - Dadar & Nagar Haveli (Dadra & Nagar Haveli and Daman & Diu),3,2
3.0,KURADA DEEPAKBHAI,Bharat Adivasi Party,10188,9,10197,4.96,2 - Dadar & Nagar Haveli (Dadra & Nagar Haveli and Daman & Diu),3,2
4.0,BORSA SANDIPBHAI S,Bahujan Samaj Party,3147,5,3152,1.53,2 - Dadar & Nagar Haveli (Dadra & Nagar Haveli and Daman & Diu),3,2
5.0,SHAILESHBHAI VARTHA,Independent,2522,2,2524,1.23,2 - Dadar & Nagar Haveli (Dadra & Nagar Haveli and Daman & Diu),3,2
6.0,NOTA,None of the Above,5144,7,5151,2.51,2 - Dadar & Nagar Haveli (Dadra & Nagar Haveli and Daman & Diu),3,2
,Total,,205257,331,205588,,2 - Dadar & Nagar Haveli (Dadra & Nagar Haveli and Daman & Diu),3,2
1.0,PRAVEEN KHANDELWAL,Bharatiya Janata Party,514958,1538,516496,53.46,1 - Chandni Chowk (NCT OF Delhi),5,1
2.0,JAI PRAKASH AGARWAL,Indian National Congress,426542,629,427171,44.22,1 - Chandni Chowk (NCT OF Delhi),5,1
3.0,ABUL KALAM AZAD,Bahujan Samaj Party,5820,9,5829,0.6,1 - Chandni Chowk (NCT OF Delhi),5,1
4.0,UMESH RATHOR,Atulya Bharat Party,1614,3,1617,0.17,1 - Chandni Chowk (NCT OF Delhi),5,1
5.0,SEEMA RIZVI,Azad Samaj Party,1089,-,1089,0.11,1 - Chandni Chowk (NCT OF Delhi),5,1
6.0,SHAIK JALEEL,Navarang Congress Party,947,2,949,0.1,1 - Chandni Chowk (NCT OF Delhi),5,1
7.0,MD NAZIR,Aman Samaj Party,945,-,945,0.1,1 - Chandni Chowk (NCT OF Delhi),5,1
8.0,SATYA DEV CHAUDHARY,Satya Bahumat Party,842,-,842,0.09,1 - Chandni Chowk (NCT OF Delhi),5,1
9.0,RITU KAUSHIK,Socialist Unity Centre Of India (COMMUNIST),642,1,643,0.07,1 - Chandni Chowk (NCT OF Delhi),5,1
10.0,SAMEER MIRZA,Rashtriya Republican Party,513,-,513,0.05,1 - Chandni Chowk (NCT OF Delhi),5,1
11.0,SOHARSH GULGULIA JAIN,Swaraj Bhartiya Nyay Party,503,-,503,0.05,1 - Chandni Chowk (NCT OF Delhi),5,1
12.0,SHYAM BHARTEEY,Gareeb Aadmi Party,462,1,463,0.05,1 - Chandni Chowk (NCT OF Delhi),5,1
13.0,GULJAR SINGH,Peoples Party of India (Democratic),424,-,424,0.04,1 - Chandni Chowk (NCT OF Delhi),5,1
14.0,YOGENDER SINGH,Bharatiya Liberal Party,389,-,389,0.04,1 - Chandni Chowk (NCT OF Delhi),5,1
15.0,VINOD KUMAR GUPTA,Akhil Bhartiya Parivar Party,357,2,359,0.04,1 - Chandni Chowk (NCT OF Delhi),5,1
16.0,SHIVAM SAINI,Right to Recall Party,330,-,330,0.03,1 - Chandni Chowk (NCT OF Delhi),5,1
17.0,MANOJ KUMAR NIGAM,Akhil Bhartiya Sudhar Party,321,-,321,0.03,1 - Chandni Chowk (NCT OF Delhi),5,1
18.0,RAJESH GUPTA,Bharat Lok Sewak Party,261,1,262,0.03,1 - Chandni Chowk (NCT OF Delhi),5,1
19.0,RAHUL SHARMA,Rashtriya Mangalam Party,256,1,257,0.03,1 - Chandni Chowk (NCT OF Delhi),5,1
20.0,SUNIL KUMAR,Independent,247,-,247,0.03,1 - Chandni Chowk (NCT OF Delhi),5,1
21.0,SUBHASH CHANDER,Independent,220,-,220,0.02,1 - Chandni Chowk (NCT OF Delhi),5,1
22.0,MOHD HAMID,Bharatheeya Jawan Kisan Party,189,-,189,0.02,1 - Chandni Chowk (NCT OF Delhi),5,1
23.0,PYUSH NARULA,Independent,172,-,172,0.02,1 - Chandni Chowk (NCT OF Delhi),5,1
24.0,HEENA,Public Political Party,169,-,169,0.02,1 - Chandni Chowk (NCT OF Delhi),5,1
25.0,ASHOK KUMAR GUPTA,Independent,139,1,140,0.01,1 - Chandni Chowk (NCT OF Delhi),5,1
26.0,NOTA,None of the Above,5544,19,5563,0.58,1 - Chandni Chowk (NCT OF Delhi),5,1
,Total,,963895,2207,966102,,1 - Chandni Chowk (NCT OF Delhi),5,1
1.0,MANOJ TIWARI,Bharatiya Janata Party,821567,2884,824451,53.1,2 - North-East Delhi (NCT OF Delhi),5,2
2.0,KANHAIYA KUMAR,Indian National Congress,684501,1172,685673,44.16,2 - North-East Delhi (NCT OF Delhi),5,2
3.0,ASHOK KUMAR,Bahujan Samaj Party,12053,85,12138,0.78,2 - North-East Delhi (NCT OF Delhi),5,2
4.0,SUNITA,Navarang Congress Party,3518,-,3518,0.23,2 - North-East Delhi (NCT OF Delhi),5,2
5.0,AKESHAN DUT,Independent,3325,-,3325,0.21,2 - North-East Delhi (NCT OF Delhi),5,2
6.0,SUSHIL CHOUDHARY,Aapki Apni Party (Peoples),2066,4,2070,0.13,2 - North-East Delhi (NCT OF Delhi),5,2
7.0,AJAY TIWARI,Right to Recall Party,2040,2,2042,0.13,2 - North-East Delhi (NCT OF Delhi),5,2
8.0,SUBHASH,Rashtriya Janmorcha,1639,-,1639,0.11,2 - North-East Delhi (NCT OF Delhi),5,2
9.0,AKASH SRIVASTAV,Jai Hind National Party,1317,-,1317,0.08,2 - North-East Delhi (NCT OF Delhi),5,2
10.0,SANJEEV KUMAR PANDEY,Bharatiya Liberal Party,1163,-,1163,0.07,2 - North-East Delhi (NCT OF Delhi),5,2
11.0,SAROJ KUMAR RAY,Independent,931,66,997,0.06,2 - North-East Delhi (NCT OF Delhi),5,2
12.0,ADV. BHIM KISHOR,Peoples Party of India (Democratic),826,1,827,0.05,2 - North-East Delhi (NCT OF Delhi),5,2
13.0,SANJEEV KUMAR,Public Political Party,799,-,799,0.05,2 - North-East Delhi (NCT OF Delhi),5,2
14.0,PRAKASH DEVI,Socialist Unity Centre Of India (COMMUNIST),676,-,676,0.04,2 - North-East Delhi (NCT OF Delhi),5,2
15.0,LAKSHYA VASHIST (SHYAM),Jindabad Kranti Party,653,-,653,0.04,2 - North-East Delhi (NCT OF Delhi),5,2
16.0,BABITA YADAV,Aazad Samaj Party (Kanshi Ram),646,-,646,0.04,2 - North-East Delhi (NCT OF Delhi),5,2
17.0,MANOJ KUMAR,Independent,559,2,561,0.04,2 - North-East Delhi (NCT OF Delhi),5,2
18.0,NIVEDITA SHARMA “PREM”,Rashtrawadi Janlok Party (Satya),541,2,543,0.03,2 - North-East Delhi (NCT OF Delhi),5,2
19.0,DR. RAJESH KUMAR SINGH,Independent,539,1,540,0.03,2 - North-East Delhi (NCT OF Delhi),5,2
20.0,KANHI LAL,Swatantra Jantaraj Party,496,2,498,0.03,2 - North-East Delhi (NCT OF Delhi),5,2
21.0,VIJAY KUMAR JHA,Independent,486,5,491,0.03,2 - North-East Delhi (NCT OF Delhi),5,2
22.0,YOGESH SWAMY,Independent,410,-,410,0.03,2 - North-East Delhi (NCT OF Delhi),5,2
23.0,ASHOK MISHRA,Independent,352,-,352,0.02,2 - North-East Delhi (NCT OF Delhi),5,2
24.0,ADV. K.T. PALUSKAR,Prabuddha Republican Party,349,-,349,0.02,2 - North-East Delhi (NCT OF Delhi),5,2
25.0,RAVI KIRAN THILAK THATIKONDA,Independent,324,-,324,0.02,2 - North-East Delhi (NCT OF Delhi),5,2
26.0,ISHWAR CHAND,Bharatrashtra Democratic Party,310,-,310,0.02,2 - North-East Delhi (NCT OF Delhi),5,2
27.0,JAGDISH,Rashtriya Samaj Paksha,276,-,276,0.02,2 - North-East Delhi (NCT OF Delhi),5,2
28.0,BIRPAL SINGH KOLI,Independent,269,1,270,0.02,2 - North-East Delhi (NCT OF Delhi),5,2
29.0,NOTA,None of the Above,5845,28,5873,0.38,2 - North-East Delhi (NCT OF Delhi),5,2
,Total,,1548476,4255,1552731,,2 - North-East Delhi (NCT OF Delhi),5,2
1.0,HARSH MALHOTRA,Bharatiya Janata Party,663420,1399,664819,52.59,3 - East Delhi (NCT OF Delhi),5,3
2.0,KULDEEP KUMAR (MONU),Aam Aadmi Party,570494,662,571156,45.18,3 - East Delhi (NCT OF Delhi),5,3
3.0,MOHD. WAQAR CHOUDHARY,Bahujan Samaj Party,9158,39,9197,0.73,3 - East Delhi (NCT OF Delhi),5,3
4.0,A. GOPALA KRISHNA,Navarang Congress Party,2807,10,2817,0.22,3 - East Delhi (NCT OF Delhi),5,3
5.0,KULDEEP KUMAR,Independent,1579,3,1582,0.13,3 - East Delhi (NCT OF Delhi),5,3
6.0,MANOJ KUMAR GUPTA (SWARAJI),Independent,1191,1,1192,0.09,3 - East Delhi (NCT OF Delhi),5,3
7.0,RODASH GUPTA,Independent,1097,2,1099,0.09,3 - East Delhi (NCT OF Delhi),5,3
8.0,JYOTI PRAKASH (MONU),Ekam Sanatan Bharat Dal,824,-,824,0.07,3 - East Delhi (NCT OF Delhi),5,3
9.0,ARUNIMA GAUTAM,Independent,749,2,751,0.06,3 - East Delhi (NCT OF Delhi),5,3
10.0,JAI RAM LAL,Rashtriya Republican Party,657,-,657,0.05,3 - East Delhi (NCT OF Delhi),5,3
11.0,ADVOCATE MANJEET SINGH,Rashtra Nirman Party,614,-,614,0.05,3 - East Delhi (NCT OF Delhi),5,3
12.0,MOHAMMAD IRFAN,Independent,582,1,583,0.05,3 - East Delhi (NCT OF Delhi),5,3
13.0,OM SHANKAR,Independent,556,-,556,0.04,3 - East Delhi (NCT OF Delhi),5,3
14.0,LAL SINGH,Bahujan Dravida Party,476,1,477,0.04,3 - East Delhi (NCT OF Delhi),5,3
15.0,YOGESH CHAUDHARY,Bhartiya Veer Dal,468,2,470,0.04,3 - East Delhi (NCT OF Delhi),5,3
16.0,VIMAL KUMAR SAXENA,Independent,427,6,433,0.03,3 - East Delhi (NCT OF Delhi),5,3
17.0,SURENDRA SINGH BASOYA,Peoples Party of India (Democratic),392,7,399,0.03,3 - East Delhi (NCT OF Delhi),5,3
18.0,SANJAY,Public Political Party,378,1,379,0.03,3 - East Delhi (NCT OF Delhi),5,3
19.0,AMIT GUPTA,Independent,358,2,360,0.03,3 - East Delhi (NCT OF Delhi),5,3
20.0,SANJAYA KUMAR YADAV,Right to Recall Party,289,1,290,0.02,3 - East Delhi (NCT OF Delhi),5,3
21.0,NOTA,None of the Above,5371,23,5394,0.43,3 - East Delhi (NCT OF Delhi),5,3
,Total,,1261887,2162,1264049,,3 - East Delhi (NCT OF Delhi),5,3
1.0,BANSURI SWARAJ,Bharatiya Janata Party,451464,1721,453185,53.48,4 - New Delhi (NCT OF Delhi),5,4
2.0,SOMNATH BHARTI,Aam Aadmi Party,374032,783,374815,44.23,4 - New Delhi (NCT OF Delhi),5,4
3.0,RAAJ KUMAR ANAND,Bahujan Samaj Party,5601,28,5629,0.66,4 - New Delhi (NCT OF Delhi),5,4
4.0,SANJAY RAWAT,Independent,1271,5,1276,0.15,4 - New Delhi (NCT OF Delhi),5,4
5.0,ACHLA JETHMALANI,Jindabad Kranti Party,1036,1,1037,0.12,4 - New Delhi (NCT OF Delhi),5,4
6.0,HIRA LAL,Independent,1005,-,1005,0.12,4 - New Delhi (NCT OF Delhi),5,4
7.0,PREM SINGH,Navarang Congress Party,800,6,806,0.1,4 - New Delhi (NCT OF Delhi),5,4
8.0,UPEN‍DRA,Anjaan Aadmi Party,781,-,781,0.09,4 - New Delhi (NCT OF Delhi),5,4
9.0,DILIP SINGH,Independent,725,1,726,0.09,4 - New Delhi (NCT OF Delhi),5,4
10.0,LUKMAN KHAN,Log Party,654,2,656,0.08,4 - New Delhi (NCT OF Delhi),5,4
11.0,PUNAM PANDEY,Rashtravadi Loktantrik Party (India),640,1,641,0.08,4 - New Delhi (NCT OF Delhi),5,4
12.0,SANDHYA THAKKAR,Rashtriya Republican Party,485,1,486,0.06,4 - New Delhi (NCT OF Delhi),5,4
13.0,RAVINDER SINGH,Independent,414,2,416,0.05,4 - New Delhi (NCT OF Delhi),5,4
14.0,DINESH KUMAR,Peoples Party of India (Democratic),360,1,361,0.04,4 - New Delhi (NCT OF Delhi),5,4
15.0,PRITHVI NATH SINGH,Bharatiya Sampuran Krantikari Party,335,-,335,0.04,4 - New Delhi (NCT OF Delhi),5,4
16.0,MAHESH KUMAR DENWAL,Ambedkarite Party of India,287,1,288,0.03,4 - New Delhi (NCT OF Delhi),5,4
17.0,MANOJ KUMAR SHARMA,Loktantrik Janshakti Party,208,4,212,0.03,4 - New Delhi (NCT OF Delhi),5,4
18.0,NOTA,None of the Above,4791,22,4813,0.57,4 - New Delhi (NCT OF Delhi),5,4
,Total,,844889,2579,847468,,4 - New Delhi (NCT OF Delhi),5,4
1.0,YOGENDER CHANDOLIYA,Bharatiya Janata Party,863255,3228,866483,58.26,5 - North-West Delhi (NCT OF Delhi),5,5
2.0,UDIT RAJ,Indian National Congress,574451,1183,575634,38.71,5 - North-West Delhi (NCT OF Delhi),5,5
3.0,VIJAY BAUDDH,Bahujan Samaj Party,11955,42,11997,0.81,5 - North-West Delhi (NCT OF Delhi),5,5
4.0,SURESH KUMAR,Peoples Party of India (Democratic),2869,1,2870,0.19,5 - North-West Delhi (NCT OF Delhi),5,5
5.0,SANJAY KUMAR SIWAL,Rashtriya Janshakti Party (Secular),2866,-,2866,0.19,5 - North-West Delhi (NCT OF Delhi),5,5
6.0,SUBHASH,Asankhya Samaj Party,2250,-,2250,0.15,5 - North-West Delhi (NCT OF Delhi),5,5
7.0,RAJENDER SOOD,Aam Janshakti Party,1468,10,1478,0.1,5 - North-West Delhi (NCT OF Delhi),5,5
8.0,PRAVEEN GAUTAM,Navarang Congress Party,1455,1,1456,0.1,5 - North-West Delhi (NCT OF Delhi),5,5
9.0,K M KAJAL,Public Political Party,1334,8,1342,0.09,5 - North-West Delhi (NCT OF Delhi),5,5
10.0,NARESH KUMAR,Independent,1270,5,1275,0.09,5 - North-West Delhi (NCT OF Delhi),5,5
11.0,ADVOCATE SATISH CHANDRA,Ambedkarite Party of India,1236,1,1237,0.08,5 - North-West Delhi (NCT OF Delhi),5,5
12.0,PARMENDRA MANJHI,Independent,1102,-,1102,0.07,5 - North-West Delhi (NCT OF Delhi),5,5
13.0,ADVOCATE DR. MAHENDER SINGH CHURIYANA,Bahujan Dravida Party,1015,1,1016,0.07,5 - North-West Delhi (NCT OF Delhi),5,5
14.0,CHANDER PAL SONI,Independent,891,-,891,0.06,5 - North-West Delhi (NCT OF Delhi),5,5
15.0,ADITI,Independent,790,-,790,0.05,5 - North-West Delhi (NCT OF Delhi),5,5
16.0,ADV. KRUPAL,Prabuddha Republican Party,673,2,675,0.05,5 - North-West Delhi (NCT OF Delhi),5,5
17.0,NAND RAM BAGRI,Voters Party International,638,-,638,0.04,5 - North-West Delhi (NCT OF Delhi),5,5
18.0,SHYAM BHARTEEY,Gareeb Aadmi Party,629,3,632,0.04,5 - North-West Delhi (NCT OF Delhi),5,5
19.0,HARI KISHAN (MECHANIC),Independent,547,1,548,0.04,5 - North-West Delhi (NCT OF Delhi),5,5
20.0,POOJA (BHAGTANI),Bharatiya Jan Jagriti Party,504,5,509,0.03,5 - North-West Delhi (NCT OF Delhi),5,5
21.0,NARESH KUMAR,Rashtriya Samaj Paksha,499,1,500,0.03,5 - North-West Delhi (NCT OF Delhi),5,5
22.0,PREETI,Saman Adhikar Party,495,8,503,0.03,5 - North-West Delhi (NCT OF Delhi),5,5
23.0,SATYA PRAKASH UTTRAKHANDI,Independent,433,1,434,0.03,5 - North-West Delhi (NCT OF Delhi),5,5
24.0,KHILKHILAKAR,Bahujan Shoshit Samaj Sangharsh Samta Party,372,1,373,0.03,5 - North-West Delhi (NCT OF Delhi),5,5
25.0,PRADEEP KUMAR,Independent,371,-,371,0.02,5 - North-West Delhi (NCT OF Delhi),5,5
26.0,PUSHPA NAGRA,Independent,353,-,353,0.02,5 - North-West Delhi (NCT OF Delhi),5,5
27.0,NOTA,None of the Above,8917,67,8984,0.6,5 - North-West Delhi (NCT OF Delhi),5,5
,Total,,1482638,4569,1487207,,5 - North-West Delhi (NCT OF Delhi),5,5
1.0,KAMALJEET SEHRAWAT,Bharatiya Janata Party,838332,4326,842658,55.27,6 - West Delhi (NCT OF Delhi),5,6
2.0,MAHABAL MISHRA,Aam Aadmi Party,641759,1886,643645,42.22,6 - West Delhi (NCT OF Delhi),5,6
3.0,VISHAKHA,Bahujan Samaj Party,7899,65,7964,0.52,6 - West Delhi (NCT OF Delhi),5,6
4.0,SABIR KHAN,Independent,3096,1,3097,0.2,6 - West Delhi (NCT OF Delhi),5,6
5.0,AJ RAJAN,Navarang Congress Party,2381,6,2387,0.16,6 - West Delhi (NCT OF Delhi),5,6
6.0,SUNIL MEGHWAL,Ambedkarite Party of India,1874,2,1876,0.12,6 - West Delhi (NCT OF Delhi),5,6
7.0,OM PRAKASH NARAYAN,Aapki Apni Party (Peoples),1770,3,1773,0.12,6 - West Delhi (NCT OF Delhi),5,6
8.0,ANJU SHARMA,Independent,1263,4,1267,0.08,6 - West Delhi (NCT OF Delhi),5,6
9.0,KAPIL MARWAH,Independent,1154,1,1155,0.08,6 - West Delhi (NCT OF Delhi),5,6
10.0,JARNAIL SINGH,Independent,1083,6,1089,0.07,6 - West Delhi (NCT OF Delhi),5,6
11.0,MADHU,Akhil Bhartiya Parivar Party,1056,3,1059,0.07,6 - West Delhi (NCT OF Delhi),5,6
12.0,RAJIV KANT MISHRA,Independent,995,-,995,0.07,6 - West Delhi (NCT OF Delhi),5,6
13.0,RAMESH KUMAR JAIN @ NIRBHIK,Gareeb Aadmi Party,971,-,971,0.06,6 - West Delhi (NCT OF Delhi),5,6
14.0,UMA SHANKAR TIWARI,Bhartiya Mahasangh Party,753,5,758,0.05,6 - West Delhi (NCT OF Delhi),5,6
15.0,MEENA UJJAINWAL,Peoples Party of India (Democratic),752,4,756,0.05,6 - West Delhi (NCT OF Delhi),5,6
16.0,CHARANJEET SINGH,All India Forward Bloc,614,5,619,0.04,6 - West Delhi (NCT OF Delhi),5,6
17.0,UMESH CHAUHAN,Rashtriya Rashtrawadi Party,611,3,614,0.04,6 - West Delhi (NCT OF Delhi),5,6
18.0,PRAMOD KUREEL,Bahujan National Party (Ambedkar),585,1,586,0.04,6 - West Delhi (NCT OF Delhi),5,6
19.0,AMIT KUMAR SINGH,Rashtriya Suraksha Party,571,3,574,0.04,6 - West Delhi (NCT OF Delhi),5,6
20.0,JAYA RAMAN,Sarvlokhit Samaj Party,439,7,446,0.03,6 - West Delhi (NCT OF Delhi),5,6
21.0,RAM NARAYAN MOHANTY,Independent,433,1,434,0.03,6 - West Delhi (NCT OF Delhi),5,6
22.0,CHAMAN LAL VERMA,Samaj Vikas Kranti Party,418,2,420,0.03,6 - West Delhi (NCT OF Delhi),5,6
23.0,DEEPAK SHARMA,Bharatiya Jan Jagriti Party,362,8,370,0.02,6 - West Delhi (NCT OF Delhi),5,6
24.0,RAVI,Independent,280,2,282,0.02,6 - West Delhi (NCT OF Delhi),5,6
25.0,NOTA,None of the Above,8624,75,8699,0.57,6 - West Delhi (NCT OF Delhi),5,6
,Total,,1518075,6419,1524494,,6 - West Delhi (NCT OF Delhi),5,6
1.0,RAMVIR SINGH BIDHURI,Bharatiya Janata Party,691184,1648,692832,53.46,7 - South Delhi (NCT OF Delhi),5,7
2.0,SAHI RAM,Aam Aadmi Party,567716,783,568499,43.87,7 - South Delhi (NCT OF Delhi),5,7
3.0,ABDUL BASIT,Bahujan Samaj Party,9829,32,9861,0.76,7 - South Delhi (NCT OF Delhi),5,7
4.0,RAM GOPAL,Haryana Jansena Party,3956,2,3958,0.31,7 - South Delhi (NCT OF Delhi),5,7
5.0,CHANDRASHEKHAR SINGH KUSHWAHA,Independent,1888,1,1889,0.15,7 - South Delhi (NCT OF Delhi),5,7
6.0,DEEPAK KAPILA,Independent,1500,-,1500,0.12,7 - South Delhi (NCT OF Delhi),5,7
7.0,OMAPRAKASH,Samaj Vikas Kranti Party,1364,1,1365,0.11,7 - South Delhi (NCT OF Delhi),5,7
8.0,JAGDISH KUMAR VERMA,Independent,1295,1,1296,0.1,7 - South Delhi (NCT OF Delhi),5,7
9.0,LAKHAN SINGH,Navarang Congress Party,967,3,970,0.07,7 - South Delhi (NCT OF Delhi),5,7
10.0,POONAM SRIVASTAVA,Independent,951,7,958,0.07,7 - South Delhi (NCT OF Delhi),5,7
11.0,ARUN KUMAR,Independent,842,-,842,0.06,7 - South Delhi (NCT OF Delhi),5,7
12.0,RINKI SANYAL,Bharatiya Sampuran Krantikari Party,762,1,763,0.06,7 - South Delhi (NCT OF Delhi),5,7
13.0,KAMLESH KUMAR JHA,Independent,714,-,714,0.06,7 - South Delhi (NCT OF Delhi),5,7
14.0,SURJEET SINGH,Delhi Janta Party,637,1,638,0.05,7 - South Delhi (NCT OF Delhi),5,7
15.0,BHIM SINGH,Ambedkarite Party of India,601,1,602,0.05,7 - South Delhi (NCT OF Delhi),5,7
16.0,SURINDER KUMAR,Bharatheeya Jawan Kisan Party,592,-,592,0.05,7 - South Delhi (NCT OF Delhi),5,7
17.0,GAUTAM ANAND,All India Forward Bloc,539,1,540,0.04,7 - South Delhi (NCT OF Delhi),5,7
18.0,SHANKAR DEY,Independent,522,-,522,0.04,7 - South Delhi (NCT OF Delhi),5,7
19.0,BIHARI LAL JALANDHARI,India Greens Party,511,3,514,0.04,7 - South Delhi (NCT OF Delhi),5,7
20.0,NAVEEN KUMAR,Hamara Sahi Vikalp Party,475,1,476,0.04,7 - South Delhi (NCT OF Delhi),5,7
21.0,VIRENDER,Independent,381,-,381,0.03,7 - South Delhi (NCT OF Delhi),5,7
22.0,RAJAN SINGH,Independent,323,2,325,0.03,7 - South Delhi (NCT OF Delhi),5,7
23.0,NOTA,None of the Above,5927,34,5961,0.46,7 - South Delhi (NCT OF Delhi),5,7
,Total,,1293476,2522,1295998,,7 - South Delhi (NCT OF Delhi),5,7
1.0,MUHAMMED HAMDULLAH SAYEED,Indian National Congress,25405,321,25726,52.29,1 - Lakshadweep (Lakshadweep),6,1
2.0,MOHAMMED FAIZAL PP,Nationalist Congress Party – Sharadchandra Pawar,22837,242,23079,46.91,1 - Lakshadweep (Lakshadweep),6,1
3.0,YOUSUF TP,Nationalist Congress Party,198,3,201,0.41,1 - Lakshadweep (Lakshadweep),6,1
4.0,KOYA,Independent,58,3,61,0.12,1 - Lakshadweep (Lakshadweep),6,1
5.0,NOTA,None of the Above,132,1,133,0.27,1 - Lakshadweep (Lakshadweep),6,1
,Total,,48630,570,49200,,1 - Lakshadweep (Lakshadweep),6,1
1.0,VE VAITHILINGAM,Indian National Congress,424292,1713,426005,52.73,1 - PUDUCHERRY (Puducherry),7,1
2.0,A NAMASSIVAYAM,Bharatiya Janata Party,288050,1439,289489,35.83,1 - PUDUCHERRY (Puducherry),7,1
3.0,R MENAGA,Naam Tamilar Katchi,39545,58,39603,4.9,1 - PUDUCHERRY (Puducherry),7,1
4.0,G THAMIZHVENDAN,All India Anna Dravida Munnetra Kazhagam,25059,106,25165,3.11,1 - PUDUCHERRY (Puducherry),7,1
5.0,P SANKARAN,Socialist Unity Centre Of India (COMMUNIST),2057,9,2066,0.26,1 - PUDUCHERRY (Puducherry),7,1
6.0,ARADADI POSIYYA,Independent,1540,6,1546,0.19,1 - PUDUCHERRY (Puducherry),7,1
7.0,D ALANGARAVELU,Bahujan Samaj Party,1534,6,1540,0.19,1 - PUDUCHERRY (Puducherry),7,1
8.0,K KISHORKUMAR,Independent,1240,6,1246,0.15,1 - PUDUCHERRY (Puducherry),7,1
9.0,KOLLANJIAPPAN,Independent,1198,1,1199,0.15,1 - PUDUCHERRY (Puducherry),7,1
10.0,M MANIKANDAN,Independent,1130,3,1133,0.14,1 - PUDUCHERRY (Puducherry),7,1
11.0,M KRISHNAMURTHY,Independent,1052,19,1071,0.13,1 - PUDUCHERRY (Puducherry),7,1
12.0,K PRABHU DEVAN,United Republican Party of India,981,8,989,0.12,1 - PUDUCHERRY (Puducherry),7,1
13.0,S BAKTHAVATCHALAM,Independent,923,1,924,0.11,1 - PUDUCHERRY (Puducherry),7,1
14.0,S SATHISH KUMAR,Independent,842,4,846,0.1,1 - PUDUCHERRY (Puducherry),7,1
15.0,COUTTANE ALIAS DHIVANEEDHE,Independent,819,3,822,0.1,1 - PUDUCHERRY (Puducherry),7,1
16.0,E ANANTHAVEL,Independent,771,5,776,0.1,1 - PUDUCHERRY (Puducherry),7,1
17.0,S KALA,Independent,593,33,626,0.08,1 - PUDUCHERRY (Puducherry),7,1
18.0,P RAJAN,Independent,545,2,547,0.07,1 - PUDUCHERRY (Puducherry),7,1
19.0,NIRMALA G,Independent,474,1,475,0.06,1 - PUDUCHERRY (Puducherry),7,1
20.0,K ARUNACHALAM,Independent,403,2,405,0.05,1 - PUDUCHERRY (Puducherry),7,1
21.0,K RAMADASS,Independent,368,4,372,0.05,1 - PUDUCHERRY (Puducherry),7,1
22.0,R RAJA,Independent,326,5,331,0.04,1 - PUDUCHERRY (Puducherry),7,1
23.0,D RAVINDIRAN,Independent,305,2,307,0.04,1 - PUDUCHERRY (Puducherry),7,1
24.0,S MASCO,Independent,248,6,254,0.03,1 - PUDUCHERRY (Puducherry),7,1
25.0,V P MANICKAM,Independent,242,2,244,0.03,1 - PUDUCHERRY (Puducherry),7,1
26.0,M MURUGAN,Independent,196,-,196,0.02,1 - PUDUCHERRY (Puducherry),7,1
27.0,NOTA,None of the Above,9756,7,9763,1.21,1 - PUDUCHERRY (Puducherry),7,1
,Total,,804489,3451,807940,,1 - PUDUCHERRY (Puducherry),7,1
1.0,ABDUL RASHID SHEIKH,Independent,469574,2907,472481,45.7,1 - BARAMULLA (Jammu and Kashmir),8,1
2.0,OMAR ABDULLAH,Jammu & Kashmir National Conference,266301,2038,268339,25.95,1 - BARAMULLA (Jammu and Kashmir),8,1
3.0,SAJAD GANI LONE,Jammu & Kashmir People Conference,171582,1657,173239,16.76,1 - BARAMULLA (Jammu and Kashmir),8,1
4.0,MIR MOHAMMAD FAYAZ,Jammu & Kashmir Peoples Democratic Party,27173,315,27488,2.66,1 - BARAMULLA (Jammu and Kashmir),8,1
5.0,SURAIYA NISSAR,Independent,21565,53,21618,2.09,1 - BARAMULLA (Jammu and Kashmir),8,1
6.0,FIRDOUS AHMAD BHAT,Independent,15707,15,15722,1.52,1 - BARAMULLA (Jammu and Kashmir),8,1
7.0,SHAFEEQA BEGUM,Independent,6203,11,6214,0.6,1 - BARAMULLA (Jammu and Kashmir),8,1
8.0,PEERZADA MUDASIR RASHID SHAH,Jammu & Kashmir National Panthers Party (Bhim),5499,67,5566,0.54,1 - BARAMULLA (Jammu and Kashmir),8,1
9.0,KHURSHEED AHMAD SHAH,Rashtriya Jankranti Party,4213,55,4268,0.41,1 - BARAMULLA (Jammu and Kashmir),8,1
10.0,MOHAMMAD SULTAN GANAIE,Independent,4054,9,4063,0.39,1 - BARAMULLA (Jammu and Kashmir),8,1
11.0,SHADIB HANIEF KHAN,Independent,3668,2,3670,0.35,1 - BARAMULLA (Jammu and Kashmir),8,1
12.0,MUDASIR AHMAD TANTARY,Independent,3196,22,3218,0.31,1 - BARAMULLA (Jammu and Kashmir),8,1
13.0,NAZIR AHMAD SOFI,Independent,2980,3,2983,0.29,1 - BARAMULLA (Jammu and Kashmir),8,1
14.0,SHABIR AHMAD DAR,Independent,2694,6,2700,0.26,1 - BARAMULLA (Jammu and Kashmir),8,1
15.0,HILAL AHMAD WAGAY,Independent,2681,8,2689,0.26,1 - BARAMULLA (Jammu and Kashmir),8,1
16.0,MEHRAJ UDDIN NAJAR,Independent,2560,10,2570,0.25,1 - BARAMULLA (Jammu and Kashmir),8,1
17.0,SYED AMEER SUHAIL,Independent,2409,8,2417,0.23,1 - BARAMULLA (Jammu and Kashmir),8,1
18.0,FAROOQ AHMAD BHAT,National Youth Party,2315,28,2343,0.23,1 - BARAMULLA (Jammu and Kashmir),8,1
19.0,ARUN KUMAR RAINA,Independent,2161,80,2241,0.22,1 - BARAMULLA (Jammu and Kashmir),8,1
20.0,MUNIR AHMAD KHAN,Jammu and Kashmir Nationalist People's Front,2004,15,2019,0.2,1 - BARAMULLA (Jammu and Kashmir),8,1
21.0,MUZAFFAR HUSSAIN DAR,Independent,1663,8,1671,0.16,1 - BARAMULLA (Jammu and Kashmir),8,1
22.0,MUSHTAQ AHMAD MIR,National Loktantrik Party,1382,15,1397,0.14,1 - BARAMULLA (Jammu and Kashmir),8,1
23.0,NOTA,None of the Above,4873,111,4984,0.48,1 - BARAMULLA (Jammu and Kashmir),8,1
,Total,,1026457,7443,1033900,,1 - BARAMULLA (Jammu and Kashmir),8,1
1.0,AGA SYED RUHULLAH MEHDI,Jammu & Kashmir National Conference,355294,1572,356866,52.85,2 - SRINAGAR (Jammu and Kashmir),8,2
2.0,WAHEED UR REHMAN PARA,Jammu & Kashmir Peoples Democratic Party,167666,784,168450,24.95,2 - SRINAGAR (Jammu and Kashmir),8,2
3.0,MOHAMMAD ASHRAF MIR,Jammu and Kashmir Apni Party,65494,460,65954,9.77,2 - SRINAGAR (Jammu and Kashmir),8,2
4.0,AMIR AHMAD BHAT,Democratic Progressive Azad Party,15061,43,15104,2.24,2 - SRINAGAR (Jammu and Kashmir),8,2
5.0,SHEEBAN ASHAI,Independent,13063,8,13071,1.94,2 - SRINAGAR (Jammu and Kashmir),8,2
6.0,SAYIM MUSTAFA,Independent,8831,49,8880,1.32,2 - SRINAGAR (Jammu and Kashmir),8,2
7.0,JIBRAN FIRDOUS DAR,Independent,5431,67,5498,0.81,2 - SRINAGAR (Jammu and Kashmir),8,2
8.0,JAHANGIR AHMAD SHEIKH,Independent,4412,10,4422,0.65,2 - SRINAGAR (Jammu and Kashmir),8,2
9.0,SAJAD AHMAD DAR,Independent,3755,9,3764,0.56,2 - SRINAGAR (Jammu and Kashmir),8,2
10.0,HAKIKAT SINGH,Jammu & Kashmir National Panthers Party (Bhim),3732,46,3778,0.56,2 - SRINAGAR (Jammu and Kashmir),8,2
11.0,RUBINA AKHTER,National Loktantrik Party,2855,21,2876,0.43,2 - SRINAGAR (Jammu and Kashmir),8,2
12.0,WASEEM HASSAN SHEIKH,Independent,2838,17,2855,0.42,2 - SRINAGAR (Jammu and Kashmir),8,2
13.0,RIYAZ AHMAD BHAT,Independent,2791,1,2792,0.41,2 - SRINAGAR (Jammu and Kashmir),8,2
14.0,FAYAZ AHMAD BUTT,Independent,2221,6,2227,0.33,2 - SRINAGAR (Jammu and Kashmir),8,2
15.0,SHAHNAZ HUSSAIN SHAH,Independent,2196,7,2203,0.33,2 - SRINAGAR (Jammu and Kashmir),8,2
16.0,MOHD YOUSUF BHAT,Gana Suraksha Party,1880,18,1898,0.28,2 - SRINAGAR (Jammu and Kashmir),8,2
17.0,WAHEEDA TABASUM SHAH,Independent,1594,12,1606,0.24,2 - SRINAGAR (Jammu and Kashmir),8,2
18.0,NISAR AHMAD AHANGAR,Independent,1115,9,1124,0.17,2 - SRINAGAR (Jammu and Kashmir),8,2
19.0,MIRZA SAJAD HUSSAIN BEIGH,Independent,1049,15,1064,0.16,2 - SRINAGAR (Jammu and Kashmir),8,2
20.0,GHULAM MOHAMMAD WANI,Independent,1028,12,1040,0.15,2 - SRINAGAR (Jammu and Kashmir),8,2
21.0,AMIN DAR,Independent,989,7,996,0.15,2 - SRINAGAR (Jammu and Kashmir),8,2
22.0,JAVEED AHMAD WANI,Independent,928,4,932,0.14,2 - SRINAGAR (Jammu and Kashmir),8,2
23.0,YOUNIS AHMAD MIR,Bharat Jodo Party,913,12,925,0.14,2 - SRINAGAR (Jammu and Kashmir),8,2
24.0,DR QAZI ASHRAF,Independent,910,9,919,0.14,2 - SRINAGAR (Jammu and Kashmir),8,2
25.0,NOTA,None of the Above,5887,111,5998,0.89,2 - SRINAGAR (Jammu and Kashmir),8,2
,Total,,671933,3309,675242,,2 - SRINAGAR (Jammu and Kashmir),8,2
1.0,MIAN ALTAF AHMAD,Jammu & Kashmir National Conference,517489,4347,521836,50.85,3 - ANANTNAG-RAJOURI (Jammu and Kashmir),8,3
2.0,MEHBOOBA MUFTI,Jammu & Kashmir Peoples Democratic Party,238210,1832,240042,23.39,3 - ANANTNAG-RAJOURI (Jammu and Kashmir),8,3
3.0,ZAFAR IQBAL KHAN MANHAS,Jammu and Kashmir Apni Party,141316,879,142195,13.86,3 - ANANTNAG-RAJOURI (Jammu and Kashmir),8,3
4.0,MOHAMAD SALEEM PARAY,Democratic Progressive Azad Party,25440,121,25561,2.49,3 - ANANTNAG-RAJOURI (Jammu and Kashmir),8,3
5.0,ABDUL RAOUF MALIK,Independent,10566,16,10582,1.03,3 - ANANTNAG-RAJOURI (Jammu and Kashmir),8,3
6.0,SUSHIL KUMAR SHARMA,Independent,9102,126,9228,0.9,3 - ANANTNAG-RAJOURI (Jammu and Kashmir),8,3
7.0,ABDUL ROUF NAIK,Independent,9079,70,9149,0.89,3 - ANANTNAG-RAJOURI (Jammu and Kashmir),8,3
8.0,SAJAD AHMAD DAR,Independent,7988,16,8004,0.78,3 - ANANTNAG-RAJOURI (Jammu and Kashmir),8,3
9.0,IMRAN SHEIKH,Independent,7457,28,7485,0.73,3 - ANANTNAG-RAJOURI (Jammu and Kashmir),8,3
10.0,IMTIYAZ AHMAD,National Loktantrik Party,6936,77,7013,0.68,3 - ANANTNAG-RAJOURI (Jammu and Kashmir),8,3
11.0,ARSHEED AHMED LONE,Jammu & Kashmir National Panthers Party (Bhim),6163,226,6389,0.62,3 - ANANTNAG-RAJOURI (Jammu and Kashmir),8,3
12.0,BALDEV KUMAR,Independent,6120,69,6189,0.6,3 - ANANTNAG-RAJOURI (Jammu and Kashmir),8,3
13.0,ALI MOHAMMAD WANI,Independent,5238,17,5255,0.51,3 - ANANTNAG-RAJOURI (Jammu and Kashmir),8,3
14.0,SHEIKH MUZAFAR AHMED,Jammu and Kashmir Nationalist People's Front,4774,40,4814,0.47,3 - ANANTNAG-RAJOURI (Jammu and Kashmir),8,3
15.0,DILIP KUMAR PANDITA,Independent,3638,84,3722,0.36,3 - ANANTNAG-RAJOURI (Jammu and Kashmir),8,3
16.0,RAVINDER SINGH,Independent,2828,134,2962,0.29,3 - ANANTNAG-RAJOURI (Jammu and Kashmir),8,3
17.0,GULSHAN AKHTER,Independent,2778,29,2807,0.27,3 - ANANTNAG-RAJOURI (Jammu and Kashmir),8,3
18.0,MOHAMMAD MAQBOOL TELI,Garib Democratic Party,2731,17,2748,0.27,3 - ANANTNAG-RAJOURI (Jammu and Kashmir),8,3
19.0,SUDARSHAN SINGH,National Awami United Party,2166,216,2382,0.23,3 - ANANTNAG-RAJOURI (Jammu and Kashmir),8,3
20.0,JAVAID AHMED,All India Forward Bloc,1534,28,1562,0.15,3 - ANANTNAG-RAJOURI (Jammu and Kashmir),8,3
21.0,NOTA,None of the Above,5967,256,6223,0.61,3 - ANANTNAG-RAJOURI (Jammu and Kashmir),8,3
,Total,,1017520,8628,1026148,,3 - ANANTNAG-RAJOURI (Jammu and Kashmir),8,3
1.0,DR JITENDRA SINGH,Bharatiya Janata Party,566833,4243,571076,51.28,4 - UDHAMPUR (Jammu and Kashmir),8,4
2.0,CH LAL SINGH,Indian National Congress,444151,2552,446703,40.11,4 - UDHAMPUR (Jammu and Kashmir),8,4
3.0,GHULAM MOHD SAROORI,Independent,39519,80,39599,3.56,4 - UDHAMPUR (Jammu and Kashmir),8,4
4.0,MEHRAJ DIN,Independent,9055,27,9082,0.82,4 - UDHAMPUR (Jammu and Kashmir),8,4
5.0,AMIT KUMAR,Bahujan Samaj Party,8559,83,8642,0.78,4 - UDHAMPUR (Jammu and Kashmir),8,4
6.0,MOHD ALI GUJJAR,Independent,7139,19,7158,0.64,4 - UDHAMPUR (Jammu and Kashmir),8,4
7.0,MANOJ KUMAR,Ekam Sanatan Bharat Dal,6778,56,6834,0.61,4 - UDHAMPUR (Jammu and Kashmir),8,4
8.0,BALWAN SINGH,Jammu & Kashmir National Panthers Party (Bhim),3243,49,3292,0.3,4 - UDHAMPUR (Jammu and Kashmir),8,4
9.0,SWARN VEER SINGH JARAL,Independent,3071,17,3088,0.28,4 - UDHAMPUR (Jammu and Kashmir),8,4
10.0,DR PANKAJ SHARMA,Independent,2201,46,2247,0.2,4 - UDHAMPUR (Jammu and Kashmir),8,4
11.0,RAJESH MANCHANDA,Independent,1575,30,1605,0.14,4 - UDHAMPUR (Jammu and Kashmir),8,4
12.0,SACHIN GUPTA,Independent,1457,6,1463,0.13,4 - UDHAMPUR (Jammu and Kashmir),8,4
13.0,NOTA,None of the Above,12891,47,12938,1.16,4 - UDHAMPUR (Jammu and Kashmir),8,4
,Total,,1106472,7255,1113727,,4 - UDHAMPUR (Jammu and Kashmir),8,4
1.0,JUGAL KISHORE,Bharatiya Janata Party,677571,10017,687588,52.8,5 - JAMMU (Jammu and Kashmir),8,5
2.0,RAMAN BHALLA,Indian National Congress,546031,6059,552090,42.4,5 - JAMMU (Jammu and Kashmir),8,5
3.0,JAGDISH RAJ,Bahujan Samaj Party,10253,47,10300,0.79,5 - JAMMU (Jammu and Kashmir),8,5
4.0,SATISH POONCHI,Independent,5948,11,5959,0.46,5 - JAMMU (Jammu and Kashmir),8,5
5.0,ANKUR SHARMA,Ekam Sanatan Bharat Dal,4268,10,4278,0.33,5 - JAMMU (Jammu and Kashmir),8,5
6.0,NARESH KUMAR CHIB,Jammu & Kashmir National Panthers Party (Bhim),4231,12,4243,0.33,5 - JAMMU (Jammu and Kashmir),8,5
7.0,PRINCIPAL C D SHARMA,Independent,3256,1,3257,0.25,5 - JAMMU (Jammu and Kashmir),8,5
8.0,KARANJIT,Independent,3199,8,3207,0.25,5 - JAMMU (Jammu and Kashmir),8,5
9.0,SHABER AHMED,Independent,3174,3,3177,0.24,5 - JAMMU (Jammu and Kashmir),8,5
10.0,SHIKHA BANDRAL,National Awami United Party,2932,5,2937,0.23,5 - JAMMU (Jammu and Kashmir),8,5
11.0,DR PRINCE RAINA,Independent,2863,3,2866,0.22,5 - JAMMU (Jammu and Kashmir),8,5
12.0,RAJ KUMAR,Independent,2611,7,2618,0.2,5 - JAMMU (Jammu and Kashmir),8,5
13.0,SURINDER SINGH,Independent,2216,10,2226,0.17,5 - JAMMU (Jammu and Kashmir),8,5
14.0,ATUL RAINA,Independent,2063,5,2068,0.16,5 - JAMMU (Jammu and Kashmir),8,5
15.0,RATTAN LAL,Jammu & Kashmir People Conference,1650,1,1651,0.13,5 - JAMMU (Jammu and Kashmir),8,5
16.0,SWAMI DIVYA NAND,Jammu and Kashmir Nationalist People's Front,1618,2,1620,0.12,5 - JAMMU (Jammu and Kashmir),8,5
17.0,PERSEEN SINGH,Independent,1587,2,1589,0.12,5 - JAMMU (Jammu and Kashmir),8,5
18.0,NARESH KUMAR TALLA,Independent,1458,1,1459,0.11,5 - JAMMU (Jammu and Kashmir),8,5
19.0,GANESH CHOUDHARY,Hindustan Shakti Sena,1187,3,1190,0.09,5 - JAMMU (Jammu and Kashmir),8,5
20.0,VICKY KUMAR DOGRA,Independent,1163,2,1165,0.09,5 - JAMMU (Jammu and Kashmir),8,5
21.0,BANSI LAL,Independent,1051,8,1059,0.08,5 - JAMMU (Jammu and Kashmir),8,5
22.0,QARI ZAHEER ABBAS BHATTI,All India Forward Bloc,983,1,984,0.08,5 - JAMMU (Jammu and Kashmir),8,5
23.0,NOTA,None of the Above,4631,14,4645,0.36,5 - JAMMU (Jammu and Kashmir),8,5
,Total,,1285944,16232,1302176,,5 - JAMMU (Jammu and Kashmir),8,5
1.0,MOHMAD HANEEFA,Independent,64443,816,65259,48.15,1 - Ladakh (Ladakh),9,1
2.0,TSERING NAMGYAL,Indian National Congress,35770,1627,37397,27.59,1 - Ladakh (Ladakh),9,1
3.0,TASHI GYALSON,Bharatiya Janata Party,31505,451,31956,23.58,1 - Ladakh (Ladakh),9,1
4.0,NOTA,None of the Above,896,16,912,0.67,1 - Ladakh (Ladakh),9,1
,Total,,132614,2910,135524,,1 - Ladakh (Ladakh),9,1
